;a;b;operation;calculated;cumulative;result;proof_size;seconds;response
prove_0;92;2;Mul;184;184;184.0;841;0.11061391600014758;{'verificationValue': 184.0, 'proof': {'imageId': [2948630792, 2482136711, 1512618692, 3197082418, 820963868, 463243005, 2815130045, 3835354657], 'receipt': 'AwAAAAAAAAAAAAAAxAciAPPsD8genbvcCN2DvDmorNgPyU2p6hAM/h+8IU0pSDuhAAAAAAAAAAAAAAAAAAAAAAAAAAAAAAAAAAAAAAAAAAAAAAAAAAAAAAAAAAAAAAAAAQAAAAAAAAAAAAAAAAAAAAAAAAAAAAAAAAAAAAAAAAAAAAAAAAAAAAEAAAAAQAEAAAAAAAAFAAAAMTg0LjAAAAAvAQAAeyJ3YXNfZmlyc3RfZXZlbnQiOnRydWUsImltYWdlX2lkIjpbMjk0ODYzMDc5MiwyNDgyMTM2NzExLDE1MTI2MTg2OTIsMzE5NzA4MjQxOCw4MjA5NjM4NjgsNDYzMjQzMDA1LDI4MTUxMzAwNDUsMzgzNTM1NDY1N10sInFmIjp7ImIiOlswLDQsMCwwLDAsMCwwLDAsMCw0LDAsMCwwLDAsMCwwLDAsMCwxMjgsMjYsMCwwLDAsMCwwLDAsMCwwLDAsMCwwLDAsMCwwLDAsMCwwLDAsMCwwLDAsMCwwLDAsMCwwLDAsMCwwLDAsMCwwLDAsMCwwLDAsMCwwLDAsMCwwLDAsMCwwLDAsMCwwLDAsMCwwLDAsMCwwXSwibCI6MSwicSI6NiwiciI6N319AAAAAAAAAAAAAAAAAEABAAAAAAAABQAAADE4NC4wAAAALwEAAHsid2FzX2ZpcnN0X2V2ZW50Ijp0cnVlLCJpbWFnZV9pZCI6WzI5NDg2MzA3OTIsMjQ4MjEzNjcxMSwxNTEyNjE4NjkyLDMxOTcwODI0MTgsODIwOTYzODY4LDQ2MzI0MzAwNSwyODE1MTMwMDQ1LDM4MzUzNTQ2NTddLCJxZiI6eyJiIjpbMCw0LDAsMCwwLDAsMCwwLDAsNCwwLDAsMCwwLDAsMCwwLDAsMTI4LDI2LDAsMCwwLDAsMCwwLDAsMCwwLDAsMCwwLDAsMCwwLDAsMCwwLDAsMCwwLDAsMCwwLDAsMCwwLDAsMCwwLDAsMCwwLDAsMCwwLDAsMCwwLDAsMCwwLDAsMCwwLDAsMCwwLDAsMCwwLDAsMF0sImwiOjEsInEiOjYsInIiOjd9fQAAAAAAAAAAAAAAAAAAAAAAAAAAAAAAAAAAAAAAAAAAAA=='}}
prove_1;8;9;Mul;72;256;256.0;849;0.07272137499967357;{'verificationValue': 256.0, 'proof': {'imageId': [2948630792, 2482136711, 1512618692, 3197082418, 820963868, 463243005, 2815130045, 3835354657], 'receipt': 'AwAAAAAAAAAAAAAAxAciAPPsD8genbvcCN2DvDmorNgPyU2p6hAM/h+8IU0pSDuhAAAAAAAAAAAAAAAAAAAAAAAAAAAAAAAAAAAAAAAAAAAAAAAAAAAAAAAAAAAAAAAAAQAAAAAAAAAAAAAAAAAAAAAAAAAAAAAAAAAAAAAAAAAAAAAAAAAAAAEAAAAARAEAAAAAAAAFAAAAMjU2LjAAAAAxAQAAeyJ3YXNfZmlyc3RfZXZlbnQiOmZhbHNlLCJpbWFnZV9pZCI6WzI5NDg2MzA3OTIsMjQ4MjEzNjcxMSwxNTEyNjE4NjkyLDMxOTcwODI0MTgsODIwOTYzODY4LDQ2MzI0MzAwNSwyODE1MTMwMDQ1LDM4MzUzNTQ2NTddLCJxZiI6eyJiIjpbMCw0LDAsMCwwLDAsMCwwLDAsOCwwLDAsMCwwLDAsMCwwLDAsMTI4LDkwLDEzLDAsMCwwLDAsMCwwLDAsMCwwLDAsMCwwLDAsMCwwLDAsMCwwLDAsMCwwLDAsMCwwLDAsMCwwLDAsMCwwLDAsMCwwLDAsMCwwLDAsMCwwLDAsMCwwLDAsMCwwLDAsMCwwLDAsMCwwLDBdLCJsIjoyLCJxIjo2LCJyIjo3fX0AAAAAAAAAAAAAAAAAAABEAQAAAAAAAAUAAAAyNTYuMAAAADEBAAB7Indhc19maXJzdF9ldmVudCI6ZmFsc2UsImltYWdlX2lkIjpbMjk0ODYzMDc5MiwyNDgyMTM2NzExLDE1MTI2MTg2OTIsMzE5NzA4MjQxOCw4MjA5NjM4NjgsNDYzMjQzMDA1LDI4MTUxMzAwNDUsMzgzNTM1NDY1N10sInFmIjp7ImIiOlswLDQsMCwwLDAsMCwwLDAsMCw4LDAsMCwwLDAsMCwwLDAsMCwxMjgsOTAsMTMsMCwwLDAsMCwwLDAsMCwwLDAsMCwwLDAsMCwwLDAsMCwwLDAsMCwwLDAsMCwwLDAsMCwwLDAsMCwwLDAsMCwwLDAsMCwwLDAsMCwwLDAsMCwwLDAsMCwwLDAsMCwwLDAsMCwwLDAsMF0sImwiOjIsInEiOjYsInIiOjd9fQAAAAAAAAAAAAAAAAAAAAAAAAAAAAAAAAAAAAAAAAAAAAAA'}}
prove_2;68;16;Mul;1088;1344;1344.0;849;0.07253725000009581;{'verificationValue': 1344.0, 'proof': {'imageId': [2948630792, 2482136711, 1512618692, 3197082418, 820963868, 463243005, 2815130045, 3835354657], 'receipt': 'AwAAAAAAAAAAAAAAxAciAPPsD8genbvcCN2DvDmorNgPyU2p6hAM/h+8IU0pSDuhAAAAAAAAAAAAAAAAAAAAAAAAAAAAAAAAAAAAAAAAAAAAAAAAAAAAAAAAAAAAAAAAAQAAAAAAAAAAAAAAAAAAAAAAAAAAAAAAAAAAAAAAAAAAAAAAAAAAAAEAAAAARAEAAAAAAAAGAAAAMTM0NC4wAAAzAQAAeyJ3YXNfZmlyc3RfZXZlbnQiOmZhbHNlLCJpbWFnZV9pZCI6WzI5NDg2MzA3OTIsMjQ4MjEzNjcxMSwxNTEyNjE4NjkyLDMxOTcwODI0MTgsODIwOTYzODY4LDQ2MzI0MzAwNSwyODE1MTMwMDQ1LDM4MzUzNTQ2NTddLCJxZiI6eyJiIjpbMCw0LDAsMCwwLDAsMCwwLDAsMTYsMCwwLDAsMCwwLDAsMCwwLDEyOCw5MCwxNzMsNiwwLDAsMCwwLDAsMCwwLDAsMCwwLDAsMCwwLDAsMCwwLDAsMCwwLDAsMCwwLDAsMCwwLDAsMCwwLDAsMCwwLDAsMCwwLDAsMCwwLDAsMCwwLDAsMCwwLDAsMCwwLDAsMCwwLDAsMF0sImwiOjMsInEiOjYsInIiOjd9fQAAAAAAAAAAAAAAAABEAQAAAAAAAAYAAAAxMzQ0LjAAADMBAAB7Indhc19maXJzdF9ldmVudCI6ZmFsc2UsImltYWdlX2lkIjpbMjk0ODYzMDc5MiwyNDgyMTM2NzExLDE1MTI2MTg2OTIsMzE5NzA4MjQxOCw4MjA5NjM4NjgsNDYzMjQzMDA1LDI4MTUxMzAwNDUsMzgzNTM1NDY1N10sInFmIjp7ImIiOlswLDQsMCwwLDAsMCwwLDAsMCwxNiwwLDAsMCwwLDAsMCwwLDAsMTI4LDkwLDE3Myw2LDAsMCwwLDAsMCwwLDAsMCwwLDAsMCwwLDAsMCwwLDAsMCwwLDAsMCwwLDAsMCwwLDAsMCwwLDAsMCwwLDAsMCwwLDAsMCwwLDAsMCwwLDAsMCwwLDAsMCwwLDAsMCwwLDAsMCwwXSwibCI6MywicSI6NiwiciI6N319AAAAAAAAAAAAAAAAAAAAAAAAAAAAAAAAAAAAAAAAAAAA'}}
prove_3;54;58;Mul;3132;4476;4476.0;849;0.07299808300012955;{'verificationValue': 4476.0, 'proof': {'imageId': [2948630792, 2482136711, 1512618692, 3197082418, 820963868, 463243005, 2815130045, 3835354657], 'receipt': 'AwAAAAAAAAAAAAAAxAciAPPsD8genbvcCN2DvDmorNgPyU2p6hAM/h+8IU0pSDuhAAAAAAAAAAAAAAAAAAAAAAAAAAAAAAAAAAAAAAAAAAAAAAAAAAAAAAAAAAAAAAAAAQAAAAAAAAAAAAAAAAAAAAAAAAAAAAAAAAAAAAAAAAAAAAAAAAAAAAEAAAAARAEAAAAAAAAGAAAANDQ3Ni4wAAA0AQAAeyJ3YXNfZmlyc3RfZXZlbnQiOmZhbHNlLCJpbWFnZV9pZCI6WzI5NDg2MzA3OTIsMjQ4MjEzNjcxMSwxNTEyNjE4NjkyLDMxOTcwODI0MTgsODIwOTYzODY4LDQ2MzI0MzAwNSwyODE1MTMwMDQ1LDM4MzUzNTQ2NTddLCJxZiI6eyJiIjpbMCw0LDAsMCwwLDAsMCwwLDAsMzIsMCwwLDAsMCwwLDAsMCwwLDEyOCw5MCwxNzMsODYsMywwLDAsMCwwLDAsMCwwLDAsMCwwLDAsMCwwLDAsMCwwLDAsMCwwLDAsMCwwLDAsMCwwLDAsMCwwLDAsMCwwLDAsMCwwLDAsMCwwLDAsMCwwLDAsMCwwLDAsMCwwLDAsMCwwLDBdLCJsIjo0LCJxIjo2LCJyIjo3fX0AAAAAAAAAAAAAAABEAQAAAAAAAAYAAAA0NDc2LjAAADQBAAB7Indhc19maXJzdF9ldmVudCI6ZmFsc2UsImltYWdlX2lkIjpbMjk0ODYzMDc5MiwyNDgyMTM2NzExLDE1MTI2MTg2OTIsMzE5NzA4MjQxOCw4MjA5NjM4NjgsNDYzMjQzMDA1LDI4MTUxMzAwNDUsMzgzNTM1NDY1N10sInFmIjp7ImIiOlswLDQsMCwwLDAsMCwwLDAsMCwzMiwwLDAsMCwwLDAsMCwwLDAsMTI4LDkwLDE3Myw4NiwzLDAsMCwwLDAsMCwwLDAsMCwwLDAsMCwwLDAsMCwwLDAsMCwwLDAsMCwwLDAsMCwwLDAsMCwwLDAsMCwwLDAsMCwwLDAsMCwwLDAsMCwwLDAsMCwwLDAsMCwwLDAsMCwwLDAsMF0sImwiOjQsInEiOjYsInIiOjd9fQAAAAAAAAAAAAAAAAAAAAAAAAAAAAAAAAAAAAAAAAAA'}}
prove_4;20;59;Mul;1180;5656;5656.0;857;0.07410125000023982;{'verificationValue': 5656.0, 'proof': {'imageId': [2948630792, 2482136711, 1512618692, 3197082418, 820963868, 463243005, 2815130045, 3835354657], 'receipt': 'AwAAAAAAAAAAAAAAxAciAPPsD8genbvcCN2DvDmorNgPyU2p6hAM/h+8IU0pSDuhAAAAAAAAAAAAAAAAAAAAAAAAAAAAAAAAAAAAAAAAAAAAAAAAAAAAAAAAAAAAAAAAAQAAAAAAAAAAAAAAAAAAAAAAAAAAAAAAAAAAAAAAAAAAAAAAAAAAAAEAAAAASAEAAAAAAAAGAAAANTY1Ni4wAAA2AQAAeyJ3YXNfZmlyc3RfZXZlbnQiOmZhbHNlLCJpbWFnZV9pZCI6WzI5NDg2MzA3OTIsMjQ4MjEzNjcxMSwxNTEyNjE4NjkyLDMxOTcwODI0MTgsODIwOTYzODY4LDQ2MzI0MzAwNSwyODE1MTMwMDQ1LDM4MzUzNTQ2NTddLCJxZiI6eyJiIjpbMCw0LDAsMCwwLDAsMCwwLDAsNjQsMCwwLDAsMCwwLDAsMCwwLDEyOCw5MCwxNzMsODYsMTcxLDEsMCwwLDAsMCwwLDAsMCwwLDAsMCwwLDAsMCwwLDAsMCwwLDAsMCwwLDAsMCwwLDAsMCwwLDAsMCwwLDAsMCwwLDAsMCwwLDAsMCwwLDAsMCwwLDAsMCwwLDAsMCwwLDAsMF0sImwiOjUsInEiOjYsInIiOjd9fQAAAAAAAAAAAAAAAAAASAEAAAAAAAAGAAAANTY1Ni4wAAA2AQAAeyJ3YXNfZmlyc3RfZXZlbnQiOmZhbHNlLCJpbWFnZV9pZCI6WzI5NDg2MzA3OTIsMjQ4MjEzNjcxMSwxNTEyNjE4NjkyLDMxOTcwODI0MTgsODIwOTYzODY4LDQ2MzI0MzAwNSwyODE1MTMwMDQ1LDM4MzUzNTQ2NTddLCJxZiI6eyJiIjpbMCw0LDAsMCwwLDAsMCwwLDAsNjQsMCwwLDAsMCwwLDAsMCwwLDEyOCw5MCwxNzMsODYsMTcxLDEsMCwwLDAsMCwwLDAsMCwwLDAsMCwwLDAsMCwwLDAsMCwwLDAsMCwwLDAsMCwwLDAsMCwwLDAsMCwwLDAsMCwwLDAsMCwwLDAsMCwwLDAsMCwwLDAsMCwwLDAsMCwwLDAsMF0sImwiOjUsInEiOjYsInIiOjd9fQAAAAAAAAAAAAAAAAAAAAAAAAAAAAAAAAAAAAAAAAAAAAA='}}
prove_5;52;15;Mul;780;6436;6436.0;865;0.07546750000074098;{'verificationValue': 6436.0, 'proof': {'imageId': [2948630792, 2482136711, 1512618692, 3197082418, 820963868, 463243005, 2815130045, 3835354657], 'receipt': 'AwAAAAAAAAAAAAAAxAciAPPsD8genbvcCN2DvDmorNgPyU2p6hAM/h+8IU0pSDuhAAAAAAAAAAAAAAAAAAAAAAAAAAAAAAAAAAAAAAAAAAAAAAAAAAAAAAAAAAAAAAAAAQAAAAAAAAAAAAAAAAAAAAAAAAAAAAAAAAAAAAAAAAAAAAAAAAAAAAEAAAAATAEAAAAAAAAGAAAANjQzNi4wAAA5AQAAeyJ3YXNfZmlyc3RfZXZlbnQiOmZhbHNlLCJpbWFnZV9pZCI6WzI5NDg2MzA3OTIsMjQ4MjEzNjcxMSwxNTEyNjE4NjkyLDMxOTcwODI0MTgsODIwOTYzODY4LDQ2MzI0MzAwNSwyODE1MTMwMDQ1LDM4MzUzNTQ2NTddLCJxZiI6eyJiIjpbMCw0LDAsMCwwLDAsMCwwLDAsMTI4LDAsMCwwLDAsMCwwLDAsMCwxMjgsOTAsMTczLDg2LDE3MSwyMTMsMCwwLDAsMCwwLDAsMCwwLDAsMCwwLDAsMCwwLDAsMCwwLDAsMCwwLDAsMCwwLDAsMCwwLDAsMCwwLDAsMCwwLDAsMCwwLDAsMCwwLDAsMCwwLDAsMCwwLDAsMCwwLDAsMF0sImwiOjYsInEiOjYsInIiOjd9fQAAAAAAAAAAAAAAAAAAAEwBAAAAAAAABgAAADY0MzYuMAAAOQEAAHsid2FzX2ZpcnN0X2V2ZW50IjpmYWxzZSwiaW1hZ2VfaWQiOlsyOTQ4NjMwNzkyLDI0ODIxMzY3MTEsMTUxMjYxODY5MiwzMTk3MDgyNDE4LDgyMDk2Mzg2OCw0NjMyNDMwMDUsMjgxNTEzMDA0NSwzODM1MzU0NjU3XSwicWYiOnsiYiI6WzAsNCwwLDAsMCwwLDAsMCwwLDEyOCwwLDAsMCwwLDAsMCwwLDAsMTI4LDkwLDE3Myw4NiwxNzEsMjEzLDAsMCwwLDAsMCwwLDAsMCwwLDAsMCwwLDAsMCwwLDAsMCwwLDAsMCwwLDAsMCwwLDAsMCwwLDAsMCwwLDAsMCwwLDAsMCwwLDAsMCwwLDAsMCwwLDAsMCwwLDAsMCwwLDBdLCJsIjo2LCJxIjo2LCJyIjo3fX0AAAAAAAAAAAAAAAAAAAAAAAAAAAAAAAAAAAAAAAAAAAAAAA=='}}
prove_6;88;38;Mul;3344;9780;9780.0;865;0.07378829100161965;{'verificationValue': 9780.0, 'proof': {'imageId': [2948630792, 2482136711, 1512618692, 3197082418, 820963868, 463243005, 2815130045, 3835354657], 'receipt': 'AwAAAAAAAAAAAAAAxAciAPPsD8genbvcCN2DvDmorNgPyU2p6hAM/h+8IU0pSDuhAAAAAAAAAAAAAAAAAAAAAAAAAAAAAAAAAAAAAAAAAAAAAAAAAAAAAAAAAAAAAAAAAQAAAAAAAAAAAAAAAAAAAAAAAAAAAAAAAAAAAAAAAAAAAAAAAAAAAAEAAAAATAEAAAAAAAAGAAAAOTc4MC4wAAA5AQAAeyJ3YXNfZmlyc3RfZXZlbnQiOmZhbHNlLCJpbWFnZV9pZCI6WzI5NDg2MzA3OTIsMjQ4MjEzNjcxMSwxNTEyNjE4NjkyLDMxOTcwODI0MTgsODIwOTYzODY4LDQ2MzI0MzAwNSwyODE1MTMwMDQ1LDM4MzUzNTQ2NTddLCJxZiI6eyJiIjpbMCw0LDAsMCwwLDAsMCwwLDAsMCwxLDAsMCwwLDAsMCwwLDAsMTI4LDkwLDE3Myw4NiwxNzEsMjEzLDEwNiwwLDAsMCwwLDAsMCwwLDAsMCwwLDAsMCwwLDAsMCwwLDAsMCwwLDAsMCwwLDAsMCwwLDAsMCwwLDAsMCwwLDAsMCwwLDAsMCwwLDAsMCwwLDAsMCwwLDAsMCwwLDAsMF0sImwiOjcsInEiOjYsInIiOjd9fQAAAAAAAAAAAAAAAAAAAEwBAAAAAAAABgAAADk3ODAuMAAAOQEAAHsid2FzX2ZpcnN0X2V2ZW50IjpmYWxzZSwiaW1hZ2VfaWQiOlsyOTQ4NjMwNzkyLDI0ODIxMzY3MTEsMTUxMjYxODY5MiwzMTk3MDgyNDE4LDgyMDk2Mzg2OCw0NjMyNDMwMDUsMjgxNTEzMDA0NSwzODM1MzU0NjU3XSwicWYiOnsiYiI6WzAsNCwwLDAsMCwwLDAsMCwwLDAsMSwwLDAsMCwwLDAsMCwwLDEyOCw5MCwxNzMsODYsMTcxLDIxMywxMDYsMCwwLDAsMCwwLDAsMCwwLDAsMCwwLDAsMCwwLDAsMCwwLDAsMCwwLDAsMCwwLDAsMCwwLDAsMCwwLDAsMCwwLDAsMCwwLDAsMCwwLDAsMCwwLDAsMCwwLDAsMCwwLDBdLCJsIjo3LCJxIjo2LCJyIjo3fX0AAAAAAAAAAAAAAAAAAAAAAAAAAAAAAAAAAAAAAAAAAAAAAA=='}}
prove_7;89;61;Mul;5429;15209;15209.0;865;0.0729315829994448;{'verificationValue': 15209.0, 'proof': {'imageId': [2948630792, 2482136711, 1512618692, 3197082418, 820963868, 463243005, 2815130045, 3835354657], 'receipt': 'AwAAAAAAAAAAAAAAxAciAPPsD8genbvcCN2DvDmorNgPyU2p6hAM/h+8IU0pSDuhAAAAAAAAAAAAAAAAAAAAAAAAAAAAAAAAAAAAAAAAAAAAAAAAAAAAAAAAAAAAAAAAAQAAAAAAAAAAAAAAAAAAAAAAAAAAAAAAAAAAAAAAAAAAAAAAAAAAAAEAAAAATAEAAAAAAAAHAAAAMTUyMDkuMAA6AQAAeyJ3YXNfZmlyc3RfZXZlbnQiOmZhbHNlLCJpbWFnZV9pZCI6WzI5NDg2MzA3OTIsMjQ4MjEzNjcxMSwxNTEyNjE4NjkyLDMxOTcwODI0MTgsODIwOTYzODY4LDQ2MzI0MzAwNSwyODE1MTMwMDQ1LDM4MzUzNTQ2NTddLCJxZiI6eyJiIjpbMCw0LDAsMCwwLDAsMCwwLDAsMCwyLDAsMCwwLDAsMCwwLDAsMTI4LDkwLDE3Myw4NiwxNzEsMjEzLDEwNiw1MywwLDAsMCwwLDAsMCwwLDAsMCwwLDAsMCwwLDAsMCwwLDAsMCwwLDAsMCwwLDAsMCwwLDAsMCwwLDAsMCwwLDAsMCwwLDAsMCwwLDAsMCwwLDAsMCwwLDAsMCwwLDBdLCJsIjo4LCJxIjo2LCJyIjo3fX0AAAAAAAAAAAAAAAAAAEwBAAAAAAAABwAAADE1MjA5LjAAOgEAAHsid2FzX2ZpcnN0X2V2ZW50IjpmYWxzZSwiaW1hZ2VfaWQiOlsyOTQ4NjMwNzkyLDI0ODIxMzY3MTEsMTUxMjYxODY5MiwzMTk3MDgyNDE4LDgyMDk2Mzg2OCw0NjMyNDMwMDUsMjgxNTEzMDA0NSwzODM1MzU0NjU3XSwicWYiOnsiYiI6WzAsNCwwLDAsMCwwLDAsMCwwLDAsMiwwLDAsMCwwLDAsMCwwLDEyOCw5MCwxNzMsODYsMTcxLDIxMywxMDYsNTMsMCwwLDAsMCwwLDAsMCwwLDAsMCwwLDAsMCwwLDAsMCwwLDAsMCwwLDAsMCwwLDAsMCwwLDAsMCwwLDAsMCwwLDAsMCwwLDAsMCwwLDAsMCwwLDAsMCwwLDAsMCwwXSwibCI6OCwicSI6NiwiciI6N319AAAAAAAAAAAAAAAAAAAAAAAAAAAAAAAAAAAAAAAAAAAAAA=='}}
prove_8;3;72;Mul;216;15425;15425.0;865;0.07204579099925468;{'verificationValue': 15425.0, 'proof': {'imageId': [2948630792, 2482136711, 1512618692, 3197082418, 820963868, 463243005, 2815130045, 3835354657], 'receipt': 'AwAAAAAAAAAAAAAAxAciAPPsD8genbvcCN2DvDmorNgPyU2p6hAM/h+8IU0pSDuhAAAAAAAAAAAAAAAAAAAAAAAAAAAAAAAAAAAAAAAAAAAAAAAAAAAAAAAAAAAAAAAAAQAAAAAAAAAAAAAAAAAAAAAAAAAAAAAAAAAAAAAAAAAAAAAAAAAAAAEAAAAATAEAAAAAAAAHAAAAMTU0MjUuMAA8AQAAeyJ3YXNfZmlyc3RfZXZlbnQiOmZhbHNlLCJpbWFnZV9pZCI6WzI5NDg2MzA3OTIsMjQ4MjEzNjcxMSwxNTEyNjE4NjkyLDMxOTcwODI0MTgsODIwOTYzODY4LDQ2MzI0MzAwNSwyODE1MTMwMDQ1LDM4MzUzNTQ2NTddLCJxZiI6eyJiIjpbMCw0LDAsMCwwLDAsMCwwLDAsMCw0LDAsMCwwLDAsMCwwLDAsMTI4LDkwLDE3Myw4NiwxNzEsMjEzLDEwNiwxODEsMjYsMCwwLDAsMCwwLDAsMCwwLDAsMCwwLDAsMCwwLDAsMCwwLDAsMCwwLDAsMCwwLDAsMCwwLDAsMCwwLDAsMCwwLDAsMCwwLDAsMCwwLDAsMCwwLDAsMCwwLDAsMF0sImwiOjksInEiOjYsInIiOjd9fQAAAAAAAAAAAAAAAEwBAAAAAAAABwAAADE1NDI1LjAAPAEAAHsid2FzX2ZpcnN0X2V2ZW50IjpmYWxzZSwiaW1hZ2VfaWQiOlsyOTQ4NjMwNzkyLDI0ODIxMzY3MTEsMTUxMjYxODY5MiwzMTk3MDgyNDE4LDgyMDk2Mzg2OCw0NjMyNDMwMDUsMjgxNTEzMDA0NSwzODM1MzU0NjU3XSwicWYiOnsiYiI6WzAsNCwwLDAsMCwwLDAsMCwwLDAsNCwwLDAsMCwwLDAsMCwwLDEyOCw5MCwxNzMsODYsMTcxLDIxMywxMDYsMTgxLDI2LDAsMCwwLDAsMCwwLDAsMCwwLDAsMCwwLDAsMCwwLDAsMCwwLDAsMCwwLDAsMCwwLDAsMCwwLDAsMCwwLDAsMCwwLDAsMCwwLDAsMCwwLDAsMCwwLDAsMCwwLDBdLCJsIjo5LCJxIjo2LCJyIjo3fX0AAAAAAAAAAAAAAAAAAAAAAAAAAAAAAAAAAAAAAAAAAA=='}}
prove_9;2;77;Mul;154;15579;15579.0;873;0.0728369999997085;{'verificationValue': 15579.0, 'proof': {'imageId': [2948630792, 2482136711, 1512618692, 3197082418, 820963868, 463243005, 2815130045, 3835354657], 'receipt': 'AwAAAAAAAAAAAAAAxAciAPPsD8genbvcCN2DvDmorNgPyU2p6hAM/h+8IU0pSDuhAAAAAAAAAAAAAAAAAAAAAAAAAAAAAAAAAAAAAAAAAAAAAAAAAAAAAAAAAAAAAAAAAQAAAAAAAAAAAAAAAAAAAAAAAAAAAAAAAAAAAAAAAAAAAAAAAAAAAAEAAAAAUAEAAAAAAAAHAAAAMTU1NzkuMAA+AQAAeyJ3YXNfZmlyc3RfZXZlbnQiOmZhbHNlLCJpbWFnZV9pZCI6WzI5NDg2MzA3OTIsMjQ4MjEzNjcxMSwxNTEyNjE4NjkyLDMxOTcwODI0MTgsODIwOTYzODY4LDQ2MzI0MzAwNSwyODE1MTMwMDQ1LDM4MzUzNTQ2NTddLCJxZiI6eyJiIjpbMCw0LDAsMCwwLDAsMCwwLDAsMCw4LDAsMCwwLDAsMCwwLDAsMTI4LDkwLDE3Myw4NiwxNzEsMjEzLDEwNiwxODEsOTAsMTMsMCwwLDAsMCwwLDAsMCwwLDAsMCwwLDAsMCwwLDAsMCwwLDAsMCwwLDAsMCwwLDAsMCwwLDAsMCwwLDAsMCwwLDAsMCwwLDAsMCwwLDAsMCwwLDAsMCwwLDBdLCJsIjoxMCwicSI6NiwiciI6N319AAAAAAAAAAAAAAAAAABQAQAAAAAAAAcAAAAxNTU3OS4wAD4BAAB7Indhc19maXJzdF9ldmVudCI6ZmFsc2UsImltYWdlX2lkIjpbMjk0ODYzMDc5MiwyNDgyMTM2NzExLDE1MTI2MTg2OTIsMzE5NzA4MjQxOCw4MjA5NjM4NjgsNDYzMjQzMDA1LDI4MTUxMzAwNDUsMzgzNTM1NDY1N10sInFmIjp7ImIiOlswLDQsMCwwLDAsMCwwLDAsMCwwLDgsMCwwLDAsMCwwLDAsMCwxMjgsOTAsMTczLDg2LDE3MSwyMTMsMTA2LDE4MSw5MCwxMywwLDAsMCwwLDAsMCwwLDAsMCwwLDAsMCwwLDAsMCwwLDAsMCwwLDAsMCwwLDAsMCwwLDAsMCwwLDAsMCwwLDAsMCwwLDAsMCwwLDAsMCwwLDAsMCwwLDAsMF0sImwiOjEwLCJxIjo2LCJyIjo3fX0AAAAAAAAAAAAAAAAAAAAAAAAAAAAAAAAAAAAAAAAAAAAA'}}
prove_10;91;38;Mul;3458;19037;19037.0;873;0.07330629100033548;{'verificationValue': 19037.0, 'proof': {'imageId': [2948630792, 2482136711, 1512618692, 3197082418, 820963868, 463243005, 2815130045, 3835354657], 'receipt': 'AwAAAAAAAAAAAAAAxAciAPPsD8genbvcCN2DvDmorNgPyU2p6hAM/h+8IU0pSDuhAAAAAAAAAAAAAAAAAAAAAAAAAAAAAAAAAAAAAAAAAAAAAAAAAAAAAAAAAAAAAAAAAQAAAAAAAAAAAAAAAAAAAAAAAAAAAAAAAAAAAAAAAAAAAAAAAAAAAAEAAAAAUAEAAAAAAAAHAAAAMTkwMzcuMABAAQAAeyJ3YXNfZmlyc3RfZXZlbnQiOmZhbHNlLCJpbWFnZV9pZCI6WzI5NDg2MzA3OTIsMjQ4MjEzNjcxMSwxNTEyNjE4NjkyLDMxOTcwODI0MTgsODIwOTYzODY4LDQ2MzI0MzAwNSwyODE1MTMwMDQ1LDM4MzUzNTQ2NTddLCJxZiI6eyJiIjpbMCw0LDAsMCwwLDAsMCwwLDAsMCwxNiwwLDAsMCwwLDAsMCwwLDEyOCw5MCwxNzMsODYsMTcxLDIxMywxMDYsMTgxLDkwLDE3Myw2LDAsMCwwLDAsMCwwLDAsMCwwLDAsMCwwLDAsMCwwLDAsMCwwLDAsMCwwLDAsMCwwLDAsMCwwLDAsMCwwLDAsMCwwLDAsMCwwLDAsMCwwLDAsMCwwLDAsMF0sImwiOjExLCJxIjo2LCJyIjo3fX0AAAAAAAAAAAAAAABQAQAAAAAAAAcAAAAxOTAzNy4wAEABAAB7Indhc19maXJzdF9ldmVudCI6ZmFsc2UsImltYWdlX2lkIjpbMjk0ODYzMDc5MiwyNDgyMTM2NzExLDE1MTI2MTg2OTIsMzE5NzA4MjQxOCw4MjA5NjM4NjgsNDYzMjQzMDA1LDI4MTUxMzAwNDUsMzgzNTM1NDY1N10sInFmIjp7ImIiOlswLDQsMCwwLDAsMCwwLDAsMCwwLDE2LDAsMCwwLDAsMCwwLDAsMTI4LDkwLDE3Myw4NiwxNzEsMjEzLDEwNiwxODEsOTAsMTczLDYsMCwwLDAsMCwwLDAsMCwwLDAsMCwwLDAsMCwwLDAsMCwwLDAsMCwwLDAsMCwwLDAsMCwwLDAsMCwwLDAsMCwwLDAsMCwwLDAsMCwwLDAsMCwwLDAsMCwwXSwibCI6MTEsInEiOjYsInIiOjd9fQAAAAAAAAAAAAAAAAAAAAAAAAAAAAAAAAAAAAAAAAAA'}}
prove_11;30;19;Mul;570;19607;19607.0;881;0.07254350000039267;{'verificationValue': 19607.0, 'proof': {'imageId': [2948630792, 2482136711, 1512618692, 3197082418, 820963868, 463243005, 2815130045, 3835354657], 'receipt': 'AwAAAAAAAAAAAAAAxAciAPPsD8genbvcCN2DvDmorNgPyU2p6hAM/h+8IU0pSDuhAAAAAAAAAAAAAAAAAAAAAAAAAAAAAAAAAAAAAAAAAAAAAAAAAAAAAAAAAAAAAAAAAQAAAAAAAAAAAAAAAAAAAAAAAAAAAAAAAAAAAAAAAAAAAAAAAAAAAAEAAAAAVAEAAAAAAAAHAAAAMTk2MDcuMABBAQAAeyJ3YXNfZmlyc3RfZXZlbnQiOmZhbHNlLCJpbWFnZV9pZCI6WzI5NDg2MzA3OTIsMjQ4MjEzNjcxMSwxNTEyNjE4NjkyLDMxOTcwODI0MTgsODIwOTYzODY4LDQ2MzI0MzAwNSwyODE1MTMwMDQ1LDM4MzUzNTQ2NTddLCJxZiI6eyJiIjpbMCw0LDAsMCwwLDAsMCwwLDAsMCwzMiwwLDAsMCwwLDAsMCwwLDEyOCw5MCwxNzMsODYsMTcxLDIxMywxMDYsMTgxLDkwLDE3Myw4NiwzLDAsMCwwLDAsMCwwLDAsMCwwLDAsMCwwLDAsMCwwLDAsMCwwLDAsMCwwLDAsMCwwLDAsMCwwLDAsMCwwLDAsMCwwLDAsMCwwLDAsMCwwLDAsMCwwLDBdLCJsIjoxMiwicSI6NiwiciI6N319AAAAAAAAAAAAAAAAAAAAVAEAAAAAAAAHAAAAMTk2MDcuMABBAQAAeyJ3YXNfZmlyc3RfZXZlbnQiOmZhbHNlLCJpbWFnZV9pZCI6WzI5NDg2MzA3OTIsMjQ4MjEzNjcxMSwxNTEyNjE4NjkyLDMxOTcwODI0MTgsODIwOTYzODY4LDQ2MzI0MzAwNSwyODE1MTMwMDQ1LDM4MzUzNTQ2NTddLCJxZiI6eyJiIjpbMCw0LDAsMCwwLDAsMCwwLDAsMCwzMiwwLDAsMCwwLDAsMCwwLDEyOCw5MCwxNzMsODYsMTcxLDIxMywxMDYsMTgxLDkwLDE3Myw4NiwzLDAsMCwwLDAsMCwwLDAsMCwwLDAsMCwwLDAsMCwwLDAsMCwwLDAsMCwwLDAsMCwwLDAsMCwwLDAsMCwwLDAsMCwwLDAsMCwwLDAsMCwwLDAsMCwwLDBdLCJsIjoxMiwicSI6NiwiciI6N319AAAAAAAAAAAAAAAAAAAAAAAAAAAAAAAAAAAAAAAAAAAAAAA='}}
prove_12;6;75;Mul;450;20057;20057.0;881;0.0725531249991036;{'verificationValue': 20057.0, 'proof': {'imageId': [2948630792, 2482136711, 1512618692, 3197082418, 820963868, 463243005, 2815130045, 3835354657], 'receipt': 'AwAAAAAAAAAAAAAAxAciAPPsD8genbvcCN2DvDmorNgPyU2p6hAM/h+8IU0pSDuhAAAAAAAAAAAAAAAAAAAAAAAAAAAAAAAAAAAAAAAAAAAAAAAAAAAAAAAAAAAAAAAAAQAAAAAAAAAAAAAAAAAAAAAAAAAAAAAAAAAAAAAAAAAAAAAAAAAAAAEAAAAAVAEAAAAAAAAHAAAAMjAwNTcuMABDAQAAeyJ3YXNfZmlyc3RfZXZlbnQiOmZhbHNlLCJpbWFnZV9pZCI6WzI5NDg2MzA3OTIsMjQ4MjEzNjcxMSwxNTEyNjE4NjkyLDMxOTcwODI0MTgsODIwOTYzODY4LDQ2MzI0MzAwNSwyODE1MTMwMDQ1LDM4MzUzNTQ2NTddLCJxZiI6eyJiIjpbMCw0LDAsMCwwLDAsMCwwLDAsMCw2NCwwLDAsMCwwLDAsMCwwLDEyOCw5MCwxNzMsODYsMTcxLDIxMywxMDYsMTgxLDkwLDE3Myw4NiwxNzEsMSwwLDAsMCwwLDAsMCwwLDAsMCwwLDAsMCwwLDAsMCwwLDAsMCwwLDAsMCwwLDAsMCwwLDAsMCwwLDAsMCwwLDAsMCwwLDAsMCwwLDAsMCwwLDAsMF0sImwiOjEzLCJxIjo2LCJyIjo3fX0AAAAAAAAAAAAAAAAAVAEAAAAAAAAHAAAAMjAwNTcuMABDAQAAeyJ3YXNfZmlyc3RfZXZlbnQiOmZhbHNlLCJpbWFnZV9pZCI6WzI5NDg2MzA3OTIsMjQ4MjEzNjcxMSwxNTEyNjE4NjkyLDMxOTcwODI0MTgsODIwOTYzODY4LDQ2MzI0MzAwNSwyODE1MTMwMDQ1LDM4MzUzNTQ2NTddLCJxZiI6eyJiIjpbMCw0LDAsMCwwLDAsMCwwLDAsMCw2NCwwLDAsMCwwLDAsMCwwLDEyOCw5MCwxNzMsODYsMTcxLDIxMywxMDYsMTgxLDkwLDE3Myw4NiwxNzEsMSwwLDAsMCwwLDAsMCwwLDAsMCwwLDAsMCwwLDAsMCwwLDAsMCwwLDAsMCwwLDAsMCwwLDAsMCwwLDAsMCwwLDAsMCwwLDAsMCwwLDAsMCwwLDAsMF0sImwiOjEzLCJxIjo2LCJyIjo3fX0AAAAAAAAAAAAAAAAAAAAAAAAAAAAAAAAAAAAAAAAAAAA='}}
prove_13;40;8;Mul;320;20377;20377.0;889;0.07288974999937636;{'verificationValue': 20377.0, 'proof': {'imageId': [2948630792, 2482136711, 1512618692, 3197082418, 820963868, 463243005, 2815130045, 3835354657], 'receipt': 'AwAAAAAAAAAAAAAAxAciAPPsD8genbvcCN2DvDmorNgPyU2p6hAM/h+8IU0pSDuhAAAAAAAAAAAAAAAAAAAAAAAAAAAAAAAAAAAAAAAAAAAAAAAAAAAAAAAAAAAAAAAAAQAAAAAAAAAAAAAAAAAAAAAAAAAAAAAAAAAAAAAAAAAAAAAAAAAAAAEAAAAAWAEAAAAAAAAHAAAAMjAzNzcuMABGAQAAeyJ3YXNfZmlyc3RfZXZlbnQiOmZhbHNlLCJpbWFnZV9pZCI6WzI5NDg2MzA3OTIsMjQ4MjEzNjcxMSwxNTEyNjE4NjkyLDMxOTcwODI0MTgsODIwOTYzODY4LDQ2MzI0MzAwNSwyODE1MTMwMDQ1LDM4MzUzNTQ2NTddLCJxZiI6eyJiIjpbMCw0LDAsMCwwLDAsMCwwLDAsMCwxMjgsMCwwLDAsMCwwLDAsMCwxMjgsOTAsMTczLDg2LDE3MSwyMTMsMTA2LDE4MSw5MCwxNzMsODYsMTcxLDIxMywwLDAsMCwwLDAsMCwwLDAsMCwwLDAsMCwwLDAsMCwwLDAsMCwwLDAsMCwwLDAsMCwwLDAsMCwwLDAsMCwwLDAsMCwwLDAsMCwwLDAsMCwwLDAsMF0sImwiOjE0LCJxIjo2LCJyIjo3fX0AAAAAAAAAAAAAAAAAAFgBAAAAAAAABwAAADIwMzc3LjAARgEAAHsid2FzX2ZpcnN0X2V2ZW50IjpmYWxzZSwiaW1hZ2VfaWQiOlsyOTQ4NjMwNzkyLDI0ODIxMzY3MTEsMTUxMjYxODY5MiwzMTk3MDgyNDE4LDgyMDk2Mzg2OCw0NjMyNDMwMDUsMjgxNTEzMDA0NSwzODM1MzU0NjU3XSwicWYiOnsiYiI6WzAsNCwwLDAsMCwwLDAsMCwwLDAsMTI4LDAsMCwwLDAsMCwwLDAsMTI4LDkwLDE3Myw4NiwxNzEsMjEzLDEwNiwxODEsOTAsMTczLDg2LDE3MSwyMTMsMCwwLDAsMCwwLDAsMCwwLDAsMCwwLDAsMCwwLDAsMCwwLDAsMCwwLDAsMCwwLDAsMCwwLDAsMCwwLDAsMCwwLDAsMCwwLDAsMCwwLDAsMCwwLDBdLCJsIjoxNCwicSI6NiwiciI6N319AAAAAAAAAAAAAAAAAAAAAAAAAAAAAAAAAAAAAAAAAAAAAA=='}}
prove_14;79;5;Mul;395;20772;20772.0;889;0.07194274999892514;{'verificationValue': 20772.0, 'proof': {'imageId': [2948630792, 2482136711, 1512618692, 3197082418, 820963868, 463243005, 2815130045, 3835354657], 'receipt': 'AwAAAAAAAAAAAAAAxAciAPPsD8genbvcCN2DvDmorNgPyU2p6hAM/h+8IU0pSDuhAAAAAAAAAAAAAAAAAAAAAAAAAAAAAAAAAAAAAAAAAAAAAAAAAAAAAAAAAAAAAAAAAQAAAAAAAAAAAAAAAAAAAAAAAAAAAAAAAAAAAAAAAAAAAAAAAAAAAAEAAAAAWAEAAAAAAAAHAAAAMjA3NzIuMABGAQAAeyJ3YXNfZmlyc3RfZXZlbnQiOmZhbHNlLCJpbWFnZV9pZCI6WzI5NDg2MzA3OTIsMjQ4MjEzNjcxMSwxNTEyNjE4NjkyLDMxOTcwODI0MTgsODIwOTYzODY4LDQ2MzI0MzAwNSwyODE1MTMwMDQ1LDM4MzUzNTQ2NTddLCJxZiI6eyJiIjpbMCw0LDAsMCwwLDAsMCwwLDAsMCwwLDEsMCwwLDAsMCwwLDAsMTI4LDkwLDE3Myw4NiwxNzEsMjEzLDEwNiwxODEsOTAsMTczLDg2LDE3MSwyMTMsMTA2LDAsMCwwLDAsMCwwLDAsMCwwLDAsMCwwLDAsMCwwLDAsMCwwLDAsMCwwLDAsMCwwLDAsMCwwLDAsMCwwLDAsMCwwLDAsMCwwLDAsMCwwLDAsMF0sImwiOjE1LCJxIjo2LCJyIjo3fX0AAAAAAAAAAAAAAAAAAFgBAAAAAAAABwAAADIwNzcyLjAARgEAAHsid2FzX2ZpcnN0X2V2ZW50IjpmYWxzZSwiaW1hZ2VfaWQiOlsyOTQ4NjMwNzkyLDI0ODIxMzY3MTEsMTUxMjYxODY5MiwzMTk3MDgyNDE4LDgyMDk2Mzg2OCw0NjMyNDMwMDUsMjgxNTEzMDA0NSwzODM1MzU0NjU3XSwicWYiOnsiYiI6WzAsNCwwLDAsMCwwLDAsMCwwLDAsMCwxLDAsMCwwLDAsMCwwLDEyOCw5MCwxNzMsODYsMTcxLDIxMywxMDYsMTgxLDkwLDE3Myw4NiwxNzEsMjEzLDEwNiwwLDAsMCwwLDAsMCwwLDAsMCwwLDAsMCwwLDAsMCwwLDAsMCwwLDAsMCwwLDAsMCwwLDAsMCwwLDAsMCwwLDAsMCwwLDAsMCwwLDAsMCwwLDBdLCJsIjoxNSwicSI6NiwiciI6N319AAAAAAAAAAAAAAAAAAAAAAAAAAAAAAAAAAAAAAAAAAAAAA=='}}
prove_15;17;73;Mul;1241;22013;22013.0;889;0.07297800000014831;{'verificationValue': 22013.0, 'proof': {'imageId': [2948630792, 2482136711, 1512618692, 3197082418, 820963868, 463243005, 2815130045, 3835354657], 'receipt': 'AwAAAAAAAAAAAAAAxAciAPPsD8genbvcCN2DvDmorNgPyU2p6hAM/h+8IU0pSDuhAAAAAAAAAAAAAAAAAAAAAAAAAAAAAAAAAAAAAAAAAAAAAAAAAAAAAAAAAAAAAAAAAQAAAAAAAAAAAAAAAAAAAAAAAAAAAAAAAAAAAAAAAAAAAAAAAAAAAAEAAAAAWAEAAAAAAAAHAAAAMjIwMTMuMABHAQAAeyJ3YXNfZmlyc3RfZXZlbnQiOmZhbHNlLCJpbWFnZV9pZCI6WzI5NDg2MzA3OTIsMjQ4MjEzNjcxMSwxNTEyNjE4NjkyLDMxOTcwODI0MTgsODIwOTYzODY4LDQ2MzI0MzAwNSwyODE1MTMwMDQ1LDM4MzUzNTQ2NTddLCJxZiI6eyJiIjpbMCw0LDAsMCwwLDAsMCwwLDAsMCwwLDIsMCwwLDAsMCwwLDAsMTI4LDkwLDE3Myw4NiwxNzEsMjEzLDEwNiwxODEsOTAsMTczLDg2LDE3MSwyMTMsMTA2LDUzLDAsMCwwLDAsMCwwLDAsMCwwLDAsMCwwLDAsMCwwLDAsMCwwLDAsMCwwLDAsMCwwLDAsMCwwLDAsMCwwLDAsMCwwLDAsMCwwLDAsMCwwLDBdLCJsIjoxNiwicSI6NiwiciI6N319AAAAAAAAAAAAAAAAAFgBAAAAAAAABwAAADIyMDEzLjAARwEAAHsid2FzX2ZpcnN0X2V2ZW50IjpmYWxzZSwiaW1hZ2VfaWQiOlsyOTQ4NjMwNzkyLDI0ODIxMzY3MTEsMTUxMjYxODY5MiwzMTk3MDgyNDE4LDgyMDk2Mzg2OCw0NjMyNDMwMDUsMjgxNTEzMDA0NSwzODM1MzU0NjU3XSwicWYiOnsiYiI6WzAsNCwwLDAsMCwwLDAsMCwwLDAsMCwyLDAsMCwwLDAsMCwwLDEyOCw5MCwxNzMsODYsMTcxLDIxMywxMDYsMTgxLDkwLDE3Myw4NiwxNzEsMjEzLDEwNiw1MywwLDAsMCwwLDAsMCwwLDAsMCwwLDAsMCwwLDAsMCwwLDAsMCwwLDAsMCwwLDAsMCwwLDAsMCwwLDAsMCwwLDAsMCwwLDAsMCwwLDAsMCwwXSwibCI6MTYsInEiOjYsInIiOjd9fQAAAAAAAAAAAAAAAAAAAAAAAAAAAAAAAAAAAAAAAAAAAA=='}}
prove_16;19;9;Mul;171;22184;22184.0;897;0.07216054200034705;{'verificationValue': 22184.0, 'proof': {'imageId': [2948630792, 2482136711, 1512618692, 3197082418, 820963868, 463243005, 2815130045, 3835354657], 'receipt': 'AwAAAAAAAAAAAAAAxAciAPPsD8genbvcCN2DvDmorNgPyU2p6hAM/h+8IU0pSDuhAAAAAAAAAAAAAAAAAAAAAAAAAAAAAAAAAAAAAAAAAAAAAAAAAAAAAAAAAAAAAAAAAQAAAAAAAAAAAAAAAAAAAAAAAAAAAAAAAAAAAAAAAAAAAAAAAAAAAAEAAAAAXAEAAAAAAAAHAAAAMjIxODQuMABJAQAAeyJ3YXNfZmlyc3RfZXZlbnQiOmZhbHNlLCJpbWFnZV9pZCI6WzI5NDg2MzA3OTIsMjQ4MjEzNjcxMSwxNTEyNjE4NjkyLDMxOTcwODI0MTgsODIwOTYzODY4LDQ2MzI0MzAwNSwyODE1MTMwMDQ1LDM4MzUzNTQ2NTddLCJxZiI6eyJiIjpbMCw0LDAsMCwwLDAsMCwwLDAsMCwwLDQsMCwwLDAsMCwwLDAsMTI4LDkwLDE3Myw4NiwxNzEsMjEzLDEwNiwxODEsOTAsMTczLDg2LDE3MSwyMTMsMTA2LDE4MSwyNiwwLDAsMCwwLDAsMCwwLDAsMCwwLDAsMCwwLDAsMCwwLDAsMCwwLDAsMCwwLDAsMCwwLDAsMCwwLDAsMCwwLDAsMCwwLDAsMCwwLDAsMF0sImwiOjE3LCJxIjo2LCJyIjo3fX0AAAAAAAAAAAAAAAAAAABcAQAAAAAAAAcAAAAyMjE4NC4wAEkBAAB7Indhc19maXJzdF9ldmVudCI6ZmFsc2UsImltYWdlX2lkIjpbMjk0ODYzMDc5MiwyNDgyMTM2NzExLDE1MTI2MTg2OTIsMzE5NzA4MjQxOCw4MjA5NjM4NjgsNDYzMjQzMDA1LDI4MTUxMzAwNDUsMzgzNTM1NDY1N10sInFmIjp7ImIiOlswLDQsMCwwLDAsMCwwLDAsMCwwLDAsNCwwLDAsMCwwLDAsMCwxMjgsOTAsMTczLDg2LDE3MSwyMTMsMTA2LDE4MSw5MCwxNzMsODYsMTcxLDIxMywxMDYsMTgxLDI2LDAsMCwwLDAsMCwwLDAsMCwwLDAsMCwwLDAsMCwwLDAsMCwwLDAsMCwwLDAsMCwwLDAsMCwwLDAsMCwwLDAsMCwwLDAsMCwwLDAsMCwwXSwibCI6MTcsInEiOjYsInIiOjd9fQAAAAAAAAAAAAAAAAAAAAAAAAAAAAAAAAAAAAAAAAAAAAAA'}}
prove_17;73;5;Mul;365;22549;22549.0;897;0.0725075829996058;{'verificationValue': 22549.0, 'proof': {'imageId': [2948630792, 2482136711, 1512618692, 3197082418, 820963868, 463243005, 2815130045, 3835354657], 'receipt': 'AwAAAAAAAAAAAAAAxAciAPPsD8genbvcCN2DvDmorNgPyU2p6hAM/h+8IU0pSDuhAAAAAAAAAAAAAAAAAAAAAAAAAAAAAAAAAAAAAAAAAAAAAAAAAAAAAAAAAAAAAAAAAQAAAAAAAAAAAAAAAAAAAAAAAAAAAAAAAAAAAAAAAAAAAAAAAAAAAAEAAAAAXAEAAAAAAAAHAAAAMjI1NDkuMABKAQAAeyJ3YXNfZmlyc3RfZXZlbnQiOmZhbHNlLCJpbWFnZV9pZCI6WzI5NDg2MzA3OTIsMjQ4MjEzNjcxMSwxNTEyNjE4NjkyLDMxOTcwODI0MTgsODIwOTYzODY4LDQ2MzI0MzAwNSwyODE1MTMwMDQ1LDM4MzUzNTQ2NTddLCJxZiI6eyJiIjpbMCw0LDAsMCwwLDAsMCwwLDAsMCwwLDgsMCwwLDAsMCwwLDAsMTI4LDkwLDE3Myw4NiwxNzEsMjEzLDEwNiwxODEsOTAsMTczLDg2LDE3MSwyMTMsMTA2LDE4MSw5MCwxMywwLDAsMCwwLDAsMCwwLDAsMCwwLDAsMCwwLDAsMCwwLDAsMCwwLDAsMCwwLDAsMCwwLDAsMCwwLDAsMCwwLDAsMCwwLDAsMCwwLDBdLCJsIjoxOCwicSI6NiwiciI6N319AAAAAAAAAAAAAAAAAABcAQAAAAAAAAcAAAAyMjU0OS4wAEoBAAB7Indhc19maXJzdF9ldmVudCI6ZmFsc2UsImltYWdlX2lkIjpbMjk0ODYzMDc5MiwyNDgyMTM2NzExLDE1MTI2MTg2OTIsMzE5NzA4MjQxOCw4MjA5NjM4NjgsNDYzMjQzMDA1LDI4MTUxMzAwNDUsMzgzNTM1NDY1N10sInFmIjp7ImIiOlswLDQsMCwwLDAsMCwwLDAsMCwwLDAsOCwwLDAsMCwwLDAsMCwxMjgsOTAsMTczLDg2LDE3MSwyMTMsMTA2LDE4MSw5MCwxNzMsODYsMTcxLDIxMywxMDYsMTgxLDkwLDEzLDAsMCwwLDAsMCwwLDAsMCwwLDAsMCwwLDAsMCwwLDAsMCwwLDAsMCwwLDAsMCwwLDAsMCwwLDAsMCwwLDAsMCwwLDAsMCwwLDAsMF0sImwiOjE4LCJxIjo2LCJyIjo3fX0AAAAAAAAAAAAAAAAAAAAAAAAAAAAAAAAAAAAAAAAAAAAA'}}
prove_18;93;14;Mul;1302;23851;23851.0;897;0.0721583329996065;{'verificationValue': 23851.0, 'proof': {'imageId': [2948630792, 2482136711, 1512618692, 3197082418, 820963868, 463243005, 2815130045, 3835354657], 'receipt': 'AwAAAAAAAAAAAAAAxAciAPPsD8genbvcCN2DvDmorNgPyU2p6hAM/h+8IU0pSDuhAAAAAAAAAAAAAAAAAAAAAAAAAAAAAAAAAAAAAAAAAAAAAAAAAAAAAAAAAAAAAAAAAQAAAAAAAAAAAAAAAAAAAAAAAAAAAAAAAAAAAAAAAAAAAAAAAAAAAAEAAAAAXAEAAAAAAAAHAAAAMjM4NTEuMABMAQAAeyJ3YXNfZmlyc3RfZXZlbnQiOmZhbHNlLCJpbWFnZV9pZCI6WzI5NDg2MzA3OTIsMjQ4MjEzNjcxMSwxNTEyNjE4NjkyLDMxOTcwODI0MTgsODIwOTYzODY4LDQ2MzI0MzAwNSwyODE1MTMwMDQ1LDM4MzUzNTQ2NTddLCJxZiI6eyJiIjpbMCw0LDAsMCwwLDAsMCwwLDAsMCwwLDE2LDAsMCwwLDAsMCwwLDEyOCw5MCwxNzMsODYsMTcxLDIxMywxMDYsMTgxLDkwLDE3Myw4NiwxNzEsMjEzLDEwNiwxODEsOTAsMTczLDYsMCwwLDAsMCwwLDAsMCwwLDAsMCwwLDAsMCwwLDAsMCwwLDAsMCwwLDAsMCwwLDAsMCwwLDAsMCwwLDAsMCwwLDAsMCwwLDAsMF0sImwiOjE5LCJxIjo2LCJyIjo3fX0AAAAAAAAAAAAAAABcAQAAAAAAAAcAAAAyMzg1MS4wAEwBAAB7Indhc19maXJzdF9ldmVudCI6ZmFsc2UsImltYWdlX2lkIjpbMjk0ODYzMDc5MiwyNDgyMTM2NzExLDE1MTI2MTg2OTIsMzE5NzA4MjQxOCw4MjA5NjM4NjgsNDYzMjQzMDA1LDI4MTUxMzAwNDUsMzgzNTM1NDY1N10sInFmIjp7ImIiOlswLDQsMCwwLDAsMCwwLDAsMCwwLDAsMTYsMCwwLDAsMCwwLDAsMTI4LDkwLDE3Myw4NiwxNzEsMjEzLDEwNiwxODEsOTAsMTczLDg2LDE3MSwyMTMsMTA2LDE4MSw5MCwxNzMsNiwwLDAsMCwwLDAsMCwwLDAsMCwwLDAsMCwwLDAsMCwwLDAsMCwwLDAsMCwwLDAsMCwwLDAsMCwwLDAsMCwwLDAsMCwwLDAsMCwwXSwibCI6MTksInEiOjYsInIiOjd9fQAAAAAAAAAAAAAAAAAAAAAAAAAAAAAAAAAAAAAAAAAA'}}
prove_19;90;100;Mul;9000;32851;32851.0;905;0.07257445899995218;{'verificationValue': 32851.0, 'proof': {'imageId': [2948630792, 2482136711, 1512618692, 3197082418, 820963868, 463243005, 2815130045, 3835354657], 'receipt': 'AwAAAAAAAAAAAAAAxAciAPPsD8genbvcCN2DvDmorNgPyU2p6hAM/h+8IU0pSDuhAAAAAAAAAAAAAAAAAAAAAAAAAAAAAAAAAAAAAAAAAAAAAAAAAAAAAAAAAAAAAAAAAQAAAAAAAAAAAAAAAAAAAAAAAAAAAAAAAAAAAAAAAAAAAAAAAAAAAAEAAAAAYAEAAAAAAAAHAAAAMzI4NTEuMABNAQAAeyJ3YXNfZmlyc3RfZXZlbnQiOmZhbHNlLCJpbWFnZV9pZCI6WzI5NDg2MzA3OTIsMjQ4MjEzNjcxMSwxNTEyNjE4NjkyLDMxOTcwODI0MTgsODIwOTYzODY4LDQ2MzI0MzAwNSwyODE1MTMwMDQ1LDM4MzUzNTQ2NTddLCJxZiI6eyJiIjpbMCw0LDAsMCwwLDAsMCwwLDAsMCwwLDMyLDAsMCwwLDAsMCwwLDEyOCw5MCwxNzMsODYsMTcxLDIxMywxMDYsMTgxLDkwLDE3Myw4NiwxNzEsMjEzLDEwNiwxODEsOTAsMTczLDg2LDMsMCwwLDAsMCwwLDAsMCwwLDAsMCwwLDAsMCwwLDAsMCwwLDAsMCwwLDAsMCwwLDAsMCwwLDAsMCwwLDAsMCwwLDAsMCwwLDBdLCJsIjoyMCwicSI6NiwiciI6N319AAAAAAAAAAAAAAAAAAAAYAEAAAAAAAAHAAAAMzI4NTEuMABNAQAAeyJ3YXNfZmlyc3RfZXZlbnQiOmZhbHNlLCJpbWFnZV9pZCI6WzI5NDg2MzA3OTIsMjQ4MjEzNjcxMSwxNTEyNjE4NjkyLDMxOTcwODI0MTgsODIwOTYzODY4LDQ2MzI0MzAwNSwyODE1MTMwMDQ1LDM4MzUzNTQ2NTddLCJxZiI6eyJiIjpbMCw0LDAsMCwwLDAsMCwwLDAsMCwwLDMyLDAsMCwwLDAsMCwwLDEyOCw5MCwxNzMsODYsMTcxLDIxMywxMDYsMTgxLDkwLDE3Myw4NiwxNzEsMjEzLDEwNiwxODEsOTAsMTczLDg2LDMsMCwwLDAsMCwwLDAsMCwwLDAsMCwwLDAsMCwwLDAsMCwwLDAsMCwwLDAsMCwwLDAsMCwwLDAsMCwwLDAsMCwwLDAsMCwwLDBdLCJsIjoyMCwicSI6NiwiciI6N319AAAAAAAAAAAAAAAAAAAAAAAAAAAAAAAAAAAAAAAAAAAAAAA='}}
prove_20;70;90;Mul;6300;39151;39151.0;905;0.07286295799895015;{'verificationValue': 39151.0, 'proof': {'imageId': [2948630792, 2482136711, 1512618692, 3197082418, 820963868, 463243005, 2815130045, 3835354657], 'receipt': 'AwAAAAAAAAAAAAAAxAciAPPsD8genbvcCN2DvDmorNgPyU2p6hAM/h+8IU0pSDuhAAAAAAAAAAAAAAAAAAAAAAAAAAAAAAAAAAAAAAAAAAAAAAAAAAAAAAAAAAAAAAAAAQAAAAAAAAAAAAAAAAAAAAAAAAAAAAAAAAAAAAAAAAAAAAAAAAAAAAEAAAAAYAEAAAAAAAAHAAAAMzkxNTEuMABPAQAAeyJ3YXNfZmlyc3RfZXZlbnQiOmZhbHNlLCJpbWFnZV9pZCI6WzI5NDg2MzA3OTIsMjQ4MjEzNjcxMSwxNTEyNjE4NjkyLDMxOTcwODI0MTgsODIwOTYzODY4LDQ2MzI0MzAwNSwyODE1MTMwMDQ1LDM4MzUzNTQ2NTddLCJxZiI6eyJiIjpbMCw0LDAsMCwwLDAsMCwwLDAsMCwwLDY0LDAsMCwwLDAsMCwwLDEyOCw5MCwxNzMsODYsMTcxLDIxMywxMDYsMTgxLDkwLDE3Myw4NiwxNzEsMjEzLDEwNiwxODEsOTAsMTczLDg2LDE3MSwxLDAsMCwwLDAsMCwwLDAsMCwwLDAsMCwwLDAsMCwwLDAsMCwwLDAsMCwwLDAsMCwwLDAsMCwwLDAsMCwwLDAsMCwwLDAsMF0sImwiOjIxLCJxIjo2LCJyIjo3fX0AAAAAAAAAAAAAAAAAYAEAAAAAAAAHAAAAMzkxNTEuMABPAQAAeyJ3YXNfZmlyc3RfZXZlbnQiOmZhbHNlLCJpbWFnZV9pZCI6WzI5NDg2MzA3OTIsMjQ4MjEzNjcxMSwxNTEyNjE4NjkyLDMxOTcwODI0MTgsODIwOTYzODY4LDQ2MzI0MzAwNSwyODE1MTMwMDQ1LDM4MzUzNTQ2NTddLCJxZiI6eyJiIjpbMCw0LDAsMCwwLDAsMCwwLDAsMCwwLDY0LDAsMCwwLDAsMCwwLDEyOCw5MCwxNzMsODYsMTcxLDIxMywxMDYsMTgxLDkwLDE3Myw4NiwxNzEsMjEzLDEwNiwxODEsOTAsMTczLDg2LDE3MSwxLDAsMCwwLDAsMCwwLDAsMCwwLDAsMCwwLDAsMCwwLDAsMCwwLDAsMCwwLDAsMCwwLDAsMCwwLDAsMCwwLDAsMCwwLDAsMF0sImwiOjIxLCJxIjo2LCJyIjo3fX0AAAAAAAAAAAAAAAAAAAAAAAAAAAAAAAAAAAAAAAAAAAA='}}
prove_21;83;87;Mul;7221;46372;46372.0;913;0.07223062500088417;{'verificationValue': 46372.0, 'proof': {'imageId': [2948630792, 2482136711, 1512618692, 3197082418, 820963868, 463243005, 2815130045, 3835354657], 'receipt': 'AwAAAAAAAAAAAAAAxAciAPPsD8genbvcCN2DvDmorNgPyU2p6hAM/h+8IU0pSDuhAAAAAAAAAAAAAAAAAAAAAAAAAAAAAAAAAAAAAAAAAAAAAAAAAAAAAAAAAAAAAAAAAQAAAAAAAAAAAAAAAAAAAAAAAAAAAAAAAAAAAAAAAAAAAAAAAAAAAAEAAAAAZAEAAAAAAAAHAAAANDYzNzIuMABSAQAAeyJ3YXNfZmlyc3RfZXZlbnQiOmZhbHNlLCJpbWFnZV9pZCI6WzI5NDg2MzA3OTIsMjQ4MjEzNjcxMSwxNTEyNjE4NjkyLDMxOTcwODI0MTgsODIwOTYzODY4LDQ2MzI0MzAwNSwyODE1MTMwMDQ1LDM4MzUzNTQ2NTddLCJxZiI6eyJiIjpbMCw0LDAsMCwwLDAsMCwwLDAsMCwwLDEyOCwwLDAsMCwwLDAsMCwxMjgsOTAsMTczLDg2LDE3MSwyMTMsMTA2LDE4MSw5MCwxNzMsODYsMTcxLDIxMywxMDYsMTgxLDkwLDE3Myw4NiwxNzEsMjEzLDAsMCwwLDAsMCwwLDAsMCwwLDAsMCwwLDAsMCwwLDAsMCwwLDAsMCwwLDAsMCwwLDAsMCwwLDAsMCwwLDAsMCwwLDAsMF0sImwiOjIyLCJxIjo2LCJyIjo3fX0AAAAAAAAAAAAAAAAAAGQBAAAAAAAABwAAADQ2MzcyLjAAUgEAAHsid2FzX2ZpcnN0X2V2ZW50IjpmYWxzZSwiaW1hZ2VfaWQiOlsyOTQ4NjMwNzkyLDI0ODIxMzY3MTEsMTUxMjYxODY5MiwzMTk3MDgyNDE4LDgyMDk2Mzg2OCw0NjMyNDMwMDUsMjgxNTEzMDA0NSwzODM1MzU0NjU3XSwicWYiOnsiYiI6WzAsNCwwLDAsMCwwLDAsMCwwLDAsMCwxMjgsMCwwLDAsMCwwLDAsMTI4LDkwLDE3Myw4NiwxNzEsMjEzLDEwNiwxODEsOTAsMTczLDg2LDE3MSwyMTMsMTA2LDE4MSw5MCwxNzMsODYsMTcxLDIxMywwLDAsMCwwLDAsMCwwLDAsMCwwLDAsMCwwLDAsMCwwLDAsMCwwLDAsMCwwLDAsMCwwLDAsMCwwLDAsMCwwLDAsMCwwLDBdLCJsIjoyMiwicSI6NiwiciI6N319AAAAAAAAAAAAAAAAAAAAAAAAAAAAAAAAAAAAAAAAAAAAAA=='}}
prove_22;45;42;Mul;1890;48262;48262.0;913;0.07249154200144403;{'verificationValue': 48262.0, 'proof': {'imageId': [2948630792, 2482136711, 1512618692, 3197082418, 820963868, 463243005, 2815130045, 3835354657], 'receipt': 'AwAAAAAAAAAAAAAAxAciAPPsD8genbvcCN2DvDmorNgPyU2p6hAM/h+8IU0pSDuhAAAAAAAAAAAAAAAAAAAAAAAAAAAAAAAAAAAAAAAAAAAAAAAAAAAAAAAAAAAAAAAAAQAAAAAAAAAAAAAAAAAAAAAAAAAAAAAAAAAAAAAAAAAAAAAAAAAAAAEAAAAAZAEAAAAAAAAHAAAANDgyNjIuMABSAQAAeyJ3YXNfZmlyc3RfZXZlbnQiOmZhbHNlLCJpbWFnZV9pZCI6WzI5NDg2MzA3OTIsMjQ4MjEzNjcxMSwxNTEyNjE4NjkyLDMxOTcwODI0MTgsODIwOTYzODY4LDQ2MzI0MzAwNSwyODE1MTMwMDQ1LDM4MzUzNTQ2NTddLCJxZiI6eyJiIjpbMCw0LDAsMCwwLDAsMCwwLDAsMCwwLDAsMSwwLDAsMCwwLDAsMTI4LDkwLDE3Myw4NiwxNzEsMjEzLDEwNiwxODEsOTAsMTczLDg2LDE3MSwyMTMsMTA2LDE4MSw5MCwxNzMsODYsMTcxLDIxMywxMDYsMCwwLDAsMCwwLDAsMCwwLDAsMCwwLDAsMCwwLDAsMCwwLDAsMCwwLDAsMCwwLDAsMCwwLDAsMCwwLDAsMCwwLDAsMF0sImwiOjIzLCJxIjo2LCJyIjo3fX0AAAAAAAAAAAAAAAAAAGQBAAAAAAAABwAAADQ4MjYyLjAAUgEAAHsid2FzX2ZpcnN0X2V2ZW50IjpmYWxzZSwiaW1hZ2VfaWQiOlsyOTQ4NjMwNzkyLDI0ODIxMzY3MTEsMTUxMjYxODY5MiwzMTk3MDgyNDE4LDgyMDk2Mzg2OCw0NjMyNDMwMDUsMjgxNTEzMDA0NSwzODM1MzU0NjU3XSwicWYiOnsiYiI6WzAsNCwwLDAsMCwwLDAsMCwwLDAsMCwwLDEsMCwwLDAsMCwwLDEyOCw5MCwxNzMsODYsMTcxLDIxMywxMDYsMTgxLDkwLDE3Myw4NiwxNzEsMjEzLDEwNiwxODEsOTAsMTczLDg2LDE3MSwyMTMsMTA2LDAsMCwwLDAsMCwwLDAsMCwwLDAsMCwwLDAsMCwwLDAsMCwwLDAsMCwwLDAsMCwwLDAsMCwwLDAsMCwwLDAsMCwwLDBdLCJsIjoyMywicSI6NiwiciI6N319AAAAAAAAAAAAAAAAAAAAAAAAAAAAAAAAAAAAAAAAAAAAAA=='}}
prove_23;72;68;Mul;4896;53158;53158.0;913;0.07277879100001883;{'verificationValue': 53158.0, 'proof': {'imageId': [2948630792, 2482136711, 1512618692, 3197082418, 820963868, 463243005, 2815130045, 3835354657], 'receipt': 'AwAAAAAAAAAAAAAAxAciAPPsD8genbvcCN2DvDmorNgPyU2p6hAM/h+8IU0pSDuhAAAAAAAAAAAAAAAAAAAAAAAAAAAAAAAAAAAAAAAAAAAAAAAAAAAAAAAAAAAAAAAAAQAAAAAAAAAAAAAAAAAAAAAAAAAAAAAAAAAAAAAAAAAAAAAAAAAAAAEAAAAAZAEAAAAAAAAHAAAANTMxNTguMABTAQAAeyJ3YXNfZmlyc3RfZXZlbnQiOmZhbHNlLCJpbWFnZV9pZCI6WzI5NDg2MzA3OTIsMjQ4MjEzNjcxMSwxNTEyNjE4NjkyLDMxOTcwODI0MTgsODIwOTYzODY4LDQ2MzI0MzAwNSwyODE1MTMwMDQ1LDM4MzUzNTQ2NTddLCJxZiI6eyJiIjpbMCw0LDAsMCwwLDAsMCwwLDAsMCwwLDAsMiwwLDAsMCwwLDAsMTI4LDkwLDE3Myw4NiwxNzEsMjEzLDEwNiwxODEsOTAsMTczLDg2LDE3MSwyMTMsMTA2LDE4MSw5MCwxNzMsODYsMTcxLDIxMywxMDYsNTMsMCwwLDAsMCwwLDAsMCwwLDAsMCwwLDAsMCwwLDAsMCwwLDAsMCwwLDAsMCwwLDAsMCwwLDAsMCwwLDAsMCwwLDBdLCJsIjoyNCwicSI6NiwiciI6N319AAAAAAAAAAAAAAAAAGQBAAAAAAAABwAAADUzMTU4LjAAUwEAAHsid2FzX2ZpcnN0X2V2ZW50IjpmYWxzZSwiaW1hZ2VfaWQiOlsyOTQ4NjMwNzkyLDI0ODIxMzY3MTEsMTUxMjYxODY5MiwzMTk3MDgyNDE4LDgyMDk2Mzg2OCw0NjMyNDMwMDUsMjgxNTEzMDA0NSwzODM1MzU0NjU3XSwicWYiOnsiYiI6WzAsNCwwLDAsMCwwLDAsMCwwLDAsMCwwLDIsMCwwLDAsMCwwLDEyOCw5MCwxNzMsODYsMTcxLDIxMywxMDYsMTgxLDkwLDE3Myw4NiwxNzEsMjEzLDEwNiwxODEsOTAsMTczLDg2LDE3MSwyMTMsMTA2LDUzLDAsMCwwLDAsMCwwLDAsMCwwLDAsMCwwLDAsMCwwLDAsMCwwLDAsMCwwLDAsMCwwLDAsMCwwLDAsMCwwLDAsMCwwXSwibCI6MjQsInEiOjYsInIiOjd9fQAAAAAAAAAAAAAAAAAAAAAAAAAAAAAAAAAAAAAAAAAAAA=='}}
prove_24;48;75;Mul;3600;56758;56758.0;921;0.07394537500113074;{'verificationValue': 56758.0, 'proof': {'imageId': [2948630792, 2482136711, 1512618692, 3197082418, 820963868, 463243005, 2815130045, 3835354657], 'receipt': 'AwAAAAAAAAAAAAAAxAciAPPsD8genbvcCN2DvDmorNgPyU2p6hAM/h+8IU0pSDuhAAAAAAAAAAAAAAAAAAAAAAAAAAAAAAAAAAAAAAAAAAAAAAAAAAAAAAAAAAAAAAAAAQAAAAAAAAAAAAAAAAAAAAAAAAAAAAAAAAAAAAAAAAAAAAAAAAAAAAEAAAAAaAEAAAAAAAAHAAAANTY3NTguMABVAQAAeyJ3YXNfZmlyc3RfZXZlbnQiOmZhbHNlLCJpbWFnZV9pZCI6WzI5NDg2MzA3OTIsMjQ4MjEzNjcxMSwxNTEyNjE4NjkyLDMxOTcwODI0MTgsODIwOTYzODY4LDQ2MzI0MzAwNSwyODE1MTMwMDQ1LDM4MzUzNTQ2NTddLCJxZiI6eyJiIjpbMCw0LDAsMCwwLDAsMCwwLDAsMCwwLDAsNCwwLDAsMCwwLDAsMTI4LDkwLDE3Myw4NiwxNzEsMjEzLDEwNiwxODEsOTAsMTczLDg2LDE3MSwyMTMsMTA2LDE4MSw5MCwxNzMsODYsMTcxLDIxMywxMDYsMTgxLDI2LDAsMCwwLDAsMCwwLDAsMCwwLDAsMCwwLDAsMCwwLDAsMCwwLDAsMCwwLDAsMCwwLDAsMCwwLDAsMCwwLDAsMF0sImwiOjI1LCJxIjo2LCJyIjo3fX0AAAAAAAAAAAAAAAAAAABoAQAAAAAAAAcAAAA1Njc1OC4wAFUBAAB7Indhc19maXJzdF9ldmVudCI6ZmFsc2UsImltYWdlX2lkIjpbMjk0ODYzMDc5MiwyNDgyMTM2NzExLDE1MTI2MTg2OTIsMzE5NzA4MjQxOCw4MjA5NjM4NjgsNDYzMjQzMDA1LDI4MTUxMzAwNDUsMzgzNTM1NDY1N10sInFmIjp7ImIiOlswLDQsMCwwLDAsMCwwLDAsMCwwLDAsMCw0LDAsMCwwLDAsMCwxMjgsOTAsMTczLDg2LDE3MSwyMTMsMTA2LDE4MSw5MCwxNzMsODYsMTcxLDIxMywxMDYsMTgxLDkwLDE3Myw4NiwxNzEsMjEzLDEwNiwxODEsMjYsMCwwLDAsMCwwLDAsMCwwLDAsMCwwLDAsMCwwLDAsMCwwLDAsMCwwLDAsMCwwLDAsMCwwLDAsMCwwLDAsMCwwXSwibCI6MjUsInEiOjYsInIiOjd9fQAAAAAAAAAAAAAAAAAAAAAAAAAAAAAAAAAAAAAAAAAAAAAA'}}
prove_25;23;45;Mul;1035;57793;57793.0;921;0.07321400000000722;{'verificationValue': 57793.0, 'proof': {'imageId': [2948630792, 2482136711, 1512618692, 3197082418, 820963868, 463243005, 2815130045, 3835354657], 'receipt': 'AwAAAAAAAAAAAAAAxAciAPPsD8genbvcCN2DvDmorNgPyU2p6hAM/h+8IU0pSDuhAAAAAAAAAAAAAAAAAAAAAAAAAAAAAAAAAAAAAAAAAAAAAAAAAAAAAAAAAAAAAAAAAQAAAAAAAAAAAAAAAAAAAAAAAAAAAAAAAAAAAAAAAAAAAAAAAAAAAAEAAAAAaAEAAAAAAAAHAAAANTc3OTMuMABWAQAAeyJ3YXNfZmlyc3RfZXZlbnQiOmZhbHNlLCJpbWFnZV9pZCI6WzI5NDg2MzA3OTIsMjQ4MjEzNjcxMSwxNTEyNjE4NjkyLDMxOTcwODI0MTgsODIwOTYzODY4LDQ2MzI0MzAwNSwyODE1MTMwMDQ1LDM4MzUzNTQ2NTddLCJxZiI6eyJiIjpbMCw0LDAsMCwwLDAsMCwwLDAsMCwwLDAsOCwwLDAsMCwwLDAsMTI4LDkwLDE3Myw4NiwxNzEsMjEzLDEwNiwxODEsOTAsMTczLDg2LDE3MSwyMTMsMTA2LDE4MSw5MCwxNzMsODYsMTcxLDIxMywxMDYsMTgxLDkwLDEzLDAsMCwwLDAsMCwwLDAsMCwwLDAsMCwwLDAsMCwwLDAsMCwwLDAsMCwwLDAsMCwwLDAsMCwwLDAsMCwwLDBdLCJsIjoyNiwicSI6NiwiciI6N319AAAAAAAAAAAAAAAAAABoAQAAAAAAAAcAAAA1Nzc5My4wAFYBAAB7Indhc19maXJzdF9ldmVudCI6ZmFsc2UsImltYWdlX2lkIjpbMjk0ODYzMDc5MiwyNDgyMTM2NzExLDE1MTI2MTg2OTIsMzE5NzA4MjQxOCw4MjA5NjM4NjgsNDYzMjQzMDA1LDI4MTUxMzAwNDUsMzgzNTM1NDY1N10sInFmIjp7ImIiOlswLDQsMCwwLDAsMCwwLDAsMCwwLDAsMCw4LDAsMCwwLDAsMCwxMjgsOTAsMTczLDg2LDE3MSwyMTMsMTA2LDE4MSw5MCwxNzMsODYsMTcxLDIxMywxMDYsMTgxLDkwLDE3Myw4NiwxNzEsMjEzLDEwNiwxODEsOTAsMTMsMCwwLDAsMCwwLDAsMCwwLDAsMCwwLDAsMCwwLDAsMCwwLDAsMCwwLDAsMCwwLDAsMCwwLDAsMCwwLDAsMF0sImwiOjI2LCJxIjo2LCJyIjo3fX0AAAAAAAAAAAAAAAAAAAAAAAAAAAAAAAAAAAAAAAAAAAAA'}}
prove_26;37;31;Mul;1147;58940;58940.0;921;0.07211833300061699;{'verificationValue': 58940.0, 'proof': {'imageId': [2948630792, 2482136711, 1512618692, 3197082418, 820963868, 463243005, 2815130045, 3835354657], 'receipt': 'AwAAAAAAAAAAAAAAxAciAPPsD8genbvcCN2DvDmorNgPyU2p6hAM/h+8IU0pSDuhAAAAAAAAAAAAAAAAAAAAAAAAAAAAAAAAAAAAAAAAAAAAAAAAAAAAAAAAAAAAAAAAAQAAAAAAAAAAAAAAAAAAAAAAAAAAAAAAAAAAAAAAAAAAAAAAAAAAAAEAAAAAaAEAAAAAAAAHAAAANTg5NDAuMABYAQAAeyJ3YXNfZmlyc3RfZXZlbnQiOmZhbHNlLCJpbWFnZV9pZCI6WzI5NDg2MzA3OTIsMjQ4MjEzNjcxMSwxNTEyNjE4NjkyLDMxOTcwODI0MTgsODIwOTYzODY4LDQ2MzI0MzAwNSwyODE1MTMwMDQ1LDM4MzUzNTQ2NTddLCJxZiI6eyJiIjpbMCw0LDAsMCwwLDAsMCwwLDAsMCwwLDAsMTYsMCwwLDAsMCwwLDEyOCw5MCwxNzMsODYsMTcxLDIxMywxMDYsMTgxLDkwLDE3Myw4NiwxNzEsMjEzLDEwNiwxODEsOTAsMTczLDg2LDE3MSwyMTMsMTA2LDE4MSw5MCwxNzMsNiwwLDAsMCwwLDAsMCwwLDAsMCwwLDAsMCwwLDAsMCwwLDAsMCwwLDAsMCwwLDAsMCwwLDAsMCwwLDAsMF0sImwiOjI3LCJxIjo2LCJyIjo3fX0AAAAAAAAAAAAAAABoAQAAAAAAAAcAAAA1ODk0MC4wAFgBAAB7Indhc19maXJzdF9ldmVudCI6ZmFsc2UsImltYWdlX2lkIjpbMjk0ODYzMDc5MiwyNDgyMTM2NzExLDE1MTI2MTg2OTIsMzE5NzA4MjQxOCw4MjA5NjM4NjgsNDYzMjQzMDA1LDI4MTUxMzAwNDUsMzgzNTM1NDY1N10sInFmIjp7ImIiOlswLDQsMCwwLDAsMCwwLDAsMCwwLDAsMCwxNiwwLDAsMCwwLDAsMTI4LDkwLDE3Myw4NiwxNzEsMjEzLDEwNiwxODEsOTAsMTczLDg2LDE3MSwyMTMsMTA2LDE4MSw5MCwxNzMsODYsMTcxLDIxMywxMDYsMTgxLDkwLDE3Myw2LDAsMCwwLDAsMCwwLDAsMCwwLDAsMCwwLDAsMCwwLDAsMCwwLDAsMCwwLDAsMCwwLDAsMCwwLDAsMCwwXSwibCI6MjcsInEiOjYsInIiOjd9fQAAAAAAAAAAAAAAAAAAAAAAAAAAAAAAAAAAAAAAAAAA'}}
prove_27;16;16;Mul;256;59196;59196.0;929;0.07329420799942454;{'verificationValue': 59196.0, 'proof': {'imageId': [2948630792, 2482136711, 1512618692, 3197082418, 820963868, 463243005, 2815130045, 3835354657], 'receipt': 'AwAAAAAAAAAAAAAAxAciAPPsD8genbvcCN2DvDmorNgPyU2p6hAM/h+8IU0pSDuhAAAAAAAAAAAAAAAAAAAAAAAAAAAAAAAAAAAAAAAAAAAAAAAAAAAAAAAAAAAAAAAAAQAAAAAAAAAAAAAAAAAAAAAAAAAAAAAAAAAAAAAAAAAAAAAAAAAAAAEAAAAAbAEAAAAAAAAHAAAANTkxOTYuMABZAQAAeyJ3YXNfZmlyc3RfZXZlbnQiOmZhbHNlLCJpbWFnZV9pZCI6WzI5NDg2MzA3OTIsMjQ4MjEzNjcxMSwxNTEyNjE4NjkyLDMxOTcwODI0MTgsODIwOTYzODY4LDQ2MzI0MzAwNSwyODE1MTMwMDQ1LDM4MzUzNTQ2NTddLCJxZiI6eyJiIjpbMCw0LDAsMCwwLDAsMCwwLDAsMCwwLDAsMzIsMCwwLDAsMCwwLDEyOCw5MCwxNzMsODYsMTcxLDIxMywxMDYsMTgxLDkwLDE3Myw4NiwxNzEsMjEzLDEwNiwxODEsOTAsMTczLDg2LDE3MSwyMTMsMTA2LDE4MSw5MCwxNzMsODYsMywwLDAsMCwwLDAsMCwwLDAsMCwwLDAsMCwwLDAsMCwwLDAsMCwwLDAsMCwwLDAsMCwwLDAsMCwwLDBdLCJsIjoyOCwicSI6NiwiciI6N319AAAAAAAAAAAAAAAAAAAAbAEAAAAAAAAHAAAANTkxOTYuMABZAQAAeyJ3YXNfZmlyc3RfZXZlbnQiOmZhbHNlLCJpbWFnZV9pZCI6WzI5NDg2MzA3OTIsMjQ4MjEzNjcxMSwxNTEyNjE4NjkyLDMxOTcwODI0MTgsODIwOTYzODY4LDQ2MzI0MzAwNSwyODE1MTMwMDQ1LDM4MzUzNTQ2NTddLCJxZiI6eyJiIjpbMCw0LDAsMCwwLDAsMCwwLDAsMCwwLDAsMzIsMCwwLDAsMCwwLDEyOCw5MCwxNzMsODYsMTcxLDIxMywxMDYsMTgxLDkwLDE3Myw4NiwxNzEsMjEzLDEwNiwxODEsOTAsMTczLDg2LDE3MSwyMTMsMTA2LDE4MSw5MCwxNzMsODYsMywwLDAsMCwwLDAsMCwwLDAsMCwwLDAsMCwwLDAsMCwwLDAsMCwwLDAsMCwwLDAsMCwwLDAsMCwwLDBdLCJsIjoyOCwicSI6NiwiciI6N319AAAAAAAAAAAAAAAAAAAAAAAAAAAAAAAAAAAAAAAAAAAAAAA='}}
prove_28;39;37;Mul;1443;60639;60639.0;929;0.07290308400115464;{'verificationValue': 60639.0, 'proof': {'imageId': [2948630792, 2482136711, 1512618692, 3197082418, 820963868, 463243005, 2815130045, 3835354657], 'receipt': 'AwAAAAAAAAAAAAAAxAciAPPsD8genbvcCN2DvDmorNgPyU2p6hAM/h+8IU0pSDuhAAAAAAAAAAAAAAAAAAAAAAAAAAAAAAAAAAAAAAAAAAAAAAAAAAAAAAAAAAAAAAAAAQAAAAAAAAAAAAAAAAAAAAAAAAAAAAAAAAAAAAAAAAAAAAAAAAAAAAEAAAAAbAEAAAAAAAAHAAAANjA2MzkuMABbAQAAeyJ3YXNfZmlyc3RfZXZlbnQiOmZhbHNlLCJpbWFnZV9pZCI6WzI5NDg2MzA3OTIsMjQ4MjEzNjcxMSwxNTEyNjE4NjkyLDMxOTcwODI0MTgsODIwOTYzODY4LDQ2MzI0MzAwNSwyODE1MTMwMDQ1LDM4MzUzNTQ2NTddLCJxZiI6eyJiIjpbMCw0LDAsMCwwLDAsMCwwLDAsMCwwLDAsNjQsMCwwLDAsMCwwLDEyOCw5MCwxNzMsODYsMTcxLDIxMywxMDYsMTgxLDkwLDE3Myw4NiwxNzEsMjEzLDEwNiwxODEsOTAsMTczLDg2LDE3MSwyMTMsMTA2LDE4MSw5MCwxNzMsODYsMTcxLDEsMCwwLDAsMCwwLDAsMCwwLDAsMCwwLDAsMCwwLDAsMCwwLDAsMCwwLDAsMCwwLDAsMCwwLDAsMF0sImwiOjI5LCJxIjo2LCJyIjo3fX0AAAAAAAAAAAAAAAAAbAEAAAAAAAAHAAAANjA2MzkuMABbAQAAeyJ3YXNfZmlyc3RfZXZlbnQiOmZhbHNlLCJpbWFnZV9pZCI6WzI5NDg2MzA3OTIsMjQ4MjEzNjcxMSwxNTEyNjE4NjkyLDMxOTcwODI0MTgsODIwOTYzODY4LDQ2MzI0MzAwNSwyODE1MTMwMDQ1LDM4MzUzNTQ2NTddLCJxZiI6eyJiIjpbMCw0LDAsMCwwLDAsMCwwLDAsMCwwLDAsNjQsMCwwLDAsMCwwLDEyOCw5MCwxNzMsODYsMTcxLDIxMywxMDYsMTgxLDkwLDE3Myw4NiwxNzEsMjEzLDEwNiwxODEsOTAsMTczLDg2LDE3MSwyMTMsMTA2LDE4MSw5MCwxNzMsODYsMTcxLDEsMCwwLDAsMCwwLDAsMCwwLDAsMCwwLDAsMCwwLDAsMCwwLDAsMCwwLDAsMCwwLDAsMCwwLDAsMF0sImwiOjI5LCJxIjo2LCJyIjo3fX0AAAAAAAAAAAAAAAAAAAAAAAAAAAAAAAAAAAAAAAAAAAA='}}
prove_29;84;18;Mul;1512;62151;62151.0;937;0.07297837499936577;{'verificationValue': 62151.0, 'proof': {'imageId': [2948630792, 2482136711, 1512618692, 3197082418, 820963868, 463243005, 2815130045, 3835354657], 'receipt': 'AwAAAAAAAAAAAAAAxAciAPPsD8genbvcCN2DvDmorNgPyU2p6hAM/h+8IU0pSDuhAAAAAAAAAAAAAAAAAAAAAAAAAAAAAAAAAAAAAAAAAAAAAAAAAAAAAAAAAAAAAAAAAQAAAAAAAAAAAAAAAAAAAAAAAAAAAAAAAAAAAAAAAAAAAAAAAAAAAAEAAAAAcAEAAAAAAAAHAAAANjIxNTEuMABeAQAAeyJ3YXNfZmlyc3RfZXZlbnQiOmZhbHNlLCJpbWFnZV9pZCI6WzI5NDg2MzA3OTIsMjQ4MjEzNjcxMSwxNTEyNjE4NjkyLDMxOTcwODI0MTgsODIwOTYzODY4LDQ2MzI0MzAwNSwyODE1MTMwMDQ1LDM4MzUzNTQ2NTddLCJxZiI6eyJiIjpbMCw0LDAsMCwwLDAsMCwwLDAsMCwwLDAsMTI4LDAsMCwwLDAsMCwxMjgsOTAsMTczLDg2LDE3MSwyMTMsMTA2LDE4MSw5MCwxNzMsODYsMTcxLDIxMywxMDYsMTgxLDkwLDE3Myw4NiwxNzEsMjEzLDEwNiwxODEsOTAsMTczLDg2LDE3MSwyMTMsMCwwLDAsMCwwLDAsMCwwLDAsMCwwLDAsMCwwLDAsMCwwLDAsMCwwLDAsMCwwLDAsMCwwLDAsMF0sImwiOjMwLCJxIjo2LCJyIjo3fX0AAAAAAAAAAAAAAAAAAHABAAAAAAAABwAAADYyMTUxLjAAXgEAAHsid2FzX2ZpcnN0X2V2ZW50IjpmYWxzZSwiaW1hZ2VfaWQiOlsyOTQ4NjMwNzkyLDI0ODIxMzY3MTEsMTUxMjYxODY5MiwzMTk3MDgyNDE4LDgyMDk2Mzg2OCw0NjMyNDMwMDUsMjgxNTEzMDA0NSwzODM1MzU0NjU3XSwicWYiOnsiYiI6WzAsNCwwLDAsMCwwLDAsMCwwLDAsMCwwLDEyOCwwLDAsMCwwLDAsMTI4LDkwLDE3Myw4NiwxNzEsMjEzLDEwNiwxODEsOTAsMTczLDg2LDE3MSwyMTMsMTA2LDE4MSw5MCwxNzMsODYsMTcxLDIxMywxMDYsMTgxLDkwLDE3Myw4NiwxNzEsMjEzLDAsMCwwLDAsMCwwLDAsMCwwLDAsMCwwLDAsMCwwLDAsMCwwLDAsMCwwLDAsMCwwLDAsMCwwLDBdLCJsIjozMCwicSI6NiwiciI6N319AAAAAAAAAAAAAAAAAAAAAAAAAAAAAAAAAAAAAAAAAAAAAA=='}}
prove_30;14;59;Mul;826;62977;62977.0;937;0.07265391699911561;{'verificationValue': 62977.0, 'proof': {'imageId': [2948630792, 2482136711, 1512618692, 3197082418, 820963868, 463243005, 2815130045, 3835354657], 'receipt': 'AwAAAAAAAAAAAAAAxAciAPPsD8genbvcCN2DvDmorNgPyU2p6hAM/h+8IU0pSDuhAAAAAAAAAAAAAAAAAAAAAAAAAAAAAAAAAAAAAAAAAAAAAAAAAAAAAAAAAAAAAAAAAQAAAAAAAAAAAAAAAAAAAAAAAAAAAAAAAAAAAAAAAAAAAAAAAAAAAAEAAAAAcAEAAAAAAAAHAAAANjI5NzcuMABeAQAAeyJ3YXNfZmlyc3RfZXZlbnQiOmZhbHNlLCJpbWFnZV9pZCI6WzI5NDg2MzA3OTIsMjQ4MjEzNjcxMSwxNTEyNjE4NjkyLDMxOTcwODI0MTgsODIwOTYzODY4LDQ2MzI0MzAwNSwyODE1MTMwMDQ1LDM4MzUzNTQ2NTddLCJxZiI6eyJiIjpbMCw0LDAsMCwwLDAsMCwwLDAsMCwwLDAsMCwxLDAsMCwwLDAsMTI4LDkwLDE3Myw4NiwxNzEsMjEzLDEwNiwxODEsOTAsMTczLDg2LDE3MSwyMTMsMTA2LDE4MSw5MCwxNzMsODYsMTcxLDIxMywxMDYsMTgxLDkwLDE3Myw4NiwxNzEsMjEzLDEwNiwwLDAsMCwwLDAsMCwwLDAsMCwwLDAsMCwwLDAsMCwwLDAsMCwwLDAsMCwwLDAsMCwwLDAsMF0sImwiOjMxLCJxIjo2LCJyIjo3fX0AAAAAAAAAAAAAAAAAAHABAAAAAAAABwAAADYyOTc3LjAAXgEAAHsid2FzX2ZpcnN0X2V2ZW50IjpmYWxzZSwiaW1hZ2VfaWQiOlsyOTQ4NjMwNzkyLDI0ODIxMzY3MTEsMTUxMjYxODY5MiwzMTk3MDgyNDE4LDgyMDk2Mzg2OCw0NjMyNDMwMDUsMjgxNTEzMDA0NSwzODM1MzU0NjU3XSwicWYiOnsiYiI6WzAsNCwwLDAsMCwwLDAsMCwwLDAsMCwwLDAsMSwwLDAsMCwwLDEyOCw5MCwxNzMsODYsMTcxLDIxMywxMDYsMTgxLDkwLDE3Myw4NiwxNzEsMjEzLDEwNiwxODEsOTAsMTczLDg2LDE3MSwyMTMsMTA2LDE4MSw5MCwxNzMsODYsMTcxLDIxMywxMDYsMCwwLDAsMCwwLDAsMCwwLDAsMCwwLDAsMCwwLDAsMCwwLDAsMCwwLDAsMCwwLDAsMCwwLDBdLCJsIjozMSwicSI6NiwiciI6N319AAAAAAAAAAAAAAAAAAAAAAAAAAAAAAAAAAAAAAAAAAAAAA=='}}
prove_31;26;59;Mul;1534;64511;64511.0;937;0.07309737499963376;{'verificationValue': 64511.0, 'proof': {'imageId': [2948630792, 2482136711, 1512618692, 3197082418, 820963868, 463243005, 2815130045, 3835354657], 'receipt': 'AwAAAAAAAAAAAAAAxAciAPPsD8genbvcCN2DvDmorNgPyU2p6hAM/h+8IU0pSDuhAAAAAAAAAAAAAAAAAAAAAAAAAAAAAAAAAAAAAAAAAAAAAAAAAAAAAAAAAAAAAAAAAQAAAAAAAAAAAAAAAAAAAAAAAAAAAAAAAAAAAAAAAAAAAAAAAAAAAAEAAAAAcAEAAAAAAAAHAAAANjQ1MTEuMABfAQAAeyJ3YXNfZmlyc3RfZXZlbnQiOmZhbHNlLCJpbWFnZV9pZCI6WzI5NDg2MzA3OTIsMjQ4MjEzNjcxMSwxNTEyNjE4NjkyLDMxOTcwODI0MTgsODIwOTYzODY4LDQ2MzI0MzAwNSwyODE1MTMwMDQ1LDM4MzUzNTQ2NTddLCJxZiI6eyJiIjpbMCw0LDAsMCwwLDAsMCwwLDAsMCwwLDAsMCwyLDAsMCwwLDAsMTI4LDkwLDE3Myw4NiwxNzEsMjEzLDEwNiwxODEsOTAsMTczLDg2LDE3MSwyMTMsMTA2LDE4MSw5MCwxNzMsODYsMTcxLDIxMywxMDYsMTgxLDkwLDE3Myw4NiwxNzEsMjEzLDEwNiw1MywwLDAsMCwwLDAsMCwwLDAsMCwwLDAsMCwwLDAsMCwwLDAsMCwwLDAsMCwwLDAsMCwwLDBdLCJsIjozMiwicSI6NiwiciI6N319AAAAAAAAAAAAAAAAAHABAAAAAAAABwAAADY0NTExLjAAXwEAAHsid2FzX2ZpcnN0X2V2ZW50IjpmYWxzZSwiaW1hZ2VfaWQiOlsyOTQ4NjMwNzkyLDI0ODIxMzY3MTEsMTUxMjYxODY5MiwzMTk3MDgyNDE4LDgyMDk2Mzg2OCw0NjMyNDMwMDUsMjgxNTEzMDA0NSwzODM1MzU0NjU3XSwicWYiOnsiYiI6WzAsNCwwLDAsMCwwLDAsMCwwLDAsMCwwLDAsMiwwLDAsMCwwLDEyOCw5MCwxNzMsODYsMTcxLDIxMywxMDYsMTgxLDkwLDE3Myw4NiwxNzEsMjEzLDEwNiwxODEsOTAsMTczLDg2LDE3MSwyMTMsMTA2LDE4MSw5MCwxNzMsODYsMTcxLDIxMywxMDYsNTMsMCwwLDAsMCwwLDAsMCwwLDAsMCwwLDAsMCwwLDAsMCwwLDAsMCwwLDAsMCwwLDAsMCwwXSwibCI6MzIsInEiOjYsInIiOjd9fQAAAAAAAAAAAAAAAAAAAAAAAAAAAAAAAAAAAAAAAAAAAA=='}}
prove_32;40;54;Mul;2160;66671;66671.0;945;0.07261375000052794;{'verificationValue': 66671.0, 'proof': {'imageId': [2948630792, 2482136711, 1512618692, 3197082418, 820963868, 463243005, 2815130045, 3835354657], 'receipt': 'AwAAAAAAAAAAAAAAxAciAPPsD8genbvcCN2DvDmorNgPyU2p6hAM/h+8IU0pSDuhAAAAAAAAAAAAAAAAAAAAAAAAAAAAAAAAAAAAAAAAAAAAAAAAAAAAAAAAAAAAAAAAAQAAAAAAAAAAAAAAAAAAAAAAAAAAAAAAAAAAAAAAAAAAAAAAAAAAAAEAAAAAdAEAAAAAAAAHAAAANjY2NzEuMABhAQAAeyJ3YXNfZmlyc3RfZXZlbnQiOmZhbHNlLCJpbWFnZV9pZCI6WzI5NDg2MzA3OTIsMjQ4MjEzNjcxMSwxNTEyNjE4NjkyLDMxOTcwODI0MTgsODIwOTYzODY4LDQ2MzI0MzAwNSwyODE1MTMwMDQ1LDM4MzUzNTQ2NTddLCJxZiI6eyJiIjpbMCw0LDAsMCwwLDAsMCwwLDAsMCwwLDAsMCw0LDAsMCwwLDAsMTI4LDkwLDE3Myw4NiwxNzEsMjEzLDEwNiwxODEsOTAsMTczLDg2LDE3MSwyMTMsMTA2LDE4MSw5MCwxNzMsODYsMTcxLDIxMywxMDYsMTgxLDkwLDE3Myw4NiwxNzEsMjEzLDEwNiwxODEsMjYsMCwwLDAsMCwwLDAsMCwwLDAsMCwwLDAsMCwwLDAsMCwwLDAsMCwwLDAsMCwwLDAsMF0sImwiOjMzLCJxIjo2LCJyIjo3fX0AAAAAAAAAAAAAAAAAAAB0AQAAAAAAAAcAAAA2NjY3MS4wAGEBAAB7Indhc19maXJzdF9ldmVudCI6ZmFsc2UsImltYWdlX2lkIjpbMjk0ODYzMDc5MiwyNDgyMTM2NzExLDE1MTI2MTg2OTIsMzE5NzA4MjQxOCw4MjA5NjM4NjgsNDYzMjQzMDA1LDI4MTUxMzAwNDUsMzgzNTM1NDY1N10sInFmIjp7ImIiOlswLDQsMCwwLDAsMCwwLDAsMCwwLDAsMCwwLDQsMCwwLDAsMCwxMjgsOTAsMTczLDg2LDE3MSwyMTMsMTA2LDE4MSw5MCwxNzMsODYsMTcxLDIxMywxMDYsMTgxLDkwLDE3Myw4NiwxNzEsMjEzLDEwNiwxODEsOTAsMTczLDg2LDE3MSwyMTMsMTA2LDE4MSwyNiwwLDAsMCwwLDAsMCwwLDAsMCwwLDAsMCwwLDAsMCwwLDAsMCwwLDAsMCwwLDAsMCwwXSwibCI6MzMsInEiOjYsInIiOjd9fQAAAAAAAAAAAAAAAAAAAAAAAAAAAAAAAAAAAAAAAAAAAAAA'}}
prove_33;27;83;Mul;2241;68912;68912.0;945;0.07265104100042663;{'verificationValue': 68912.0, 'proof': {'imageId': [2948630792, 2482136711, 1512618692, 3197082418, 820963868, 463243005, 2815130045, 3835354657], 'receipt': 'AwAAAAAAAAAAAAAAxAciAPPsD8genbvcCN2DvDmorNgPyU2p6hAM/h+8IU0pSDuhAAAAAAAAAAAAAAAAAAAAAAAAAAAAAAAAAAAAAAAAAAAAAAAAAAAAAAAAAAAAAAAAAQAAAAAAAAAAAAAAAAAAAAAAAAAAAAAAAAAAAAAAAAAAAAAAAAAAAAEAAAAAdAEAAAAAAAAHAAAANjg5MTIuMABiAQAAeyJ3YXNfZmlyc3RfZXZlbnQiOmZhbHNlLCJpbWFnZV9pZCI6WzI5NDg2MzA3OTIsMjQ4MjEzNjcxMSwxNTEyNjE4NjkyLDMxOTcwODI0MTgsODIwOTYzODY4LDQ2MzI0MzAwNSwyODE1MTMwMDQ1LDM4MzUzNTQ2NTddLCJxZiI6eyJiIjpbMCw0LDAsMCwwLDAsMCwwLDAsMCwwLDAsMCw4LDAsMCwwLDAsMTI4LDkwLDE3Myw4NiwxNzEsMjEzLDEwNiwxODEsOTAsMTczLDg2LDE3MSwyMTMsMTA2LDE4MSw5MCwxNzMsODYsMTcxLDIxMywxMDYsMTgxLDkwLDE3Myw4NiwxNzEsMjEzLDEwNiwxODEsOTAsMTMsMCwwLDAsMCwwLDAsMCwwLDAsMCwwLDAsMCwwLDAsMCwwLDAsMCwwLDAsMCwwLDBdLCJsIjozNCwicSI6NiwiciI6N319AAAAAAAAAAAAAAAAAAB0AQAAAAAAAAcAAAA2ODkxMi4wAGIBAAB7Indhc19maXJzdF9ldmVudCI6ZmFsc2UsImltYWdlX2lkIjpbMjk0ODYzMDc5MiwyNDgyMTM2NzExLDE1MTI2MTg2OTIsMzE5NzA4MjQxOCw4MjA5NjM4NjgsNDYzMjQzMDA1LDI4MTUxMzAwNDUsMzgzNTM1NDY1N10sInFmIjp7ImIiOlswLDQsMCwwLDAsMCwwLDAsMCwwLDAsMCwwLDgsMCwwLDAsMCwxMjgsOTAsMTczLDg2LDE3MSwyMTMsMTA2LDE4MSw5MCwxNzMsODYsMTcxLDIxMywxMDYsMTgxLDkwLDE3Myw4NiwxNzEsMjEzLDEwNiwxODEsOTAsMTczLDg2LDE3MSwyMTMsMTA2LDE4MSw5MCwxMywwLDAsMCwwLDAsMCwwLDAsMCwwLDAsMCwwLDAsMCwwLDAsMCwwLDAsMCwwLDAsMF0sImwiOjM0LCJxIjo2LCJyIjo3fX0AAAAAAAAAAAAAAAAAAAAAAAAAAAAAAAAAAAAAAAAAAAAA'}}
prove_34;55;20;Mul;1100;70012;70012.0;945;0.07268008400023973;{'verificationValue': 70012.0, 'proof': {'imageId': [2948630792, 2482136711, 1512618692, 3197082418, 820963868, 463243005, 2815130045, 3835354657], 'receipt': 'AwAAAAAAAAAAAAAAxAciAPPsD8genbvcCN2DvDmorNgPyU2p6hAM/h+8IU0pSDuhAAAAAAAAAAAAAAAAAAAAAAAAAAAAAAAAAAAAAAAAAAAAAAAAAAAAAAAAAAAAAAAAAQAAAAAAAAAAAAAAAAAAAAAAAAAAAAAAAAAAAAAAAAAAAAAAAAAAAAEAAAAAdAEAAAAAAAAHAAAANzAwMTIuMABkAQAAeyJ3YXNfZmlyc3RfZXZlbnQiOmZhbHNlLCJpbWFnZV9pZCI6WzI5NDg2MzA3OTIsMjQ4MjEzNjcxMSwxNTEyNjE4NjkyLDMxOTcwODI0MTgsODIwOTYzODY4LDQ2MzI0MzAwNSwyODE1MTMwMDQ1LDM4MzUzNTQ2NTddLCJxZiI6eyJiIjpbMCw0LDAsMCwwLDAsMCwwLDAsMCwwLDAsMCwxNiwwLDAsMCwwLDEyOCw5MCwxNzMsODYsMTcxLDIxMywxMDYsMTgxLDkwLDE3Myw4NiwxNzEsMjEzLDEwNiwxODEsOTAsMTczLDg2LDE3MSwyMTMsMTA2LDE4MSw5MCwxNzMsODYsMTcxLDIxMywxMDYsMTgxLDkwLDE3Myw2LDAsMCwwLDAsMCwwLDAsMCwwLDAsMCwwLDAsMCwwLDAsMCwwLDAsMCwwLDAsMF0sImwiOjM1LCJxIjo2LCJyIjo3fX0AAAAAAAAAAAAAAAB0AQAAAAAAAAcAAAA3MDAxMi4wAGQBAAB7Indhc19maXJzdF9ldmVudCI6ZmFsc2UsImltYWdlX2lkIjpbMjk0ODYzMDc5MiwyNDgyMTM2NzExLDE1MTI2MTg2OTIsMzE5NzA4MjQxOCw4MjA5NjM4NjgsNDYzMjQzMDA1LDI4MTUxMzAwNDUsMzgzNTM1NDY1N10sInFmIjp7ImIiOlswLDQsMCwwLDAsMCwwLDAsMCwwLDAsMCwwLDE2LDAsMCwwLDAsMTI4LDkwLDE3Myw4NiwxNzEsMjEzLDEwNiwxODEsOTAsMTczLDg2LDE3MSwyMTMsMTA2LDE4MSw5MCwxNzMsODYsMTcxLDIxMywxMDYsMTgxLDkwLDE3Myw4NiwxNzEsMjEzLDEwNiwxODEsOTAsMTczLDYsMCwwLDAsMCwwLDAsMCwwLDAsMCwwLDAsMCwwLDAsMCwwLDAsMCwwLDAsMCwwXSwibCI6MzUsInEiOjYsInIiOjd9fQAAAAAAAAAAAAAAAAAAAAAAAAAAAAAAAAAAAAAAAAAA'}}
prove_35;26;98;Mul;2548;72560;72560.0;953;0.07296599999972386;{'verificationValue': 72560.0, 'proof': {'imageId': [2948630792, 2482136711, 1512618692, 3197082418, 820963868, 463243005, 2815130045, 3835354657], 'receipt': 'AwAAAAAAAAAAAAAAxAciAPPsD8genbvcCN2DvDmorNgPyU2p6hAM/h+8IU0pSDuhAAAAAAAAAAAAAAAAAAAAAAAAAAAAAAAAAAAAAAAAAAAAAAAAAAAAAAAAAAAAAAAAAQAAAAAAAAAAAAAAAAAAAAAAAAAAAAAAAAAAAAAAAAAAAAAAAAAAAAEAAAAAeAEAAAAAAAAHAAAANzI1NjAuMABlAQAAeyJ3YXNfZmlyc3RfZXZlbnQiOmZhbHNlLCJpbWFnZV9pZCI6WzI5NDg2MzA3OTIsMjQ4MjEzNjcxMSwxNTEyNjE4NjkyLDMxOTcwODI0MTgsODIwOTYzODY4LDQ2MzI0MzAwNSwyODE1MTMwMDQ1LDM4MzUzNTQ2NTddLCJxZiI6eyJiIjpbMCw0LDAsMCwwLDAsMCwwLDAsMCwwLDAsMCwzMiwwLDAsMCwwLDEyOCw5MCwxNzMsODYsMTcxLDIxMywxMDYsMTgxLDkwLDE3Myw4NiwxNzEsMjEzLDEwNiwxODEsOTAsMTczLDg2LDE3MSwyMTMsMTA2LDE4MSw5MCwxNzMsODYsMTcxLDIxMywxMDYsMTgxLDkwLDE3Myw4NiwzLDAsMCwwLDAsMCwwLDAsMCwwLDAsMCwwLDAsMCwwLDAsMCwwLDAsMCwwLDBdLCJsIjozNiwicSI6NiwiciI6N319AAAAAAAAAAAAAAAAAAAAeAEAAAAAAAAHAAAANzI1NjAuMABlAQAAeyJ3YXNfZmlyc3RfZXZlbnQiOmZhbHNlLCJpbWFnZV9pZCI6WzI5NDg2MzA3OTIsMjQ4MjEzNjcxMSwxNTEyNjE4NjkyLDMxOTcwODI0MTgsODIwOTYzODY4LDQ2MzI0MzAwNSwyODE1MTMwMDQ1LDM4MzUzNTQ2NTddLCJxZiI6eyJiIjpbMCw0LDAsMCwwLDAsMCwwLDAsMCwwLDAsMCwzMiwwLDAsMCwwLDEyOCw5MCwxNzMsODYsMTcxLDIxMywxMDYsMTgxLDkwLDE3Myw4NiwxNzEsMjEzLDEwNiwxODEsOTAsMTczLDg2LDE3MSwyMTMsMTA2LDE4MSw5MCwxNzMsODYsMTcxLDIxMywxMDYsMTgxLDkwLDE3Myw4NiwzLDAsMCwwLDAsMCwwLDAsMCwwLDAsMCwwLDAsMCwwLDAsMCwwLDAsMCwwLDBdLCJsIjozNiwicSI6NiwiciI6N319AAAAAAAAAAAAAAAAAAAAAAAAAAAAAAAAAAAAAAAAAAAAAAA='}}
prove_36;32;60;Mul;1920;74480;74480.0;953;0.07317549999970652;{'verificationValue': 74480.0, 'proof': {'imageId': [2948630792, 2482136711, 1512618692, 3197082418, 820963868, 463243005, 2815130045, 3835354657], 'receipt': 'AwAAAAAAAAAAAAAAxAciAPPsD8genbvcCN2DvDmorNgPyU2p6hAM/h+8IU0pSDuhAAAAAAAAAAAAAAAAAAAAAAAAAAAAAAAAAAAAAAAAAAAAAAAAAAAAAAAAAAAAAAAAAQAAAAAAAAAAAAAAAAAAAAAAAAAAAAAAAAAAAAAAAAAAAAAAAAAAAAEAAAAAeAEAAAAAAAAHAAAANzQ0ODAuMABnAQAAeyJ3YXNfZmlyc3RfZXZlbnQiOmZhbHNlLCJpbWFnZV9pZCI6WzI5NDg2MzA3OTIsMjQ4MjEzNjcxMSwxNTEyNjE4NjkyLDMxOTcwODI0MTgsODIwOTYzODY4LDQ2MzI0MzAwNSwyODE1MTMwMDQ1LDM4MzUzNTQ2NTddLCJxZiI6eyJiIjpbMCw0LDAsMCwwLDAsMCwwLDAsMCwwLDAsMCw2NCwwLDAsMCwwLDEyOCw5MCwxNzMsODYsMTcxLDIxMywxMDYsMTgxLDkwLDE3Myw4NiwxNzEsMjEzLDEwNiwxODEsOTAsMTczLDg2LDE3MSwyMTMsMTA2LDE4MSw5MCwxNzMsODYsMTcxLDIxMywxMDYsMTgxLDkwLDE3Myw4NiwxNzEsMSwwLDAsMCwwLDAsMCwwLDAsMCwwLDAsMCwwLDAsMCwwLDAsMCwwLDAsMF0sImwiOjM3LCJxIjo2LCJyIjo3fX0AAAAAAAAAAAAAAAAAeAEAAAAAAAAHAAAANzQ0ODAuMABnAQAAeyJ3YXNfZmlyc3RfZXZlbnQiOmZhbHNlLCJpbWFnZV9pZCI6WzI5NDg2MzA3OTIsMjQ4MjEzNjcxMSwxNTEyNjE4NjkyLDMxOTcwODI0MTgsODIwOTYzODY4LDQ2MzI0MzAwNSwyODE1MTMwMDQ1LDM4MzUzNTQ2NTddLCJxZiI6eyJiIjpbMCw0LDAsMCwwLDAsMCwwLDAsMCwwLDAsMCw2NCwwLDAsMCwwLDEyOCw5MCwxNzMsODYsMTcxLDIxMywxMDYsMTgxLDkwLDE3Myw4NiwxNzEsMjEzLDEwNiwxODEsOTAsMTczLDg2LDE3MSwyMTMsMTA2LDE4MSw5MCwxNzMsODYsMTcxLDIxMywxMDYsMTgxLDkwLDE3Myw4NiwxNzEsMSwwLDAsMCwwLDAsMCwwLDAsMCwwLDAsMCwwLDAsMCwwLDAsMCwwLDAsMF0sImwiOjM3LCJxIjo2LCJyIjo3fX0AAAAAAAAAAAAAAAAAAAAAAAAAAAAAAAAAAAAAAAAAAAA='}}
prove_37;75;92;Mul;6900;81380;81380.0;961;0.07252154199886718;{'verificationValue': 81380.0, 'proof': {'imageId': [2948630792, 2482136711, 1512618692, 3197082418, 820963868, 463243005, 2815130045, 3835354657], 'receipt': 'AwAAAAAAAAAAAAAAxAciAPPsD8genbvcCN2DvDmorNgPyU2p6hAM/h+8IU0pSDuhAAAAAAAAAAAAAAAAAAAAAAAAAAAAAAAAAAAAAAAAAAAAAAAAAAAAAAAAAAAAAAAAAQAAAAAAAAAAAAAAAAAAAAAAAAAAAAAAAAAAAAAAAAAAAAAAAAAAAAEAAAAAfAEAAAAAAAAHAAAAODEzODAuMABqAQAAeyJ3YXNfZmlyc3RfZXZlbnQiOmZhbHNlLCJpbWFnZV9pZCI6WzI5NDg2MzA3OTIsMjQ4MjEzNjcxMSwxNTEyNjE4NjkyLDMxOTcwODI0MTgsODIwOTYzODY4LDQ2MzI0MzAwNSwyODE1MTMwMDQ1LDM4MzUzNTQ2NTddLCJxZiI6eyJiIjpbMCw0LDAsMCwwLDAsMCwwLDAsMCwwLDAsMCwxMjgsMCwwLDAsMCwxMjgsOTAsMTczLDg2LDE3MSwyMTMsMTA2LDE4MSw5MCwxNzMsODYsMTcxLDIxMywxMDYsMTgxLDkwLDE3Myw4NiwxNzEsMjEzLDEwNiwxODEsOTAsMTczLDg2LDE3MSwyMTMsMTA2LDE4MSw5MCwxNzMsODYsMTcxLDIxMywwLDAsMCwwLDAsMCwwLDAsMCwwLDAsMCwwLDAsMCwwLDAsMCwwLDAsMF0sImwiOjM4LCJxIjo2LCJyIjo3fX0AAAAAAAAAAAAAAAAAAHwBAAAAAAAABwAAADgxMzgwLjAAagEAAHsid2FzX2ZpcnN0X2V2ZW50IjpmYWxzZSwiaW1hZ2VfaWQiOlsyOTQ4NjMwNzkyLDI0ODIxMzY3MTEsMTUxMjYxODY5MiwzMTk3MDgyNDE4LDgyMDk2Mzg2OCw0NjMyNDMwMDUsMjgxNTEzMDA0NSwzODM1MzU0NjU3XSwicWYiOnsiYiI6WzAsNCwwLDAsMCwwLDAsMCwwLDAsMCwwLDAsMTI4LDAsMCwwLDAsMTI4LDkwLDE3Myw4NiwxNzEsMjEzLDEwNiwxODEsOTAsMTczLDg2LDE3MSwyMTMsMTA2LDE4MSw5MCwxNzMsODYsMTcxLDIxMywxMDYsMTgxLDkwLDE3Myw4NiwxNzEsMjEzLDEwNiwxODEsOTAsMTczLDg2LDE3MSwyMTMsMCwwLDAsMCwwLDAsMCwwLDAsMCwwLDAsMCwwLDAsMCwwLDAsMCwwLDBdLCJsIjozOCwicSI6NiwiciI6N319AAAAAAAAAAAAAAAAAAAAAAAAAAAAAAAAAAAAAAAAAAAAAA=='}}
prove_38;99;40;Mul;3960;85340;85340.0;961;0.07305016699865519;{'verificationValue': 85340.0, 'proof': {'imageId': [2948630792, 2482136711, 1512618692, 3197082418, 820963868, 463243005, 2815130045, 3835354657], 'receipt': 'AwAAAAAAAAAAAAAAxAciAPPsD8genbvcCN2DvDmorNgPyU2p6hAM/h+8IU0pSDuhAAAAAAAAAAAAAAAAAAAAAAAAAAAAAAAAAAAAAAAAAAAAAAAAAAAAAAAAAAAAAAAAAQAAAAAAAAAAAAAAAAAAAAAAAAAAAAAAAAAAAAAAAAAAAAAAAAAAAAEAAAAAfAEAAAAAAAAHAAAAODUzNDAuMABqAQAAeyJ3YXNfZmlyc3RfZXZlbnQiOmZhbHNlLCJpbWFnZV9pZCI6WzI5NDg2MzA3OTIsMjQ4MjEzNjcxMSwxNTEyNjE4NjkyLDMxOTcwODI0MTgsODIwOTYzODY4LDQ2MzI0MzAwNSwyODE1MTMwMDQ1LDM4MzUzNTQ2NTddLCJxZiI6eyJiIjpbMCw0LDAsMCwwLDAsMCwwLDAsMCwwLDAsMCwwLDEsMCwwLDAsMTI4LDkwLDE3Myw4NiwxNzEsMjEzLDEwNiwxODEsOTAsMTczLDg2LDE3MSwyMTMsMTA2LDE4MSw5MCwxNzMsODYsMTcxLDIxMywxMDYsMTgxLDkwLDE3Myw4NiwxNzEsMjEzLDEwNiwxODEsOTAsMTczLDg2LDE3MSwyMTMsMTA2LDAsMCwwLDAsMCwwLDAsMCwwLDAsMCwwLDAsMCwwLDAsMCwwLDAsMF0sImwiOjM5LCJxIjo2LCJyIjo3fX0AAAAAAAAAAAAAAAAAAHwBAAAAAAAABwAAADg1MzQwLjAAagEAAHsid2FzX2ZpcnN0X2V2ZW50IjpmYWxzZSwiaW1hZ2VfaWQiOlsyOTQ4NjMwNzkyLDI0ODIxMzY3MTEsMTUxMjYxODY5MiwzMTk3MDgyNDE4LDgyMDk2Mzg2OCw0NjMyNDMwMDUsMjgxNTEzMDA0NSwzODM1MzU0NjU3XSwicWYiOnsiYiI6WzAsNCwwLDAsMCwwLDAsMCwwLDAsMCwwLDAsMCwxLDAsMCwwLDEyOCw5MCwxNzMsODYsMTcxLDIxMywxMDYsMTgxLDkwLDE3Myw4NiwxNzEsMjEzLDEwNiwxODEsOTAsMTczLDg2LDE3MSwyMTMsMTA2LDE4MSw5MCwxNzMsODYsMTcxLDIxMywxMDYsMTgxLDkwLDE3Myw4NiwxNzEsMjEzLDEwNiwwLDAsMCwwLDAsMCwwLDAsMCwwLDAsMCwwLDAsMCwwLDAsMCwwLDBdLCJsIjozOSwicSI6NiwiciI6N319AAAAAAAAAAAAAAAAAAAAAAAAAAAAAAAAAAAAAAAAAAAAAA=='}}
prove_39;66;75;Mul;4950;90290;90290.0;961;0.07264458299869148;{'verificationValue': 90290.0, 'proof': {'imageId': [2948630792, 2482136711, 1512618692, 3197082418, 820963868, 463243005, 2815130045, 3835354657], 'receipt': 'AwAAAAAAAAAAAAAAxAciAPPsD8genbvcCN2DvDmorNgPyU2p6hAM/h+8IU0pSDuhAAAAAAAAAAAAAAAAAAAAAAAAAAAAAAAAAAAAAAAAAAAAAAAAAAAAAAAAAAAAAAAAAQAAAAAAAAAAAAAAAAAAAAAAAAAAAAAAAAAAAAAAAAAAAAAAAAAAAAEAAAAAfAEAAAAAAAAHAAAAOTAyOTAuMABrAQAAeyJ3YXNfZmlyc3RfZXZlbnQiOmZhbHNlLCJpbWFnZV9pZCI6WzI5NDg2MzA3OTIsMjQ4MjEzNjcxMSwxNTEyNjE4NjkyLDMxOTcwODI0MTgsODIwOTYzODY4LDQ2MzI0MzAwNSwyODE1MTMwMDQ1LDM4MzUzNTQ2NTddLCJxZiI6eyJiIjpbMCw0LDAsMCwwLDAsMCwwLDAsMCwwLDAsMCwwLDIsMCwwLDAsMTI4LDkwLDE3Myw4NiwxNzEsMjEzLDEwNiwxODEsOTAsMTczLDg2LDE3MSwyMTMsMTA2LDE4MSw5MCwxNzMsODYsMTcxLDIxMywxMDYsMTgxLDkwLDE3Myw4NiwxNzEsMjEzLDEwNiwxODEsOTAsMTczLDg2LDE3MSwyMTMsMTA2LDUzLDAsMCwwLDAsMCwwLDAsMCwwLDAsMCwwLDAsMCwwLDAsMCwwLDBdLCJsIjo0MCwicSI6NiwiciI6N319AAAAAAAAAAAAAAAAAHwBAAAAAAAABwAAADkwMjkwLjAAawEAAHsid2FzX2ZpcnN0X2V2ZW50IjpmYWxzZSwiaW1hZ2VfaWQiOlsyOTQ4NjMwNzkyLDI0ODIxMzY3MTEsMTUxMjYxODY5MiwzMTk3MDgyNDE4LDgyMDk2Mzg2OCw0NjMyNDMwMDUsMjgxNTEzMDA0NSwzODM1MzU0NjU3XSwicWYiOnsiYiI6WzAsNCwwLDAsMCwwLDAsMCwwLDAsMCwwLDAsMCwyLDAsMCwwLDEyOCw5MCwxNzMsODYsMTcxLDIxMywxMDYsMTgxLDkwLDE3Myw4NiwxNzEsMjEzLDEwNiwxODEsOTAsMTczLDg2LDE3MSwyMTMsMTA2LDE4MSw5MCwxNzMsODYsMTcxLDIxMywxMDYsMTgxLDkwLDE3Myw4NiwxNzEsMjEzLDEwNiw1MywwLDAsMCwwLDAsMCwwLDAsMCwwLDAsMCwwLDAsMCwwLDAsMCwwXSwibCI6NDAsInEiOjYsInIiOjd9fQAAAAAAAAAAAAAAAAAAAAAAAAAAAAAAAAAAAAAAAAAAAA=='}}
prove_40;54;53;Mul;2862;93152;93152.0;969;0.07226770800116356;{'verificationValue': 93152.0, 'proof': {'imageId': [2948630792, 2482136711, 1512618692, 3197082418, 820963868, 463243005, 2815130045, 3835354657], 'receipt': 'AwAAAAAAAAAAAAAAxAciAPPsD8genbvcCN2DvDmorNgPyU2p6hAM/h+8IU0pSDuhAAAAAAAAAAAAAAAAAAAAAAAAAAAAAAAAAAAAAAAAAAAAAAAAAAAAAAAAAAAAAAAAAQAAAAAAAAAAAAAAAAAAAAAAAAAAAAAAAAAAAAAAAAAAAAAAAAAAAAEAAAAAgAEAAAAAAAAHAAAAOTMxNTIuMABtAQAAeyJ3YXNfZmlyc3RfZXZlbnQiOmZhbHNlLCJpbWFnZV9pZCI6WzI5NDg2MzA3OTIsMjQ4MjEzNjcxMSwxNTEyNjE4NjkyLDMxOTcwODI0MTgsODIwOTYzODY4LDQ2MzI0MzAwNSwyODE1MTMwMDQ1LDM4MzUzNTQ2NTddLCJxZiI6eyJiIjpbMCw0LDAsMCwwLDAsMCwwLDAsMCwwLDAsMCwwLDQsMCwwLDAsMTI4LDkwLDE3Myw4NiwxNzEsMjEzLDEwNiwxODEsOTAsMTczLDg2LDE3MSwyMTMsMTA2LDE4MSw5MCwxNzMsODYsMTcxLDIxMywxMDYsMTgxLDkwLDE3Myw4NiwxNzEsMjEzLDEwNiwxODEsOTAsMTczLDg2LDE3MSwyMTMsMTA2LDE4MSwyNiwwLDAsMCwwLDAsMCwwLDAsMCwwLDAsMCwwLDAsMCwwLDAsMF0sImwiOjQxLCJxIjo2LCJyIjo3fX0AAAAAAAAAAAAAAAAAAACAAQAAAAAAAAcAAAA5MzE1Mi4wAG0BAAB7Indhc19maXJzdF9ldmVudCI6ZmFsc2UsImltYWdlX2lkIjpbMjk0ODYzMDc5MiwyNDgyMTM2NzExLDE1MTI2MTg2OTIsMzE5NzA4MjQxOCw4MjA5NjM4NjgsNDYzMjQzMDA1LDI4MTUxMzAwNDUsMzgzNTM1NDY1N10sInFmIjp7ImIiOlswLDQsMCwwLDAsMCwwLDAsMCwwLDAsMCwwLDAsNCwwLDAsMCwxMjgsOTAsMTczLDg2LDE3MSwyMTMsMTA2LDE4MSw5MCwxNzMsODYsMTcxLDIxMywxMDYsMTgxLDkwLDE3Myw4NiwxNzEsMjEzLDEwNiwxODEsOTAsMTczLDg2LDE3MSwyMTMsMTA2LDE4MSw5MCwxNzMsODYsMTcxLDIxMywxMDYsMTgxLDI2LDAsMCwwLDAsMCwwLDAsMCwwLDAsMCwwLDAsMCwwLDAsMCwwXSwibCI6NDEsInEiOjYsInIiOjd9fQAAAAAAAAAAAAAAAAAAAAAAAAAAAAAAAAAAAAAAAAAAAAAA'}}
prove_41;8;43;Mul;344;93496;93496.0;969;0.07255362499927287;{'verificationValue': 93496.0, 'proof': {'imageId': [2948630792, 2482136711, 1512618692, 3197082418, 820963868, 463243005, 2815130045, 3835354657], 'receipt': 'AwAAAAAAAAAAAAAAxAciAPPsD8genbvcCN2DvDmorNgPyU2p6hAM/h+8IU0pSDuhAAAAAAAAAAAAAAAAAAAAAAAAAAAAAAAAAAAAAAAAAAAAAAAAAAAAAAAAAAAAAAAAAQAAAAAAAAAAAAAAAAAAAAAAAAAAAAAAAAAAAAAAAAAAAAAAAAAAAAEAAAAAgAEAAAAAAAAHAAAAOTM0OTYuMABuAQAAeyJ3YXNfZmlyc3RfZXZlbnQiOmZhbHNlLCJpbWFnZV9pZCI6WzI5NDg2MzA3OTIsMjQ4MjEzNjcxMSwxNTEyNjE4NjkyLDMxOTcwODI0MTgsODIwOTYzODY4LDQ2MzI0MzAwNSwyODE1MTMwMDQ1LDM4MzUzNTQ2NTddLCJxZiI6eyJiIjpbMCw0LDAsMCwwLDAsMCwwLDAsMCwwLDAsMCwwLDgsMCwwLDAsMTI4LDkwLDE3Myw4NiwxNzEsMjEzLDEwNiwxODEsOTAsMTczLDg2LDE3MSwyMTMsMTA2LDE4MSw5MCwxNzMsODYsMTcxLDIxMywxMDYsMTgxLDkwLDE3Myw4NiwxNzEsMjEzLDEwNiwxODEsOTAsMTczLDg2LDE3MSwyMTMsMTA2LDE4MSw5MCwxMywwLDAsMCwwLDAsMCwwLDAsMCwwLDAsMCwwLDAsMCwwLDBdLCJsIjo0MiwicSI6NiwiciI6N319AAAAAAAAAAAAAAAAAACAAQAAAAAAAAcAAAA5MzQ5Ni4wAG4BAAB7Indhc19maXJzdF9ldmVudCI6ZmFsc2UsImltYWdlX2lkIjpbMjk0ODYzMDc5MiwyNDgyMTM2NzExLDE1MTI2MTg2OTIsMzE5NzA4MjQxOCw4MjA5NjM4NjgsNDYzMjQzMDA1LDI4MTUxMzAwNDUsMzgzNTM1NDY1N10sInFmIjp7ImIiOlswLDQsMCwwLDAsMCwwLDAsMCwwLDAsMCwwLDAsOCwwLDAsMCwxMjgsOTAsMTczLDg2LDE3MSwyMTMsMTA2LDE4MSw5MCwxNzMsODYsMTcxLDIxMywxMDYsMTgxLDkwLDE3Myw4NiwxNzEsMjEzLDEwNiwxODEsOTAsMTczLDg2LDE3MSwyMTMsMTA2LDE4MSw5MCwxNzMsODYsMTcxLDIxMywxMDYsMTgxLDkwLDEzLDAsMCwwLDAsMCwwLDAsMCwwLDAsMCwwLDAsMCwwLDAsMF0sImwiOjQyLCJxIjo2LCJyIjo3fX0AAAAAAAAAAAAAAAAAAAAAAAAAAAAAAAAAAAAAAAAAAAAA'}}
prove_42;83;49;Mul;4067;97563;97563.0;969;0.0722066670005006;{'verificationValue': 97563.0, 'proof': {'imageId': [2948630792, 2482136711, 1512618692, 3197082418, 820963868, 463243005, 2815130045, 3835354657], 'receipt': 'AwAAAAAAAAAAAAAAxAciAPPsD8genbvcCN2DvDmorNgPyU2p6hAM/h+8IU0pSDuhAAAAAAAAAAAAAAAAAAAAAAAAAAAAAAAAAAAAAAAAAAAAAAAAAAAAAAAAAAAAAAAAAQAAAAAAAAAAAAAAAAAAAAAAAAAAAAAAAAAAAAAAAAAAAAAAAAAAAAEAAAAAgAEAAAAAAAAHAAAAOTc1NjMuMABwAQAAeyJ3YXNfZmlyc3RfZXZlbnQiOmZhbHNlLCJpbWFnZV9pZCI6WzI5NDg2MzA3OTIsMjQ4MjEzNjcxMSwxNTEyNjE4NjkyLDMxOTcwODI0MTgsODIwOTYzODY4LDQ2MzI0MzAwNSwyODE1MTMwMDQ1LDM4MzUzNTQ2NTddLCJxZiI6eyJiIjpbMCw0LDAsMCwwLDAsMCwwLDAsMCwwLDAsMCwwLDE2LDAsMCwwLDEyOCw5MCwxNzMsODYsMTcxLDIxMywxMDYsMTgxLDkwLDE3Myw4NiwxNzEsMjEzLDEwNiwxODEsOTAsMTczLDg2LDE3MSwyMTMsMTA2LDE4MSw5MCwxNzMsODYsMTcxLDIxMywxMDYsMTgxLDkwLDE3Myw4NiwxNzEsMjEzLDEwNiwxODEsOTAsMTczLDYsMCwwLDAsMCwwLDAsMCwwLDAsMCwwLDAsMCwwLDAsMF0sImwiOjQzLCJxIjo2LCJyIjo3fX0AAAAAAAAAAAAAAACAAQAAAAAAAAcAAAA5NzU2My4wAHABAAB7Indhc19maXJzdF9ldmVudCI6ZmFsc2UsImltYWdlX2lkIjpbMjk0ODYzMDc5MiwyNDgyMTM2NzExLDE1MTI2MTg2OTIsMzE5NzA4MjQxOCw4MjA5NjM4NjgsNDYzMjQzMDA1LDI4MTUxMzAwNDUsMzgzNTM1NDY1N10sInFmIjp7ImIiOlswLDQsMCwwLDAsMCwwLDAsMCwwLDAsMCwwLDAsMTYsMCwwLDAsMTI4LDkwLDE3Myw4NiwxNzEsMjEzLDEwNiwxODEsOTAsMTczLDg2LDE3MSwyMTMsMTA2LDE4MSw5MCwxNzMsODYsMTcxLDIxMywxMDYsMTgxLDkwLDE3Myw4NiwxNzEsMjEzLDEwNiwxODEsOTAsMTczLDg2LDE3MSwyMTMsMTA2LDE4MSw5MCwxNzMsNiwwLDAsMCwwLDAsMCwwLDAsMCwwLDAsMCwwLDAsMCwwXSwibCI6NDMsInEiOjYsInIiOjd9fQAAAAAAAAAAAAAAAAAAAAAAAAAAAAAAAAAAAAAAAAAA'}}
prove_43;85;26;Mul;2210;99773;99773.0;977;0.0726756670010218;{'verificationValue': 99773.0, 'proof': {'imageId': [2948630792, 2482136711, 1512618692, 3197082418, 820963868, 463243005, 2815130045, 3835354657], 'receipt': 'AwAAAAAAAAAAAAAAxAciAPPsD8genbvcCN2DvDmorNgPyU2p6hAM/h+8IU0pSDuhAAAAAAAAAAAAAAAAAAAAAAAAAAAAAAAAAAAAAAAAAAAAAAAAAAAAAAAAAAAAAAAAAQAAAAAAAAAAAAAAAAAAAAAAAAAAAAAAAAAAAAAAAAAAAAAAAAAAAAEAAAAAhAEAAAAAAAAHAAAAOTk3NzMuMABxAQAAeyJ3YXNfZmlyc3RfZXZlbnQiOmZhbHNlLCJpbWFnZV9pZCI6WzI5NDg2MzA3OTIsMjQ4MjEzNjcxMSwxNTEyNjE4NjkyLDMxOTcwODI0MTgsODIwOTYzODY4LDQ2MzI0MzAwNSwyODE1MTMwMDQ1LDM4MzUzNTQ2NTddLCJxZiI6eyJiIjpbMCw0LDAsMCwwLDAsMCwwLDAsMCwwLDAsMCwwLDMyLDAsMCwwLDEyOCw5MCwxNzMsODYsMTcxLDIxMywxMDYsMTgxLDkwLDE3Myw4NiwxNzEsMjEzLDEwNiwxODEsOTAsMTczLDg2LDE3MSwyMTMsMTA2LDE4MSw5MCwxNzMsODYsMTcxLDIxMywxMDYsMTgxLDkwLDE3Myw4NiwxNzEsMjEzLDEwNiwxODEsOTAsMTczLDg2LDMsMCwwLDAsMCwwLDAsMCwwLDAsMCwwLDAsMCwwLDBdLCJsIjo0NCwicSI6NiwiciI6N319AAAAAAAAAAAAAAAAAAAAhAEAAAAAAAAHAAAAOTk3NzMuMABxAQAAeyJ3YXNfZmlyc3RfZXZlbnQiOmZhbHNlLCJpbWFnZV9pZCI6WzI5NDg2MzA3OTIsMjQ4MjEzNjcxMSwxNTEyNjE4NjkyLDMxOTcwODI0MTgsODIwOTYzODY4LDQ2MzI0MzAwNSwyODE1MTMwMDQ1LDM4MzUzNTQ2NTddLCJxZiI6eyJiIjpbMCw0LDAsMCwwLDAsMCwwLDAsMCwwLDAsMCwwLDMyLDAsMCwwLDEyOCw5MCwxNzMsODYsMTcxLDIxMywxMDYsMTgxLDkwLDE3Myw4NiwxNzEsMjEzLDEwNiwxODEsOTAsMTczLDg2LDE3MSwyMTMsMTA2LDE4MSw5MCwxNzMsODYsMTcxLDIxMywxMDYsMTgxLDkwLDE3Myw4NiwxNzEsMjEzLDEwNiwxODEsOTAsMTczLDg2LDMsMCwwLDAsMCwwLDAsMCwwLDAsMCwwLDAsMCwwLDBdLCJsIjo0NCwicSI6NiwiciI6N319AAAAAAAAAAAAAAAAAAAAAAAAAAAAAAAAAAAAAAAAAAAAAAA='}}
prove_44;66;94;Mul;6204;105977;105977.0;977;0.07271575000049779;{'verificationValue': 105977.0, 'proof': {'imageId': [2948630792, 2482136711, 1512618692, 3197082418, 820963868, 463243005, 2815130045, 3835354657], 'receipt': 'AwAAAAAAAAAAAAAAxAciAPPsD8genbvcCN2DvDmorNgPyU2p6hAM/h+8IU0pSDuhAAAAAAAAAAAAAAAAAAAAAAAAAAAAAAAAAAAAAAAAAAAAAAAAAAAAAAAAAAAAAAAAAQAAAAAAAAAAAAAAAAAAAAAAAAAAAAAAAAAAAAAAAAAAAAAAAAAAAAEAAAAAhAEAAAAAAAAIAAAAMTA1OTc3LjBzAQAAeyJ3YXNfZmlyc3RfZXZlbnQiOmZhbHNlLCJpbWFnZV9pZCI6WzI5NDg2MzA3OTIsMjQ4MjEzNjcxMSwxNTEyNjE4NjkyLDMxOTcwODI0MTgsODIwOTYzODY4LDQ2MzI0MzAwNSwyODE1MTMwMDQ1LDM4MzUzNTQ2NTddLCJxZiI6eyJiIjpbMCw0LDAsMCwwLDAsMCwwLDAsMCwwLDAsMCwwLDY0LDAsMCwwLDEyOCw5MCwxNzMsODYsMTcxLDIxMywxMDYsMTgxLDkwLDE3Myw4NiwxNzEsMjEzLDEwNiwxODEsOTAsMTczLDg2LDE3MSwyMTMsMTA2LDE4MSw5MCwxNzMsODYsMTcxLDIxMywxMDYsMTgxLDkwLDE3Myw4NiwxNzEsMjEzLDEwNiwxODEsOTAsMTczLDg2LDE3MSwxLDAsMCwwLDAsMCwwLDAsMCwwLDAsMCwwLDAsMF0sImwiOjQ1LCJxIjo2LCJyIjo3fX0AAAAAAAAAAAAAAAAAhAEAAAAAAAAIAAAAMTA1OTc3LjBzAQAAeyJ3YXNfZmlyc3RfZXZlbnQiOmZhbHNlLCJpbWFnZV9pZCI6WzI5NDg2MzA3OTIsMjQ4MjEzNjcxMSwxNTEyNjE4NjkyLDMxOTcwODI0MTgsODIwOTYzODY4LDQ2MzI0MzAwNSwyODE1MTMwMDQ1LDM4MzUzNTQ2NTddLCJxZiI6eyJiIjpbMCw0LDAsMCwwLDAsMCwwLDAsMCwwLDAsMCwwLDY0LDAsMCwwLDEyOCw5MCwxNzMsODYsMTcxLDIxMywxMDYsMTgxLDkwLDE3Myw4NiwxNzEsMjEzLDEwNiwxODEsOTAsMTczLDg2LDE3MSwyMTMsMTA2LDE4MSw5MCwxNzMsODYsMTcxLDIxMywxMDYsMTgxLDkwLDE3Myw4NiwxNzEsMjEzLDEwNiwxODEsOTAsMTczLDg2LDE3MSwxLDAsMCwwLDAsMCwwLDAsMCwwLDAsMCwwLDAsMF0sImwiOjQ1LCJxIjo2LCJyIjo3fX0AAAAAAAAAAAAAAAAAAAAAAAAAAAAAAAAAAAAAAAAAAAA='}}
prove_45;61;49;Mul;2989;108966;108966.0;985;0.07240016700052365;{'verificationValue': 108966.0, 'proof': {'imageId': [2948630792, 2482136711, 1512618692, 3197082418, 820963868, 463243005, 2815130045, 3835354657], 'receipt': 'AwAAAAAAAAAAAAAAxAciAPPsD8genbvcCN2DvDmorNgPyU2p6hAM/h+8IU0pSDuhAAAAAAAAAAAAAAAAAAAAAAAAAAAAAAAAAAAAAAAAAAAAAAAAAAAAAAAAAAAAAAAAAQAAAAAAAAAAAAAAAAAAAAAAAAAAAAAAAAAAAAAAAAAAAAAAAAAAAAEAAAAAiAEAAAAAAAAIAAAAMTA4OTY2LjB2AQAAeyJ3YXNfZmlyc3RfZXZlbnQiOmZhbHNlLCJpbWFnZV9pZCI6WzI5NDg2MzA3OTIsMjQ4MjEzNjcxMSwxNTEyNjE4NjkyLDMxOTcwODI0MTgsODIwOTYzODY4LDQ2MzI0MzAwNSwyODE1MTMwMDQ1LDM4MzUzNTQ2NTddLCJxZiI6eyJiIjpbMCw0LDAsMCwwLDAsMCwwLDAsMCwwLDAsMCwwLDEyOCwwLDAsMCwxMjgsOTAsMTczLDg2LDE3MSwyMTMsMTA2LDE4MSw5MCwxNzMsODYsMTcxLDIxMywxMDYsMTgxLDkwLDE3Myw4NiwxNzEsMjEzLDEwNiwxODEsOTAsMTczLDg2LDE3MSwyMTMsMTA2LDE4MSw5MCwxNzMsODYsMTcxLDIxMywxMDYsMTgxLDkwLDE3Myw4NiwxNzEsMjEzLDAsMCwwLDAsMCwwLDAsMCwwLDAsMCwwLDAsMF0sImwiOjQ2LCJxIjo2LCJyIjo3fX0AAAAAAAAAAAAAAAAAAIgBAAAAAAAACAAAADEwODk2Ni4wdgEAAHsid2FzX2ZpcnN0X2V2ZW50IjpmYWxzZSwiaW1hZ2VfaWQiOlsyOTQ4NjMwNzkyLDI0ODIxMzY3MTEsMTUxMjYxODY5MiwzMTk3MDgyNDE4LDgyMDk2Mzg2OCw0NjMyNDMwMDUsMjgxNTEzMDA0NSwzODM1MzU0NjU3XSwicWYiOnsiYiI6WzAsNCwwLDAsMCwwLDAsMCwwLDAsMCwwLDAsMCwxMjgsMCwwLDAsMTI4LDkwLDE3Myw4NiwxNzEsMjEzLDEwNiwxODEsOTAsMTczLDg2LDE3MSwyMTMsMTA2LDE4MSw5MCwxNzMsODYsMTcxLDIxMywxMDYsMTgxLDkwLDE3Myw4NiwxNzEsMjEzLDEwNiwxODEsOTAsMTczLDg2LDE3MSwyMTMsMTA2LDE4MSw5MCwxNzMsODYsMTcxLDIxMywwLDAsMCwwLDAsMCwwLDAsMCwwLDAsMCwwLDBdLCJsIjo0NiwicSI6NiwiciI6N319AAAAAAAAAAAAAAAAAAAAAAAAAAAAAAAAAAAAAAAAAAAAAA=='}}
prove_46;20;7;Mul;140;109106;109106.0;985;0.07292874999984633;{'verificationValue': 109106.0, 'proof': {'imageId': [2948630792, 2482136711, 1512618692, 3197082418, 820963868, 463243005, 2815130045, 3835354657], 'receipt': 'AwAAAAAAAAAAAAAAxAciAPPsD8genbvcCN2DvDmorNgPyU2p6hAM/h+8IU0pSDuhAAAAAAAAAAAAAAAAAAAAAAAAAAAAAAAAAAAAAAAAAAAAAAAAAAAAAAAAAAAAAAAAAQAAAAAAAAAAAAAAAAAAAAAAAAAAAAAAAAAAAAAAAAAAAAAAAAAAAAEAAAAAiAEAAAAAAAAIAAAAMTA5MTA2LjB2AQAAeyJ3YXNfZmlyc3RfZXZlbnQiOmZhbHNlLCJpbWFnZV9pZCI6WzI5NDg2MzA3OTIsMjQ4MjEzNjcxMSwxNTEyNjE4NjkyLDMxOTcwODI0MTgsODIwOTYzODY4LDQ2MzI0MzAwNSwyODE1MTMwMDQ1LDM4MzUzNTQ2NTddLCJxZiI6eyJiIjpbMCw0LDAsMCwwLDAsMCwwLDAsMCwwLDAsMCwwLDAsMSwwLDAsMTI4LDkwLDE3Myw4NiwxNzEsMjEzLDEwNiwxODEsOTAsMTczLDg2LDE3MSwyMTMsMTA2LDE4MSw5MCwxNzMsODYsMTcxLDIxMywxMDYsMTgxLDkwLDE3Myw4NiwxNzEsMjEzLDEwNiwxODEsOTAsMTczLDg2LDE3MSwyMTMsMTA2LDE4MSw5MCwxNzMsODYsMTcxLDIxMywxMDYsMCwwLDAsMCwwLDAsMCwwLDAsMCwwLDAsMF0sImwiOjQ3LCJxIjo2LCJyIjo3fX0AAAAAAAAAAAAAAAAAAIgBAAAAAAAACAAAADEwOTEwNi4wdgEAAHsid2FzX2ZpcnN0X2V2ZW50IjpmYWxzZSwiaW1hZ2VfaWQiOlsyOTQ4NjMwNzkyLDI0ODIxMzY3MTEsMTUxMjYxODY5MiwzMTk3MDgyNDE4LDgyMDk2Mzg2OCw0NjMyNDMwMDUsMjgxNTEzMDA0NSwzODM1MzU0NjU3XSwicWYiOnsiYiI6WzAsNCwwLDAsMCwwLDAsMCwwLDAsMCwwLDAsMCwwLDEsMCwwLDEyOCw5MCwxNzMsODYsMTcxLDIxMywxMDYsMTgxLDkwLDE3Myw4NiwxNzEsMjEzLDEwNiwxODEsOTAsMTczLDg2LDE3MSwyMTMsMTA2LDE4MSw5MCwxNzMsODYsMTcxLDIxMywxMDYsMTgxLDkwLDE3Myw4NiwxNzEsMjEzLDEwNiwxODEsOTAsMTczLDg2LDE3MSwyMTMsMTA2LDAsMCwwLDAsMCwwLDAsMCwwLDAsMCwwLDBdLCJsIjo0NywicSI6NiwiciI6N319AAAAAAAAAAAAAAAAAAAAAAAAAAAAAAAAAAAAAAAAAAAAAA=='}}
prove_47;95;79;Mul;7505;116611;116611.0;985;0.07280004099993675;{'verificationValue': 116611.0, 'proof': {'imageId': [2948630792, 2482136711, 1512618692, 3197082418, 820963868, 463243005, 2815130045, 3835354657], 'receipt': 'AwAAAAAAAAAAAAAAxAciAPPsD8genbvcCN2DvDmorNgPyU2p6hAM/h+8IU0pSDuhAAAAAAAAAAAAAAAAAAAAAAAAAAAAAAAAAAAAAAAAAAAAAAAAAAAAAAAAAAAAAAAAAQAAAAAAAAAAAAAAAAAAAAAAAAAAAAAAAAAAAAAAAAAAAAAAAAAAAAEAAAAAiAEAAAAAAAAIAAAAMTE2NjExLjB3AQAAeyJ3YXNfZmlyc3RfZXZlbnQiOmZhbHNlLCJpbWFnZV9pZCI6WzI5NDg2MzA3OTIsMjQ4MjEzNjcxMSwxNTEyNjE4NjkyLDMxOTcwODI0MTgsODIwOTYzODY4LDQ2MzI0MzAwNSwyODE1MTMwMDQ1LDM4MzUzNTQ2NTddLCJxZiI6eyJiIjpbMCw0LDAsMCwwLDAsMCwwLDAsMCwwLDAsMCwwLDAsMiwwLDAsMTI4LDkwLDE3Myw4NiwxNzEsMjEzLDEwNiwxODEsOTAsMTczLDg2LDE3MSwyMTMsMTA2LDE4MSw5MCwxNzMsODYsMTcxLDIxMywxMDYsMTgxLDkwLDE3Myw4NiwxNzEsMjEzLDEwNiwxODEsOTAsMTczLDg2LDE3MSwyMTMsMTA2LDE4MSw5MCwxNzMsODYsMTcxLDIxMywxMDYsNTMsMCwwLDAsMCwwLDAsMCwwLDAsMCwwLDBdLCJsIjo0OCwicSI6NiwiciI6N319AAAAAAAAAAAAAAAAAIgBAAAAAAAACAAAADExNjYxMS4wdwEAAHsid2FzX2ZpcnN0X2V2ZW50IjpmYWxzZSwiaW1hZ2VfaWQiOlsyOTQ4NjMwNzkyLDI0ODIxMzY3MTEsMTUxMjYxODY5MiwzMTk3MDgyNDE4LDgyMDk2Mzg2OCw0NjMyNDMwMDUsMjgxNTEzMDA0NSwzODM1MzU0NjU3XSwicWYiOnsiYiI6WzAsNCwwLDAsMCwwLDAsMCwwLDAsMCwwLDAsMCwwLDIsMCwwLDEyOCw5MCwxNzMsODYsMTcxLDIxMywxMDYsMTgxLDkwLDE3Myw4NiwxNzEsMjEzLDEwNiwxODEsOTAsMTczLDg2LDE3MSwyMTMsMTA2LDE4MSw5MCwxNzMsODYsMTcxLDIxMywxMDYsMTgxLDkwLDE3Myw4NiwxNzEsMjEzLDEwNiwxODEsOTAsMTczLDg2LDE3MSwyMTMsMTA2LDUzLDAsMCwwLDAsMCwwLDAsMCwwLDAsMCwwXSwibCI6NDgsInEiOjYsInIiOjd9fQAAAAAAAAAAAAAAAAAAAAAAAAAAAAAAAAAAAAAAAAAAAA=='}}
prove_48;27;60;Mul;1620;118231;118231.0;993;0.07261000000107742;{'verificationValue': 118231.0, 'proof': {'imageId': [2948630792, 2482136711, 1512618692, 3197082418, 820963868, 463243005, 2815130045, 3835354657], 'receipt': 'AwAAAAAAAAAAAAAAxAciAPPsD8genbvcCN2DvDmorNgPyU2p6hAM/h+8IU0pSDuhAAAAAAAAAAAAAAAAAAAAAAAAAAAAAAAAAAAAAAAAAAAAAAAAAAAAAAAAAAAAAAAAAQAAAAAAAAAAAAAAAAAAAAAAAAAAAAAAAAAAAAAAAAAAAAAAAAAAAAEAAAAAjAEAAAAAAAAIAAAAMTE4MjMxLjB5AQAAeyJ3YXNfZmlyc3RfZXZlbnQiOmZhbHNlLCJpbWFnZV9pZCI6WzI5NDg2MzA3OTIsMjQ4MjEzNjcxMSwxNTEyNjE4NjkyLDMxOTcwODI0MTgsODIwOTYzODY4LDQ2MzI0MzAwNSwyODE1MTMwMDQ1LDM4MzUzNTQ2NTddLCJxZiI6eyJiIjpbMCw0LDAsMCwwLDAsMCwwLDAsMCwwLDAsMCwwLDAsNCwwLDAsMTI4LDkwLDE3Myw4NiwxNzEsMjEzLDEwNiwxODEsOTAsMTczLDg2LDE3MSwyMTMsMTA2LDE4MSw5MCwxNzMsODYsMTcxLDIxMywxMDYsMTgxLDkwLDE3Myw4NiwxNzEsMjEzLDEwNiwxODEsOTAsMTczLDg2LDE3MSwyMTMsMTA2LDE4MSw5MCwxNzMsODYsMTcxLDIxMywxMDYsMTgxLDI2LDAsMCwwLDAsMCwwLDAsMCwwLDAsMF0sImwiOjQ5LCJxIjo2LCJyIjo3fX0AAAAAAAAAAAAAAAAAAACMAQAAAAAAAAgAAAAxMTgyMzEuMHkBAAB7Indhc19maXJzdF9ldmVudCI6ZmFsc2UsImltYWdlX2lkIjpbMjk0ODYzMDc5MiwyNDgyMTM2NzExLDE1MTI2MTg2OTIsMzE5NzA4MjQxOCw4MjA5NjM4NjgsNDYzMjQzMDA1LDI4MTUxMzAwNDUsMzgzNTM1NDY1N10sInFmIjp7ImIiOlswLDQsMCwwLDAsMCwwLDAsMCwwLDAsMCwwLDAsMCw0LDAsMCwxMjgsOTAsMTczLDg2LDE3MSwyMTMsMTA2LDE4MSw5MCwxNzMsODYsMTcxLDIxMywxMDYsMTgxLDkwLDE3Myw4NiwxNzEsMjEzLDEwNiwxODEsOTAsMTczLDg2LDE3MSwyMTMsMTA2LDE4MSw5MCwxNzMsODYsMTcxLDIxMywxMDYsMTgxLDkwLDE3Myw4NiwxNzEsMjEzLDEwNiwxODEsMjYsMCwwLDAsMCwwLDAsMCwwLDAsMCwwXSwibCI6NDksInEiOjYsInIiOjd9fQAAAAAAAAAAAAAAAAAAAAAAAAAAAAAAAAAAAAAAAAAAAAAA'}}
prove_49;91;61;Mul;5551;123782;123782.0;993;0.07247283399919979;{'verificationValue': 123782.0, 'proof': {'imageId': [2948630792, 2482136711, 1512618692, 3197082418, 820963868, 463243005, 2815130045, 3835354657], 'receipt': 'AwAAAAAAAAAAAAAAxAciAPPsD8genbvcCN2DvDmorNgPyU2p6hAM/h+8IU0pSDuhAAAAAAAAAAAAAAAAAAAAAAAAAAAAAAAAAAAAAAAAAAAAAAAAAAAAAAAAAAAAAAAAAQAAAAAAAAAAAAAAAAAAAAAAAAAAAAAAAAAAAAAAAAAAAAAAAAAAAAEAAAAAjAEAAAAAAAAIAAAAMTIzNzgyLjB6AQAAeyJ3YXNfZmlyc3RfZXZlbnQiOmZhbHNlLCJpbWFnZV9pZCI6WzI5NDg2MzA3OTIsMjQ4MjEzNjcxMSwxNTEyNjE4NjkyLDMxOTcwODI0MTgsODIwOTYzODY4LDQ2MzI0MzAwNSwyODE1MTMwMDQ1LDM4MzUzNTQ2NTddLCJxZiI6eyJiIjpbMCw0LDAsMCwwLDAsMCwwLDAsMCwwLDAsMCwwLDAsOCwwLDAsMTI4LDkwLDE3Myw4NiwxNzEsMjEzLDEwNiwxODEsOTAsMTczLDg2LDE3MSwyMTMsMTA2LDE4MSw5MCwxNzMsODYsMTcxLDIxMywxMDYsMTgxLDkwLDE3Myw4NiwxNzEsMjEzLDEwNiwxODEsOTAsMTczLDg2LDE3MSwyMTMsMTA2LDE4MSw5MCwxNzMsODYsMTcxLDIxMywxMDYsMTgxLDkwLDEzLDAsMCwwLDAsMCwwLDAsMCwwLDBdLCJsIjo1MCwicSI6NiwiciI6N319AAAAAAAAAAAAAAAAAACMAQAAAAAAAAgAAAAxMjM3ODIuMHoBAAB7Indhc19maXJzdF9ldmVudCI6ZmFsc2UsImltYWdlX2lkIjpbMjk0ODYzMDc5MiwyNDgyMTM2NzExLDE1MTI2MTg2OTIsMzE5NzA4MjQxOCw4MjA5NjM4NjgsNDYzMjQzMDA1LDI4MTUxMzAwNDUsMzgzNTM1NDY1N10sInFmIjp7ImIiOlswLDQsMCwwLDAsMCwwLDAsMCwwLDAsMCwwLDAsMCw4LDAsMCwxMjgsOTAsMTczLDg2LDE3MSwyMTMsMTA2LDE4MSw5MCwxNzMsODYsMTcxLDIxMywxMDYsMTgxLDkwLDE3Myw4NiwxNzEsMjEzLDEwNiwxODEsOTAsMTczLDg2LDE3MSwyMTMsMTA2LDE4MSw5MCwxNzMsODYsMTcxLDIxMywxMDYsMTgxLDkwLDE3Myw4NiwxNzEsMjEzLDEwNiwxODEsOTAsMTMsMCwwLDAsMCwwLDAsMCwwLDAsMF0sImwiOjUwLCJxIjo2LCJyIjo3fX0AAAAAAAAAAAAAAAAAAAAAAAAAAAAAAAAAAAAAAAAAAAAA'}}
prove_50;28;57;Mul;1596;125378;125378.0;993;0.07266925000112678;{'verificationValue': 125378.0, 'proof': {'imageId': [2948630792, 2482136711, 1512618692, 3197082418, 820963868, 463243005, 2815130045, 3835354657], 'receipt': 'AwAAAAAAAAAAAAAAxAciAPPsD8genbvcCN2DvDmorNgPyU2p6hAM/h+8IU0pSDuhAAAAAAAAAAAAAAAAAAAAAAAAAAAAAAAAAAAAAAAAAAAAAAAAAAAAAAAAAAAAAAAAAQAAAAAAAAAAAAAAAAAAAAAAAAAAAAAAAAAAAAAAAAAAAAAAAAAAAAEAAAAAjAEAAAAAAAAIAAAAMTI1Mzc4LjB8AQAAeyJ3YXNfZmlyc3RfZXZlbnQiOmZhbHNlLCJpbWFnZV9pZCI6WzI5NDg2MzA3OTIsMjQ4MjEzNjcxMSwxNTEyNjE4NjkyLDMxOTcwODI0MTgsODIwOTYzODY4LDQ2MzI0MzAwNSwyODE1MTMwMDQ1LDM4MzUzNTQ2NTddLCJxZiI6eyJiIjpbMCw0LDAsMCwwLDAsMCwwLDAsMCwwLDAsMCwwLDAsMTYsMCwwLDEyOCw5MCwxNzMsODYsMTcxLDIxMywxMDYsMTgxLDkwLDE3Myw4NiwxNzEsMjEzLDEwNiwxODEsOTAsMTczLDg2LDE3MSwyMTMsMTA2LDE4MSw5MCwxNzMsODYsMTcxLDIxMywxMDYsMTgxLDkwLDE3Myw4NiwxNzEsMjEzLDEwNiwxODEsOTAsMTczLDg2LDE3MSwyMTMsMTA2LDE4MSw5MCwxNzMsNiwwLDAsMCwwLDAsMCwwLDAsMF0sImwiOjUxLCJxIjo2LCJyIjo3fX0AAAAAAAAAAAAAAACMAQAAAAAAAAgAAAAxMjUzNzguMHwBAAB7Indhc19maXJzdF9ldmVudCI6ZmFsc2UsImltYWdlX2lkIjpbMjk0ODYzMDc5MiwyNDgyMTM2NzExLDE1MTI2MTg2OTIsMzE5NzA4MjQxOCw4MjA5NjM4NjgsNDYzMjQzMDA1LDI4MTUxMzAwNDUsMzgzNTM1NDY1N10sInFmIjp7ImIiOlswLDQsMCwwLDAsMCwwLDAsMCwwLDAsMCwwLDAsMCwxNiwwLDAsMTI4LDkwLDE3Myw4NiwxNzEsMjEzLDEwNiwxODEsOTAsMTczLDg2LDE3MSwyMTMsMTA2LDE4MSw5MCwxNzMsODYsMTcxLDIxMywxMDYsMTgxLDkwLDE3Myw4NiwxNzEsMjEzLDEwNiwxODEsOTAsMTczLDg2LDE3MSwyMTMsMTA2LDE4MSw5MCwxNzMsODYsMTcxLDIxMywxMDYsMTgxLDkwLDE3Myw2LDAsMCwwLDAsMCwwLDAsMCwwXSwibCI6NTEsInEiOjYsInIiOjd9fQAAAAAAAAAAAAAAAAAAAAAAAAAAAAAAAAAAAAAAAAAA'}}
prove_51;11;17;Mul;187;125565;125565.0;1001;0.07338858299954154;{'verificationValue': 125565.0, 'proof': {'imageId': [2948630792, 2482136711, 1512618692, 3197082418, 820963868, 463243005, 2815130045, 3835354657], 'receipt': 'AwAAAAAAAAAAAAAAxAciAPPsD8genbvcCN2DvDmorNgPyU2p6hAM/h+8IU0pSDuhAAAAAAAAAAAAAAAAAAAAAAAAAAAAAAAAAAAAAAAAAAAAAAAAAAAAAAAAAAAAAAAAAQAAAAAAAAAAAAAAAAAAAAAAAAAAAAAAAAAAAAAAAAAAAAAAAAAAAAEAAAAAkAEAAAAAAAAIAAAAMTI1NTY1LjB9AQAAeyJ3YXNfZmlyc3RfZXZlbnQiOmZhbHNlLCJpbWFnZV9pZCI6WzI5NDg2MzA3OTIsMjQ4MjEzNjcxMSwxNTEyNjE4NjkyLDMxOTcwODI0MTgsODIwOTYzODY4LDQ2MzI0MzAwNSwyODE1MTMwMDQ1LDM4MzUzNTQ2NTddLCJxZiI6eyJiIjpbMCw0LDAsMCwwLDAsMCwwLDAsMCwwLDAsMCwwLDAsMzIsMCwwLDEyOCw5MCwxNzMsODYsMTcxLDIxMywxMDYsMTgxLDkwLDE3Myw4NiwxNzEsMjEzLDEwNiwxODEsOTAsMTczLDg2LDE3MSwyMTMsMTA2LDE4MSw5MCwxNzMsODYsMTcxLDIxMywxMDYsMTgxLDkwLDE3Myw4NiwxNzEsMjEzLDEwNiwxODEsOTAsMTczLDg2LDE3MSwyMTMsMTA2LDE4MSw5MCwxNzMsODYsMywwLDAsMCwwLDAsMCwwLDBdLCJsIjo1MiwicSI6NiwiciI6N319AAAAAAAAAAAAAAAAAAAAkAEAAAAAAAAIAAAAMTI1NTY1LjB9AQAAeyJ3YXNfZmlyc3RfZXZlbnQiOmZhbHNlLCJpbWFnZV9pZCI6WzI5NDg2MzA3OTIsMjQ4MjEzNjcxMSwxNTEyNjE4NjkyLDMxOTcwODI0MTgsODIwOTYzODY4LDQ2MzI0MzAwNSwyODE1MTMwMDQ1LDM4MzUzNTQ2NTddLCJxZiI6eyJiIjpbMCw0LDAsMCwwLDAsMCwwLDAsMCwwLDAsMCwwLDAsMzIsMCwwLDEyOCw5MCwxNzMsODYsMTcxLDIxMywxMDYsMTgxLDkwLDE3Myw4NiwxNzEsMjEzLDEwNiwxODEsOTAsMTczLDg2LDE3MSwyMTMsMTA2LDE4MSw5MCwxNzMsODYsMTcxLDIxMywxMDYsMTgxLDkwLDE3Myw4NiwxNzEsMjEzLDEwNiwxODEsOTAsMTczLDg2LDE3MSwyMTMsMTA2LDE4MSw5MCwxNzMsODYsMywwLDAsMCwwLDAsMCwwLDBdLCJsIjo1MiwicSI6NiwiciI6N319AAAAAAAAAAAAAAAAAAAAAAAAAAAAAAAAAAAAAAAAAAAAAAA='}}
prove_52;88;71;Mul;6248;131813;131813.0;1001;0.07252195900036895;{'verificationValue': 131813.0, 'proof': {'imageId': [2948630792, 2482136711, 1512618692, 3197082418, 820963868, 463243005, 2815130045, 3835354657], 'receipt': 'AwAAAAAAAAAAAAAAxAciAPPsD8genbvcCN2DvDmorNgPyU2p6hAM/h+8IU0pSDuhAAAAAAAAAAAAAAAAAAAAAAAAAAAAAAAAAAAAAAAAAAAAAAAAAAAAAAAAAAAAAAAAAQAAAAAAAAAAAAAAAAAAAAAAAAAAAAAAAAAAAAAAAAAAAAAAAAAAAAEAAAAAkAEAAAAAAAAIAAAAMTMxODEzLjB/AQAAeyJ3YXNfZmlyc3RfZXZlbnQiOmZhbHNlLCJpbWFnZV9pZCI6WzI5NDg2MzA3OTIsMjQ4MjEzNjcxMSwxNTEyNjE4NjkyLDMxOTcwODI0MTgsODIwOTYzODY4LDQ2MzI0MzAwNSwyODE1MTMwMDQ1LDM4MzUzNTQ2NTddLCJxZiI6eyJiIjpbMCw0LDAsMCwwLDAsMCwwLDAsMCwwLDAsMCwwLDAsNjQsMCwwLDEyOCw5MCwxNzMsODYsMTcxLDIxMywxMDYsMTgxLDkwLDE3Myw4NiwxNzEsMjEzLDEwNiwxODEsOTAsMTczLDg2LDE3MSwyMTMsMTA2LDE4MSw5MCwxNzMsODYsMTcxLDIxMywxMDYsMTgxLDkwLDE3Myw4NiwxNzEsMjEzLDEwNiwxODEsOTAsMTczLDg2LDE3MSwyMTMsMTA2LDE4MSw5MCwxNzMsODYsMTcxLDEsMCwwLDAsMCwwLDAsMF0sImwiOjUzLCJxIjo2LCJyIjo3fX0AAAAAAAAAAAAAAAAAkAEAAAAAAAAIAAAAMTMxODEzLjB/AQAAeyJ3YXNfZmlyc3RfZXZlbnQiOmZhbHNlLCJpbWFnZV9pZCI6WzI5NDg2MzA3OTIsMjQ4MjEzNjcxMSwxNTEyNjE4NjkyLDMxOTcwODI0MTgsODIwOTYzODY4LDQ2MzI0MzAwNSwyODE1MTMwMDQ1LDM4MzUzNTQ2NTddLCJxZiI6eyJiIjpbMCw0LDAsMCwwLDAsMCwwLDAsMCwwLDAsMCwwLDAsNjQsMCwwLDEyOCw5MCwxNzMsODYsMTcxLDIxMywxMDYsMTgxLDkwLDE3Myw4NiwxNzEsMjEzLDEwNiwxODEsOTAsMTczLDg2LDE3MSwyMTMsMTA2LDE4MSw5MCwxNzMsODYsMTcxLDIxMywxMDYsMTgxLDkwLDE3Myw4NiwxNzEsMjEzLDEwNiwxODEsOTAsMTczLDg2LDE3MSwyMTMsMTA2LDE4MSw5MCwxNzMsODYsMTcxLDEsMCwwLDAsMCwwLDAsMF0sImwiOjUzLCJxIjo2LCJyIjo3fX0AAAAAAAAAAAAAAAAAAAAAAAAAAAAAAAAAAAAAAAAAAAA='}}
prove_53;13;13;Mul;169;131982;131982.0;1009;0.07261375000052794;{'verificationValue': 131982.0, 'proof': {'imageId': [2948630792, 2482136711, 1512618692, 3197082418, 820963868, 463243005, 2815130045, 3835354657], 'receipt': 'AwAAAAAAAAAAAAAAxAciAPPsD8genbvcCN2DvDmorNgPyU2p6hAM/h+8IU0pSDuhAAAAAAAAAAAAAAAAAAAAAAAAAAAAAAAAAAAAAAAAAAAAAAAAAAAAAAAAAAAAAAAAAQAAAAAAAAAAAAAAAAAAAAAAAAAAAAAAAAAAAAAAAAAAAAAAAAAAAAEAAAAAlAEAAAAAAAAIAAAAMTMxOTgyLjCCAQAAeyJ3YXNfZmlyc3RfZXZlbnQiOmZhbHNlLCJpbWFnZV9pZCI6WzI5NDg2MzA3OTIsMjQ4MjEzNjcxMSwxNTEyNjE4NjkyLDMxOTcwODI0MTgsODIwOTYzODY4LDQ2MzI0MzAwNSwyODE1MTMwMDQ1LDM4MzUzNTQ2NTddLCJxZiI6eyJiIjpbMCw0LDAsMCwwLDAsMCwwLDAsMCwwLDAsMCwwLDAsMTI4LDAsMCwxMjgsOTAsMTczLDg2LDE3MSwyMTMsMTA2LDE4MSw5MCwxNzMsODYsMTcxLDIxMywxMDYsMTgxLDkwLDE3Myw4NiwxNzEsMjEzLDEwNiwxODEsOTAsMTczLDg2LDE3MSwyMTMsMTA2LDE4MSw5MCwxNzMsODYsMTcxLDIxMywxMDYsMTgxLDkwLDE3Myw4NiwxNzEsMjEzLDEwNiwxODEsOTAsMTczLDg2LDE3MSwyMTMsMCwwLDAsMCwwLDAsMF0sImwiOjU0LCJxIjo2LCJyIjo3fX0AAAAAAAAAAAAAAAAAAJQBAAAAAAAACAAAADEzMTk4Mi4wggEAAHsid2FzX2ZpcnN0X2V2ZW50IjpmYWxzZSwiaW1hZ2VfaWQiOlsyOTQ4NjMwNzkyLDI0ODIxMzY3MTEsMTUxMjYxODY5MiwzMTk3MDgyNDE4LDgyMDk2Mzg2OCw0NjMyNDMwMDUsMjgxNTEzMDA0NSwzODM1MzU0NjU3XSwicWYiOnsiYiI6WzAsNCwwLDAsMCwwLDAsMCwwLDAsMCwwLDAsMCwwLDEyOCwwLDAsMTI4LDkwLDE3Myw4NiwxNzEsMjEzLDEwNiwxODEsOTAsMTczLDg2LDE3MSwyMTMsMTA2LDE4MSw5MCwxNzMsODYsMTcxLDIxMywxMDYsMTgxLDkwLDE3Myw4NiwxNzEsMjEzLDEwNiwxODEsOTAsMTczLDg2LDE3MSwyMTMsMTA2LDE4MSw5MCwxNzMsODYsMTcxLDIxMywxMDYsMTgxLDkwLDE3Myw4NiwxNzEsMjEzLDAsMCwwLDAsMCwwLDBdLCJsIjo1NCwicSI6NiwiciI6N319AAAAAAAAAAAAAAAAAAAAAAAAAAAAAAAAAAAAAAAAAAAAAA=='}}
prove_54;94;68;Mul;6392;138374;138374.0;1009;0.07315554200067709;{'verificationValue': 138374.0, 'proof': {'imageId': [2948630792, 2482136711, 1512618692, 3197082418, 820963868, 463243005, 2815130045, 3835354657], 'receipt': 'AwAAAAAAAAAAAAAAxAciAPPsD8genbvcCN2DvDmorNgPyU2p6hAM/h+8IU0pSDuhAAAAAAAAAAAAAAAAAAAAAAAAAAAAAAAAAAAAAAAAAAAAAAAAAAAAAAAAAAAAAAAAAQAAAAAAAAAAAAAAAAAAAAAAAAAAAAAAAAAAAAAAAAAAAAAAAAAAAAEAAAAAlAEAAAAAAAAIAAAAMTM4Mzc0LjCCAQAAeyJ3YXNfZmlyc3RfZXZlbnQiOmZhbHNlLCJpbWFnZV9pZCI6WzI5NDg2MzA3OTIsMjQ4MjEzNjcxMSwxNTEyNjE4NjkyLDMxOTcwODI0MTgsODIwOTYzODY4LDQ2MzI0MzAwNSwyODE1MTMwMDQ1LDM4MzUzNTQ2NTddLCJxZiI6eyJiIjpbMCw0LDAsMCwwLDAsMCwwLDAsMCwwLDAsMCwwLDAsMCwxLDAsMTI4LDkwLDE3Myw4NiwxNzEsMjEzLDEwNiwxODEsOTAsMTczLDg2LDE3MSwyMTMsMTA2LDE4MSw5MCwxNzMsODYsMTcxLDIxMywxMDYsMTgxLDkwLDE3Myw4NiwxNzEsMjEzLDEwNiwxODEsOTAsMTczLDg2LDE3MSwyMTMsMTA2LDE4MSw5MCwxNzMsODYsMTcxLDIxMywxMDYsMTgxLDkwLDE3Myw4NiwxNzEsMjEzLDEwNiwwLDAsMCwwLDAsMF0sImwiOjU1LCJxIjo2LCJyIjo3fX0AAAAAAAAAAAAAAAAAAJQBAAAAAAAACAAAADEzODM3NC4wggEAAHsid2FzX2ZpcnN0X2V2ZW50IjpmYWxzZSwiaW1hZ2VfaWQiOlsyOTQ4NjMwNzkyLDI0ODIxMzY3MTEsMTUxMjYxODY5MiwzMTk3MDgyNDE4LDgyMDk2Mzg2OCw0NjMyNDMwMDUsMjgxNTEzMDA0NSwzODM1MzU0NjU3XSwicWYiOnsiYiI6WzAsNCwwLDAsMCwwLDAsMCwwLDAsMCwwLDAsMCwwLDAsMSwwLDEyOCw5MCwxNzMsODYsMTcxLDIxMywxMDYsMTgxLDkwLDE3Myw4NiwxNzEsMjEzLDEwNiwxODEsOTAsMTczLDg2LDE3MSwyMTMsMTA2LDE4MSw5MCwxNzMsODYsMTcxLDIxMywxMDYsMTgxLDkwLDE3Myw4NiwxNzEsMjEzLDEwNiwxODEsOTAsMTczLDg2LDE3MSwyMTMsMTA2LDE4MSw5MCwxNzMsODYsMTcxLDIxMywxMDYsMCwwLDAsMCwwLDBdLCJsIjo1NSwicSI6NiwiciI6N319AAAAAAAAAAAAAAAAAAAAAAAAAAAAAAAAAAAAAAAAAAAAAA=='}}
prove_55;68;52;Mul;3536;141910;141910.0;1009;0.07244133299900568;{'verificationValue': 141910.0, 'proof': {'imageId': [2948630792, 2482136711, 1512618692, 3197082418, 820963868, 463243005, 2815130045, 3835354657], 'receipt': 'AwAAAAAAAAAAAAAAxAciAPPsD8genbvcCN2DvDmorNgPyU2p6hAM/h+8IU0pSDuhAAAAAAAAAAAAAAAAAAAAAAAAAAAAAAAAAAAAAAAAAAAAAAAAAAAAAAAAAAAAAAAAAQAAAAAAAAAAAAAAAAAAAAAAAAAAAAAAAAAAAAAAAAAAAAAAAAAAAAEAAAAAlAEAAAAAAAAIAAAAMTQxOTEwLjCDAQAAeyJ3YXNfZmlyc3RfZXZlbnQiOmZhbHNlLCJpbWFnZV9pZCI6WzI5NDg2MzA3OTIsMjQ4MjEzNjcxMSwxNTEyNjE4NjkyLDMxOTcwODI0MTgsODIwOTYzODY4LDQ2MzI0MzAwNSwyODE1MTMwMDQ1LDM4MzUzNTQ2NTddLCJxZiI6eyJiIjpbMCw0LDAsMCwwLDAsMCwwLDAsMCwwLDAsMCwwLDAsMCwyLDAsMTI4LDkwLDE3Myw4NiwxNzEsMjEzLDEwNiwxODEsOTAsMTczLDg2LDE3MSwyMTMsMTA2LDE4MSw5MCwxNzMsODYsMTcxLDIxMywxMDYsMTgxLDkwLDE3Myw4NiwxNzEsMjEzLDEwNiwxODEsOTAsMTczLDg2LDE3MSwyMTMsMTA2LDE4MSw5MCwxNzMsODYsMTcxLDIxMywxMDYsMTgxLDkwLDE3Myw4NiwxNzEsMjEzLDEwNiw1MywwLDAsMCwwLDBdLCJsIjo1NiwicSI6NiwiciI6N319AAAAAAAAAAAAAAAAAJQBAAAAAAAACAAAADE0MTkxMC4wgwEAAHsid2FzX2ZpcnN0X2V2ZW50IjpmYWxzZSwiaW1hZ2VfaWQiOlsyOTQ4NjMwNzkyLDI0ODIxMzY3MTEsMTUxMjYxODY5MiwzMTk3MDgyNDE4LDgyMDk2Mzg2OCw0NjMyNDMwMDUsMjgxNTEzMDA0NSwzODM1MzU0NjU3XSwicWYiOnsiYiI6WzAsNCwwLDAsMCwwLDAsMCwwLDAsMCwwLDAsMCwwLDAsMiwwLDEyOCw5MCwxNzMsODYsMTcxLDIxMywxMDYsMTgxLDkwLDE3Myw4NiwxNzEsMjEzLDEwNiwxODEsOTAsMTczLDg2LDE3MSwyMTMsMTA2LDE4MSw5MCwxNzMsODYsMTcxLDIxMywxMDYsMTgxLDkwLDE3Myw4NiwxNzEsMjEzLDEwNiwxODEsOTAsMTczLDg2LDE3MSwyMTMsMTA2LDE4MSw5MCwxNzMsODYsMTcxLDIxMywxMDYsNTMsMCwwLDAsMCwwXSwibCI6NTYsInEiOjYsInIiOjd9fQAAAAAAAAAAAAAAAAAAAAAAAAAAAAAAAAAAAAAAAAAAAA=='}}
prove_56;44;75;Mul;3300;145210;145210.0;1017;0.07226133400035906;{'verificationValue': 145210.0, 'proof': {'imageId': [2948630792, 2482136711, 1512618692, 3197082418, 820963868, 463243005, 2815130045, 3835354657], 'receipt': 'AwAAAAAAAAAAAAAAxAciAPPsD8genbvcCN2DvDmorNgPyU2p6hAM/h+8IU0pSDuhAAAAAAAAAAAAAAAAAAAAAAAAAAAAAAAAAAAAAAAAAAAAAAAAAAAAAAAAAAAAAAAAAQAAAAAAAAAAAAAAAAAAAAAAAAAAAAAAAAAAAAAAAAAAAAAAAAAAAAEAAAAAmAEAAAAAAAAIAAAAMTQ1MjEwLjCFAQAAeyJ3YXNfZmlyc3RfZXZlbnQiOmZhbHNlLCJpbWFnZV9pZCI6WzI5NDg2MzA3OTIsMjQ4MjEzNjcxMSwxNTEyNjE4NjkyLDMxOTcwODI0MTgsODIwOTYzODY4LDQ2MzI0MzAwNSwyODE1MTMwMDQ1LDM4MzUzNTQ2NTddLCJxZiI6eyJiIjpbMCw0LDAsMCwwLDAsMCwwLDAsMCwwLDAsMCwwLDAsMCw0LDAsMTI4LDkwLDE3Myw4NiwxNzEsMjEzLDEwNiwxODEsOTAsMTczLDg2LDE3MSwyMTMsMTA2LDE4MSw5MCwxNzMsODYsMTcxLDIxMywxMDYsMTgxLDkwLDE3Myw4NiwxNzEsMjEzLDEwNiwxODEsOTAsMTczLDg2LDE3MSwyMTMsMTA2LDE4MSw5MCwxNzMsODYsMTcxLDIxMywxMDYsMTgxLDkwLDE3Myw4NiwxNzEsMjEzLDEwNiwxODEsMjYsMCwwLDAsMF0sImwiOjU3LCJxIjo2LCJyIjo3fX0AAAAAAAAAAAAAAAAAAACYAQAAAAAAAAgAAAAxNDUyMTAuMIUBAAB7Indhc19maXJzdF9ldmVudCI6ZmFsc2UsImltYWdlX2lkIjpbMjk0ODYzMDc5MiwyNDgyMTM2NzExLDE1MTI2MTg2OTIsMzE5NzA4MjQxOCw4MjA5NjM4NjgsNDYzMjQzMDA1LDI4MTUxMzAwNDUsMzgzNTM1NDY1N10sInFmIjp7ImIiOlswLDQsMCwwLDAsMCwwLDAsMCwwLDAsMCwwLDAsMCwwLDQsMCwxMjgsOTAsMTczLDg2LDE3MSwyMTMsMTA2LDE4MSw5MCwxNzMsODYsMTcxLDIxMywxMDYsMTgxLDkwLDE3Myw4NiwxNzEsMjEzLDEwNiwxODEsOTAsMTczLDg2LDE3MSwyMTMsMTA2LDE4MSw5MCwxNzMsODYsMTcxLDIxMywxMDYsMTgxLDkwLDE3Myw4NiwxNzEsMjEzLDEwNiwxODEsOTAsMTczLDg2LDE3MSwyMTMsMTA2LDE4MSwyNiwwLDAsMCwwXSwibCI6NTcsInEiOjYsInIiOjd9fQAAAAAAAAAAAAAAAAAAAAAAAAAAAAAAAAAAAAAAAAAAAAAA'}}
prove_57;57;47;Mul;2679;147889;147889.0;1017;0.072587458000271;{'verificationValue': 147889.0, 'proof': {'imageId': [2948630792, 2482136711, 1512618692, 3197082418, 820963868, 463243005, 2815130045, 3835354657], 'receipt': 'AwAAAAAAAAAAAAAAxAciAPPsD8genbvcCN2DvDmorNgPyU2p6hAM/h+8IU0pSDuhAAAAAAAAAAAAAAAAAAAAAAAAAAAAAAAAAAAAAAAAAAAAAAAAAAAAAAAAAAAAAAAAAQAAAAAAAAAAAAAAAAAAAAAAAAAAAAAAAAAAAAAAAAAAAAAAAAAAAAEAAAAAmAEAAAAAAAAIAAAAMTQ3ODg5LjCGAQAAeyJ3YXNfZmlyc3RfZXZlbnQiOmZhbHNlLCJpbWFnZV9pZCI6WzI5NDg2MzA3OTIsMjQ4MjEzNjcxMSwxNTEyNjE4NjkyLDMxOTcwODI0MTgsODIwOTYzODY4LDQ2MzI0MzAwNSwyODE1MTMwMDQ1LDM4MzUzNTQ2NTddLCJxZiI6eyJiIjpbMCw0LDAsMCwwLDAsMCwwLDAsMCwwLDAsMCwwLDAsMCw4LDAsMTI4LDkwLDE3Myw4NiwxNzEsMjEzLDEwNiwxODEsOTAsMTczLDg2LDE3MSwyMTMsMTA2LDE4MSw5MCwxNzMsODYsMTcxLDIxMywxMDYsMTgxLDkwLDE3Myw4NiwxNzEsMjEzLDEwNiwxODEsOTAsMTczLDg2LDE3MSwyMTMsMTA2LDE4MSw5MCwxNzMsODYsMTcxLDIxMywxMDYsMTgxLDkwLDE3Myw4NiwxNzEsMjEzLDEwNiwxODEsOTAsMTMsMCwwLDBdLCJsIjo1OCwicSI6NiwiciI6N319AAAAAAAAAAAAAAAAAACYAQAAAAAAAAgAAAAxNDc4ODkuMIYBAAB7Indhc19maXJzdF9ldmVudCI6ZmFsc2UsImltYWdlX2lkIjpbMjk0ODYzMDc5MiwyNDgyMTM2NzExLDE1MTI2MTg2OTIsMzE5NzA4MjQxOCw4MjA5NjM4NjgsNDYzMjQzMDA1LDI4MTUxMzAwNDUsMzgzNTM1NDY1N10sInFmIjp7ImIiOlswLDQsMCwwLDAsMCwwLDAsMCwwLDAsMCwwLDAsMCwwLDgsMCwxMjgsOTAsMTczLDg2LDE3MSwyMTMsMTA2LDE4MSw5MCwxNzMsODYsMTcxLDIxMywxMDYsMTgxLDkwLDE3Myw4NiwxNzEsMjEzLDEwNiwxODEsOTAsMTczLDg2LDE3MSwyMTMsMTA2LDE4MSw5MCwxNzMsODYsMTcxLDIxMywxMDYsMTgxLDkwLDE3Myw4NiwxNzEsMjEzLDEwNiwxODEsOTAsMTczLDg2LDE3MSwyMTMsMTA2LDE4MSw5MCwxMywwLDAsMF0sImwiOjU4LCJxIjo2LCJyIjo3fX0AAAAAAAAAAAAAAAAAAAAAAAAAAAAAAAAAAAAAAAAAAAAA'}}
prove_58;1;94;Mul;94;147983;147983.0;1017;0.07259679200069513;{'verificationValue': 147983.0, 'proof': {'imageId': [2948630792, 2482136711, 1512618692, 3197082418, 820963868, 463243005, 2815130045, 3835354657], 'receipt': 'AwAAAAAAAAAAAAAAxAciAPPsD8genbvcCN2DvDmorNgPyU2p6hAM/h+8IU0pSDuhAAAAAAAAAAAAAAAAAAAAAAAAAAAAAAAAAAAAAAAAAAAAAAAAAAAAAAAAAAAAAAAAAQAAAAAAAAAAAAAAAAAAAAAAAAAAAAAAAAAAAAAAAAAAAAAAAAAAAAEAAAAAmAEAAAAAAAAIAAAAMTQ3OTgzLjCIAQAAeyJ3YXNfZmlyc3RfZXZlbnQiOmZhbHNlLCJpbWFnZV9pZCI6WzI5NDg2MzA3OTIsMjQ4MjEzNjcxMSwxNTEyNjE4NjkyLDMxOTcwODI0MTgsODIwOTYzODY4LDQ2MzI0MzAwNSwyODE1MTMwMDQ1LDM4MzUzNTQ2NTddLCJxZiI6eyJiIjpbMCw0LDAsMCwwLDAsMCwwLDAsMCwwLDAsMCwwLDAsMCwxNiwwLDEyOCw5MCwxNzMsODYsMTcxLDIxMywxMDYsMTgxLDkwLDE3Myw4NiwxNzEsMjEzLDEwNiwxODEsOTAsMTczLDg2LDE3MSwyMTMsMTA2LDE4MSw5MCwxNzMsODYsMTcxLDIxMywxMDYsMTgxLDkwLDE3Myw4NiwxNzEsMjEzLDEwNiwxODEsOTAsMTczLDg2LDE3MSwyMTMsMTA2LDE4MSw5MCwxNzMsODYsMTcxLDIxMywxMDYsMTgxLDkwLDE3Myw2LDAsMF0sImwiOjU5LCJxIjo2LCJyIjo3fX0AAAAAAAAAAAAAAACYAQAAAAAAAAgAAAAxNDc5ODMuMIgBAAB7Indhc19maXJzdF9ldmVudCI6ZmFsc2UsImltYWdlX2lkIjpbMjk0ODYzMDc5MiwyNDgyMTM2NzExLDE1MTI2MTg2OTIsMzE5NzA4MjQxOCw4MjA5NjM4NjgsNDYzMjQzMDA1LDI4MTUxMzAwNDUsMzgzNTM1NDY1N10sInFmIjp7ImIiOlswLDQsMCwwLDAsMCwwLDAsMCwwLDAsMCwwLDAsMCwwLDE2LDAsMTI4LDkwLDE3Myw4NiwxNzEsMjEzLDEwNiwxODEsOTAsMTczLDg2LDE3MSwyMTMsMTA2LDE4MSw5MCwxNzMsODYsMTcxLDIxMywxMDYsMTgxLDkwLDE3Myw4NiwxNzEsMjEzLDEwNiwxODEsOTAsMTczLDg2LDE3MSwyMTMsMTA2LDE4MSw5MCwxNzMsODYsMTcxLDIxMywxMDYsMTgxLDkwLDE3Myw4NiwxNzEsMjEzLDEwNiwxODEsOTAsMTczLDYsMCwwXSwibCI6NTksInEiOjYsInIiOjd9fQAAAAAAAAAAAAAAAAAAAAAAAAAAAAAAAAAAAAAAAAAA'}}
prove_59;22;23;Mul;506;148489;148489.0;1025;0.07239708400084055;{'verificationValue': 148489.0, 'proof': {'imageId': [2948630792, 2482136711, 1512618692, 3197082418, 820963868, 463243005, 2815130045, 3835354657], 'receipt': 'AwAAAAAAAAAAAAAAxAciAPPsD8genbvcCN2DvDmorNgPyU2p6hAM/h+8IU0pSDuhAAAAAAAAAAAAAAAAAAAAAAAAAAAAAAAAAAAAAAAAAAAAAAAAAAAAAAAAAAAAAAAAAQAAAAAAAAAAAAAAAAAAAAAAAAAAAAAAAAAAAAAAAAAAAAAAAAAAAAEAAAAAnAEAAAAAAAAIAAAAMTQ4NDg5LjCJAQAAeyJ3YXNfZmlyc3RfZXZlbnQiOmZhbHNlLCJpbWFnZV9pZCI6WzI5NDg2MzA3OTIsMjQ4MjEzNjcxMSwxNTEyNjE4NjkyLDMxOTcwODI0MTgsODIwOTYzODY4LDQ2MzI0MzAwNSwyODE1MTMwMDQ1LDM4MzUzNTQ2NTddLCJxZiI6eyJiIjpbMCw0LDAsMCwwLDAsMCwwLDAsMCwwLDAsMCwwLDAsMCwzMiwwLDEyOCw5MCwxNzMsODYsMTcxLDIxMywxMDYsMTgxLDkwLDE3Myw4NiwxNzEsMjEzLDEwNiwxODEsOTAsMTczLDg2LDE3MSwyMTMsMTA2LDE4MSw5MCwxNzMsODYsMTcxLDIxMywxMDYsMTgxLDkwLDE3Myw4NiwxNzEsMjEzLDEwNiwxODEsOTAsMTczLDg2LDE3MSwyMTMsMTA2LDE4MSw5MCwxNzMsODYsMTcxLDIxMywxMDYsMTgxLDkwLDE3Myw4NiwzLDBdLCJsIjo2MCwicSI6NiwiciI6N319AAAAAAAAAAAAAAAAAAAAnAEAAAAAAAAIAAAAMTQ4NDg5LjCJAQAAeyJ3YXNfZmlyc3RfZXZlbnQiOmZhbHNlLCJpbWFnZV9pZCI6WzI5NDg2MzA3OTIsMjQ4MjEzNjcxMSwxNTEyNjE4NjkyLDMxOTcwODI0MTgsODIwOTYzODY4LDQ2MzI0MzAwNSwyODE1MTMwMDQ1LDM4MzUzNTQ2NTddLCJxZiI6eyJiIjpbMCw0LDAsMCwwLDAsMCwwLDAsMCwwLDAsMCwwLDAsMCwzMiwwLDEyOCw5MCwxNzMsODYsMTcxLDIxMywxMDYsMTgxLDkwLDE3Myw4NiwxNzEsMjEzLDEwNiwxODEsOTAsMTczLDg2LDE3MSwyMTMsMTA2LDE4MSw5MCwxNzMsODYsMTcxLDIxMywxMDYsMTgxLDkwLDE3Myw4NiwxNzEsMjEzLDEwNiwxODEsOTAsMTczLDg2LDE3MSwyMTMsMTA2LDE4MSw5MCwxNzMsODYsMTcxLDIxMywxMDYsMTgxLDkwLDE3Myw4NiwzLDBdLCJsIjo2MCwicSI6NiwiciI6N319AAAAAAAAAAAAAAAAAAAAAAAAAAAAAAAAAAAAAAAAAAAAAAA='}}
prove_60;7;42;Mul;294;148783;148783.0;1025;0.07290670799920917;{'verificationValue': 148783.0, 'proof': {'imageId': [2948630792, 2482136711, 1512618692, 3197082418, 820963868, 463243005, 2815130045, 3835354657], 'receipt': 'AwAAAAAAAAAAAAAAxAciAPPsD8genbvcCN2DvDmorNgPyU2p6hAM/h+8IU0pSDuhAAAAAAAAAAAAAAAAAAAAAAAAAAAAAAAAAAAAAAAAAAAAAAAAAAAAAAAAAAAAAAAAAQAAAAAAAAAAAAAAAAAAAAAAAAAAAAAAAAAAAAAAAAAAAAAAAAAAAAEAAAAAnAEAAAAAAAAIAAAAMTQ4NzgzLjCJAQAAeyJ3YXNfZmlyc3RfZXZlbnQiOmZhbHNlLCJpbWFnZV9pZCI6WzI5NDg2MzA3OTIsMjQ4MjEzNjcxMSwxNTEyNjE4NjkyLDMxOTcwODI0MTgsODIwOTYzODY4LDQ2MzI0MzAwNSwyODE1MTMwMDQ1LDM4MzUzNTQ2NTddLCJxZiI6eyJiIjpbMCw0LDAsMCwwLDAsMCwwLDAsMCwwLDAsMCwwLDAsMCwzMiwwLDEyOCw5MCwxNzMsODYsMTcxLDIxMywxMDYsMTgxLDkwLDE3Myw4NiwxNzEsMjEzLDEwNiwxODEsOTAsMTczLDg2LDE3MSwyMTMsMTA2LDE4MSw5MCwxNzMsODYsMTcxLDIxMywxMDYsMTgxLDkwLDE3Myw4NiwxNzEsMjEzLDEwNiwxODEsOTAsMTczLDg2LDE3MSwyMTMsMTA2LDE4MSw5MCwxNzMsODYsMTcxLDIxMywxMDYsMTgxLDkwLDE3Myw4NiwzLDBdLCJsIjo2MCwicSI6NiwiciI6N319AAAAAAAAAAAAAAAAAAAAnAEAAAAAAAAIAAAAMTQ4NzgzLjCJAQAAeyJ3YXNfZmlyc3RfZXZlbnQiOmZhbHNlLCJpbWFnZV9pZCI6WzI5NDg2MzA3OTIsMjQ4MjEzNjcxMSwxNTEyNjE4NjkyLDMxOTcwODI0MTgsODIwOTYzODY4LDQ2MzI0MzAwNSwyODE1MTMwMDQ1LDM4MzUzNTQ2NTddLCJxZiI6eyJiIjpbMCw0LDAsMCwwLDAsMCwwLDAsMCwwLDAsMCwwLDAsMCwzMiwwLDEyOCw5MCwxNzMsODYsMTcxLDIxMywxMDYsMTgxLDkwLDE3Myw4NiwxNzEsMjEzLDEwNiwxODEsOTAsMTczLDg2LDE3MSwyMTMsMTA2LDE4MSw5MCwxNzMsODYsMTcxLDIxMywxMDYsMTgxLDkwLDE3Myw4NiwxNzEsMjEzLDEwNiwxODEsOTAsMTczLDg2LDE3MSwyMTMsMTA2LDE4MSw5MCwxNzMsODYsMTcxLDIxMywxMDYsMTgxLDkwLDE3Myw4NiwzLDBdLCJsIjo2MCwicSI6NiwiciI6N319AAAAAAAAAAAAAAAAAAAAAAAAAAAAAAAAAAAAAAAAAAAAAAA='}}
prove_61;29;18;Mul;522;149305;149305.0;1025;0.07356770799924561;{'verificationValue': 149305.0, 'proof': {'imageId': [2948630792, 2482136711, 1512618692, 3197082418, 820963868, 463243005, 2815130045, 3835354657], 'receipt': 'AwAAAAAAAAAAAAAAxAciAPPsD8genbvcCN2DvDmorNgPyU2p6hAM/h+8IU0pSDuhAAAAAAAAAAAAAAAAAAAAAAAAAAAAAAAAAAAAAAAAAAAAAAAAAAAAAAAAAAAAAAAAAQAAAAAAAAAAAAAAAAAAAAAAAAAAAAAAAAAAAAAAAAAAAAAAAAAAAAEAAAAAnAEAAAAAAAAIAAAAMTQ5MzA1LjCJAQAAeyJ3YXNfZmlyc3RfZXZlbnQiOmZhbHNlLCJpbWFnZV9pZCI6WzI5NDg2MzA3OTIsMjQ4MjEzNjcxMSwxNTEyNjE4NjkyLDMxOTcwODI0MTgsODIwOTYzODY4LDQ2MzI0MzAwNSwyODE1MTMwMDQ1LDM4MzUzNTQ2NTddLCJxZiI6eyJiIjpbMCw0LDAsMCwwLDAsMCwwLDAsMCwwLDAsMCwwLDAsMCwzMiwwLDEyOCw5MCwxNzMsODYsMTcxLDIxMywxMDYsMTgxLDkwLDE3Myw4NiwxNzEsMjEzLDEwNiwxODEsOTAsMTczLDg2LDE3MSwyMTMsMTA2LDE4MSw5MCwxNzMsODYsMTcxLDIxMywxMDYsMTgxLDkwLDE3Myw4NiwxNzEsMjEzLDEwNiwxODEsOTAsMTczLDg2LDE3MSwyMTMsMTA2LDE4MSw5MCwxNzMsODYsMTcxLDIxMywxMDYsMTgxLDkwLDE3Myw4NiwzLDBdLCJsIjo2MCwicSI6NiwiciI6N319AAAAAAAAAAAAAAAAAAAAnAEAAAAAAAAIAAAAMTQ5MzA1LjCJAQAAeyJ3YXNfZmlyc3RfZXZlbnQiOmZhbHNlLCJpbWFnZV9pZCI6WzI5NDg2MzA3OTIsMjQ4MjEzNjcxMSwxNTEyNjE4NjkyLDMxOTcwODI0MTgsODIwOTYzODY4LDQ2MzI0MzAwNSwyODE1MTMwMDQ1LDM4MzUzNTQ2NTddLCJxZiI6eyJiIjpbMCw0LDAsMCwwLDAsMCwwLDAsMCwwLDAsMCwwLDAsMCwzMiwwLDEyOCw5MCwxNzMsODYsMTcxLDIxMywxMDYsMTgxLDkwLDE3Myw4NiwxNzEsMjEzLDEwNiwxODEsOTAsMTczLDg2LDE3MSwyMTMsMTA2LDE4MSw5MCwxNzMsODYsMTcxLDIxMywxMDYsMTgxLDkwLDE3Myw4NiwxNzEsMjEzLDEwNiwxODEsOTAsMTczLDg2LDE3MSwyMTMsMTA2LDE4MSw5MCwxNzMsODYsMTcxLDIxMywxMDYsMTgxLDkwLDE3Myw4NiwzLDBdLCJsIjo2MCwicSI6NiwiciI6N319AAAAAAAAAAAAAAAAAAAAAAAAAAAAAAAAAAAAAAAAAAAAAAA='}}
prove_62;97;21;Mul;2037;151342;151342.0;1025;0.07318020799903024;{'verificationValue': 151342.0, 'proof': {'imageId': [2948630792, 2482136711, 1512618692, 3197082418, 820963868, 463243005, 2815130045, 3835354657], 'receipt': 'AwAAAAAAAAAAAAAAxAciAPPsD8genbvcCN2DvDmorNgPyU2p6hAM/h+8IU0pSDuhAAAAAAAAAAAAAAAAAAAAAAAAAAAAAAAAAAAAAAAAAAAAAAAAAAAAAAAAAAAAAAAAAQAAAAAAAAAAAAAAAAAAAAAAAAAAAAAAAAAAAAAAAAAAAAAAAAAAAAEAAAAAnAEAAAAAAAAIAAAAMTUxMzQyLjCJAQAAeyJ3YXNfZmlyc3RfZXZlbnQiOmZhbHNlLCJpbWFnZV9pZCI6WzI5NDg2MzA3OTIsMjQ4MjEzNjcxMSwxNTEyNjE4NjkyLDMxOTcwODI0MTgsODIwOTYzODY4LDQ2MzI0MzAwNSwyODE1MTMwMDQ1LDM4MzUzNTQ2NTddLCJxZiI6eyJiIjpbMCw0LDAsMCwwLDAsMCwwLDAsMCwwLDAsMCwwLDAsMCwzMiwwLDEyOCw5MCwxNzMsODYsMTcxLDIxMywxMDYsMTgxLDkwLDE3Myw4NiwxNzEsMjEzLDEwNiwxODEsOTAsMTczLDg2LDE3MSwyMTMsMTA2LDE4MSw5MCwxNzMsODYsMTcxLDIxMywxMDYsMTgxLDkwLDE3Myw4NiwxNzEsMjEzLDEwNiwxODEsOTAsMTczLDg2LDE3MSwyMTMsMTA2LDE4MSw5MCwxNzMsODYsMTcxLDIxMywxMDYsMTgxLDkwLDE3Myw4NiwzLDBdLCJsIjo2MCwicSI6NiwiciI6N319AAAAAAAAAAAAAAAAAAAAnAEAAAAAAAAIAAAAMTUxMzQyLjCJAQAAeyJ3YXNfZmlyc3RfZXZlbnQiOmZhbHNlLCJpbWFnZV9pZCI6WzI5NDg2MzA3OTIsMjQ4MjEzNjcxMSwxNTEyNjE4NjkyLDMxOTcwODI0MTgsODIwOTYzODY4LDQ2MzI0MzAwNSwyODE1MTMwMDQ1LDM4MzUzNTQ2NTddLCJxZiI6eyJiIjpbMCw0LDAsMCwwLDAsMCwwLDAsMCwwLDAsMCwwLDAsMCwzMiwwLDEyOCw5MCwxNzMsODYsMTcxLDIxMywxMDYsMTgxLDkwLDE3Myw4NiwxNzEsMjEzLDEwNiwxODEsOTAsMTczLDg2LDE3MSwyMTMsMTA2LDE4MSw5MCwxNzMsODYsMTcxLDIxMywxMDYsMTgxLDkwLDE3Myw4NiwxNzEsMjEzLDEwNiwxODEsOTAsMTczLDg2LDE3MSwyMTMsMTA2LDE4MSw5MCwxNzMsODYsMTcxLDIxMywxMDYsMTgxLDkwLDE3Myw4NiwzLDBdLCJsIjo2MCwicSI6NiwiciI6N319AAAAAAAAAAAAAAAAAAAAAAAAAAAAAAAAAAAAAAAAAAAAAAA='}}
prove_63;50;76;Mul;3800;155142;155142.0;1025;0.07322145800026192;{'verificationValue': 155142.0, 'proof': {'imageId': [2948630792, 2482136711, 1512618692, 3197082418, 820963868, 463243005, 2815130045, 3835354657], 'receipt': 'AwAAAAAAAAAAAAAAxAciAPPsD8genbvcCN2DvDmorNgPyU2p6hAM/h+8IU0pSDuhAAAAAAAAAAAAAAAAAAAAAAAAAAAAAAAAAAAAAAAAAAAAAAAAAAAAAAAAAAAAAAAAAQAAAAAAAAAAAAAAAAAAAAAAAAAAAAAAAAAAAAAAAAAAAAAAAAAAAAEAAAAAnAEAAAAAAAAIAAAAMTU1MTQyLjCJAQAAeyJ3YXNfZmlyc3RfZXZlbnQiOmZhbHNlLCJpbWFnZV9pZCI6WzI5NDg2MzA3OTIsMjQ4MjEzNjcxMSwxNTEyNjE4NjkyLDMxOTcwODI0MTgsODIwOTYzODY4LDQ2MzI0MzAwNSwyODE1MTMwMDQ1LDM4MzUzNTQ2NTddLCJxZiI6eyJiIjpbMCw0LDAsMCwwLDAsMCwwLDAsMCwwLDAsMCwwLDAsMCwzMiwwLDEyOCw5MCwxNzMsODYsMTcxLDIxMywxMDYsMTgxLDkwLDE3Myw4NiwxNzEsMjEzLDEwNiwxODEsOTAsMTczLDg2LDE3MSwyMTMsMTA2LDE4MSw5MCwxNzMsODYsMTcxLDIxMywxMDYsMTgxLDkwLDE3Myw4NiwxNzEsMjEzLDEwNiwxODEsOTAsMTczLDg2LDE3MSwyMTMsMTA2LDE4MSw5MCwxNzMsODYsMTcxLDIxMywxMDYsMTgxLDkwLDE3Myw4NiwzLDBdLCJsIjo2MCwicSI6NiwiciI6N319AAAAAAAAAAAAAAAAAAAAnAEAAAAAAAAIAAAAMTU1MTQyLjCJAQAAeyJ3YXNfZmlyc3RfZXZlbnQiOmZhbHNlLCJpbWFnZV9pZCI6WzI5NDg2MzA3OTIsMjQ4MjEzNjcxMSwxNTEyNjE4NjkyLDMxOTcwODI0MTgsODIwOTYzODY4LDQ2MzI0MzAwNSwyODE1MTMwMDQ1LDM4MzUzNTQ2NTddLCJxZiI6eyJiIjpbMCw0LDAsMCwwLDAsMCwwLDAsMCwwLDAsMCwwLDAsMCwzMiwwLDEyOCw5MCwxNzMsODYsMTcxLDIxMywxMDYsMTgxLDkwLDE3Myw4NiwxNzEsMjEzLDEwNiwxODEsOTAsMTczLDg2LDE3MSwyMTMsMTA2LDE4MSw5MCwxNzMsODYsMTcxLDIxMywxMDYsMTgxLDkwLDE3Myw4NiwxNzEsMjEzLDEwNiwxODEsOTAsMTczLDg2LDE3MSwyMTMsMTA2LDE4MSw5MCwxNzMsODYsMTcxLDIxMywxMDYsMTgxLDkwLDE3Myw4NiwzLDBdLCJsIjo2MCwicSI6NiwiciI6N319AAAAAAAAAAAAAAAAAAAAAAAAAAAAAAAAAAAAAAAAAAAAAAA='}}
prove_64;6;22;Mul;132;155274;155274.0;1025;0.07237229099882825;{'verificationValue': 155274.0, 'proof': {'imageId': [2948630792, 2482136711, 1512618692, 3197082418, 820963868, 463243005, 2815130045, 3835354657], 'receipt': 'AwAAAAAAAAAAAAAAxAciAPPsD8genbvcCN2DvDmorNgPyU2p6hAM/h+8IU0pSDuhAAAAAAAAAAAAAAAAAAAAAAAAAAAAAAAAAAAAAAAAAAAAAAAAAAAAAAAAAAAAAAAAAQAAAAAAAAAAAAAAAAAAAAAAAAAAAAAAAAAAAAAAAAAAAAAAAAAAAAEAAAAAnAEAAAAAAAAIAAAAMTU1Mjc0LjCJAQAAeyJ3YXNfZmlyc3RfZXZlbnQiOmZhbHNlLCJpbWFnZV9pZCI6WzI5NDg2MzA3OTIsMjQ4MjEzNjcxMSwxNTEyNjE4NjkyLDMxOTcwODI0MTgsODIwOTYzODY4LDQ2MzI0MzAwNSwyODE1MTMwMDQ1LDM4MzUzNTQ2NTddLCJxZiI6eyJiIjpbMCw0LDAsMCwwLDAsMCwwLDAsMCwwLDAsMCwwLDAsMCwzMiwwLDEyOCw5MCwxNzMsODYsMTcxLDIxMywxMDYsMTgxLDkwLDE3Myw4NiwxNzEsMjEzLDEwNiwxODEsOTAsMTczLDg2LDE3MSwyMTMsMTA2LDE4MSw5MCwxNzMsODYsMTcxLDIxMywxMDYsMTgxLDkwLDE3Myw4NiwxNzEsMjEzLDEwNiwxODEsOTAsMTczLDg2LDE3MSwyMTMsMTA2LDE4MSw5MCwxNzMsODYsMTcxLDIxMywxMDYsMTgxLDkwLDE3Myw4NiwzLDBdLCJsIjo2MCwicSI6NiwiciI6N319AAAAAAAAAAAAAAAAAAAAnAEAAAAAAAAIAAAAMTU1Mjc0LjCJAQAAeyJ3YXNfZmlyc3RfZXZlbnQiOmZhbHNlLCJpbWFnZV9pZCI6WzI5NDg2MzA3OTIsMjQ4MjEzNjcxMSwxNTEyNjE4NjkyLDMxOTcwODI0MTgsODIwOTYzODY4LDQ2MzI0MzAwNSwyODE1MTMwMDQ1LDM4MzUzNTQ2NTddLCJxZiI6eyJiIjpbMCw0LDAsMCwwLDAsMCwwLDAsMCwwLDAsMCwwLDAsMCwzMiwwLDEyOCw5MCwxNzMsODYsMTcxLDIxMywxMDYsMTgxLDkwLDE3Myw4NiwxNzEsMjEzLDEwNiwxODEsOTAsMTczLDg2LDE3MSwyMTMsMTA2LDE4MSw5MCwxNzMsODYsMTcxLDIxMywxMDYsMTgxLDkwLDE3Myw4NiwxNzEsMjEzLDEwNiwxODEsOTAsMTczLDg2LDE3MSwyMTMsMTA2LDE4MSw5MCwxNzMsODYsMTcxLDIxMywxMDYsMTgxLDkwLDE3Myw4NiwzLDBdLCJsIjo2MCwicSI6NiwiciI6N319AAAAAAAAAAAAAAAAAAAAAAAAAAAAAAAAAAAAAAAAAAAAAAA='}}
prove_65;32;93;Mul;2976;158250;158250.0;1025;0.07288383299965062;{'verificationValue': 158250.0, 'proof': {'imageId': [2948630792, 2482136711, 1512618692, 3197082418, 820963868, 463243005, 2815130045, 3835354657], 'receipt': 'AwAAAAAAAAAAAAAAxAciAPPsD8genbvcCN2DvDmorNgPyU2p6hAM/h+8IU0pSDuhAAAAAAAAAAAAAAAAAAAAAAAAAAAAAAAAAAAAAAAAAAAAAAAAAAAAAAAAAAAAAAAAAQAAAAAAAAAAAAAAAAAAAAAAAAAAAAAAAAAAAAAAAAAAAAAAAAAAAAEAAAAAnAEAAAAAAAAIAAAAMTU4MjUwLjCJAQAAeyJ3YXNfZmlyc3RfZXZlbnQiOmZhbHNlLCJpbWFnZV9pZCI6WzI5NDg2MzA3OTIsMjQ4MjEzNjcxMSwxNTEyNjE4NjkyLDMxOTcwODI0MTgsODIwOTYzODY4LDQ2MzI0MzAwNSwyODE1MTMwMDQ1LDM4MzUzNTQ2NTddLCJxZiI6eyJiIjpbMCw0LDAsMCwwLDAsMCwwLDAsMCwwLDAsMCwwLDAsMCwzMiwwLDEyOCw5MCwxNzMsODYsMTcxLDIxMywxMDYsMTgxLDkwLDE3Myw4NiwxNzEsMjEzLDEwNiwxODEsOTAsMTczLDg2LDE3MSwyMTMsMTA2LDE4MSw5MCwxNzMsODYsMTcxLDIxMywxMDYsMTgxLDkwLDE3Myw4NiwxNzEsMjEzLDEwNiwxODEsOTAsMTczLDg2LDE3MSwyMTMsMTA2LDE4MSw5MCwxNzMsODYsMTcxLDIxMywxMDYsMTgxLDkwLDE3Myw4NiwzLDBdLCJsIjo2MCwicSI6NiwiciI6N319AAAAAAAAAAAAAAAAAAAAnAEAAAAAAAAIAAAAMTU4MjUwLjCJAQAAeyJ3YXNfZmlyc3RfZXZlbnQiOmZhbHNlLCJpbWFnZV9pZCI6WzI5NDg2MzA3OTIsMjQ4MjEzNjcxMSwxNTEyNjE4NjkyLDMxOTcwODI0MTgsODIwOTYzODY4LDQ2MzI0MzAwNSwyODE1MTMwMDQ1LDM4MzUzNTQ2NTddLCJxZiI6eyJiIjpbMCw0LDAsMCwwLDAsMCwwLDAsMCwwLDAsMCwwLDAsMCwzMiwwLDEyOCw5MCwxNzMsODYsMTcxLDIxMywxMDYsMTgxLDkwLDE3Myw4NiwxNzEsMjEzLDEwNiwxODEsOTAsMTczLDg2LDE3MSwyMTMsMTA2LDE4MSw5MCwxNzMsODYsMTcxLDIxMywxMDYsMTgxLDkwLDE3Myw4NiwxNzEsMjEzLDEwNiwxODEsOTAsMTczLDg2LDE3MSwyMTMsMTA2LDE4MSw5MCwxNzMsODYsMTcxLDIxMywxMDYsMTgxLDkwLDE3Myw4NiwzLDBdLCJsIjo2MCwicSI6NiwiciI6N319AAAAAAAAAAAAAAAAAAAAAAAAAAAAAAAAAAAAAAAAAAAAAAA='}}
prove_66;43;99;Mul;4257;162507;162507.0;1025;0.07256833300016297;{'verificationValue': 162507.0, 'proof': {'imageId': [2948630792, 2482136711, 1512618692, 3197082418, 820963868, 463243005, 2815130045, 3835354657], 'receipt': 'AwAAAAAAAAAAAAAAxAciAPPsD8genbvcCN2DvDmorNgPyU2p6hAM/h+8IU0pSDuhAAAAAAAAAAAAAAAAAAAAAAAAAAAAAAAAAAAAAAAAAAAAAAAAAAAAAAAAAAAAAAAAAQAAAAAAAAAAAAAAAAAAAAAAAAAAAAAAAAAAAAAAAAAAAAAAAAAAAAEAAAAAnAEAAAAAAAAIAAAAMTYyNTA3LjCJAQAAeyJ3YXNfZmlyc3RfZXZlbnQiOmZhbHNlLCJpbWFnZV9pZCI6WzI5NDg2MzA3OTIsMjQ4MjEzNjcxMSwxNTEyNjE4NjkyLDMxOTcwODI0MTgsODIwOTYzODY4LDQ2MzI0MzAwNSwyODE1MTMwMDQ1LDM4MzUzNTQ2NTddLCJxZiI6eyJiIjpbMCw0LDAsMCwwLDAsMCwwLDAsMCwwLDAsMCwwLDAsMCwzMiwwLDEyOCw5MCwxNzMsODYsMTcxLDIxMywxMDYsMTgxLDkwLDE3Myw4NiwxNzEsMjEzLDEwNiwxODEsOTAsMTczLDg2LDE3MSwyMTMsMTA2LDE4MSw5MCwxNzMsODYsMTcxLDIxMywxMDYsMTgxLDkwLDE3Myw4NiwxNzEsMjEzLDEwNiwxODEsOTAsMTczLDg2LDE3MSwyMTMsMTA2LDE4MSw5MCwxNzMsODYsMTcxLDIxMywxMDYsMTgxLDkwLDE3Myw4NiwzLDBdLCJsIjo2MCwicSI6NiwiciI6N319AAAAAAAAAAAAAAAAAAAAnAEAAAAAAAAIAAAAMTYyNTA3LjCJAQAAeyJ3YXNfZmlyc3RfZXZlbnQiOmZhbHNlLCJpbWFnZV9pZCI6WzI5NDg2MzA3OTIsMjQ4MjEzNjcxMSwxNTEyNjE4NjkyLDMxOTcwODI0MTgsODIwOTYzODY4LDQ2MzI0MzAwNSwyODE1MTMwMDQ1LDM4MzUzNTQ2NTddLCJxZiI6eyJiIjpbMCw0LDAsMCwwLDAsMCwwLDAsMCwwLDAsMCwwLDAsMCwzMiwwLDEyOCw5MCwxNzMsODYsMTcxLDIxMywxMDYsMTgxLDkwLDE3Myw4NiwxNzEsMjEzLDEwNiwxODEsOTAsMTczLDg2LDE3MSwyMTMsMTA2LDE4MSw5MCwxNzMsODYsMTcxLDIxMywxMDYsMTgxLDkwLDE3Myw4NiwxNzEsMjEzLDEwNiwxODEsOTAsMTczLDg2LDE3MSwyMTMsMTA2LDE4MSw5MCwxNzMsODYsMTcxLDIxMywxMDYsMTgxLDkwLDE3Myw4NiwzLDBdLCJsIjo2MCwicSI6NiwiciI6N319AAAAAAAAAAAAAAAAAAAAAAAAAAAAAAAAAAAAAAAAAAAAAAA='}}
prove_67;34;79;Mul;2686;165193;165193.0;1025;0.08828270899903146;{'verificationValue': 165193.0, 'proof': {'imageId': [2948630792, 2482136711, 1512618692, 3197082418, 820963868, 463243005, 2815130045, 3835354657], 'receipt': 'AwAAAAAAAAAAAAAAxAciAPPsD8genbvcCN2DvDmorNgPyU2p6hAM/h+8IU0pSDuhAAAAAAAAAAAAAAAAAAAAAAAAAAAAAAAAAAAAAAAAAAAAAAAAAAAAAAAAAAAAAAAAAQAAAAAAAAAAAAAAAAAAAAAAAAAAAAAAAAAAAAAAAAAAAAAAAAAAAAEAAAAAnAEAAAAAAAAIAAAAMTY1MTkzLjCJAQAAeyJ3YXNfZmlyc3RfZXZlbnQiOmZhbHNlLCJpbWFnZV9pZCI6WzI5NDg2MzA3OTIsMjQ4MjEzNjcxMSwxNTEyNjE4NjkyLDMxOTcwODI0MTgsODIwOTYzODY4LDQ2MzI0MzAwNSwyODE1MTMwMDQ1LDM4MzUzNTQ2NTddLCJxZiI6eyJiIjpbMCw0LDAsMCwwLDAsMCwwLDAsMCwwLDAsMCwwLDAsMCwzMiwwLDEyOCw5MCwxNzMsODYsMTcxLDIxMywxMDYsMTgxLDkwLDE3Myw4NiwxNzEsMjEzLDEwNiwxODEsOTAsMTczLDg2LDE3MSwyMTMsMTA2LDE4MSw5MCwxNzMsODYsMTcxLDIxMywxMDYsMTgxLDkwLDE3Myw4NiwxNzEsMjEzLDEwNiwxODEsOTAsMTczLDg2LDE3MSwyMTMsMTA2LDE4MSw5MCwxNzMsODYsMTcxLDIxMywxMDYsMTgxLDkwLDE3Myw4NiwzLDBdLCJsIjo2MCwicSI6NiwiciI6N319AAAAAAAAAAAAAAAAAAAAnAEAAAAAAAAIAAAAMTY1MTkzLjCJAQAAeyJ3YXNfZmlyc3RfZXZlbnQiOmZhbHNlLCJpbWFnZV9pZCI6WzI5NDg2MzA3OTIsMjQ4MjEzNjcxMSwxNTEyNjE4NjkyLDMxOTcwODI0MTgsODIwOTYzODY4LDQ2MzI0MzAwNSwyODE1MTMwMDQ1LDM4MzUzNTQ2NTddLCJxZiI6eyJiIjpbMCw0LDAsMCwwLDAsMCwwLDAsMCwwLDAsMCwwLDAsMCwzMiwwLDEyOCw5MCwxNzMsODYsMTcxLDIxMywxMDYsMTgxLDkwLDE3Myw4NiwxNzEsMjEzLDEwNiwxODEsOTAsMTczLDg2LDE3MSwyMTMsMTA2LDE4MSw5MCwxNzMsODYsMTcxLDIxMywxMDYsMTgxLDkwLDE3Myw4NiwxNzEsMjEzLDEwNiwxODEsOTAsMTczLDg2LDE3MSwyMTMsMTA2LDE4MSw5MCwxNzMsODYsMTcxLDIxMywxMDYsMTgxLDkwLDE3Myw4NiwzLDBdLCJsIjo2MCwicSI6NiwiciI6N319AAAAAAAAAAAAAAAAAAAAAAAAAAAAAAAAAAAAAAAAAAAAAAA='}}
prove_68;71;32;Mul;2272;167465;167465.0;1025;0.07271995900009642;{'verificationValue': 167465.0, 'proof': {'imageId': [2948630792, 2482136711, 1512618692, 3197082418, 820963868, 463243005, 2815130045, 3835354657], 'receipt': 'AwAAAAAAAAAAAAAAxAciAPPsD8genbvcCN2DvDmorNgPyU2p6hAM/h+8IU0pSDuhAAAAAAAAAAAAAAAAAAAAAAAAAAAAAAAAAAAAAAAAAAAAAAAAAAAAAAAAAAAAAAAAAQAAAAAAAAAAAAAAAAAAAAAAAAAAAAAAAAAAAAAAAAAAAAAAAAAAAAEAAAAAnAEAAAAAAAAIAAAAMTY3NDY1LjCJAQAAeyJ3YXNfZmlyc3RfZXZlbnQiOmZhbHNlLCJpbWFnZV9pZCI6WzI5NDg2MzA3OTIsMjQ4MjEzNjcxMSwxNTEyNjE4NjkyLDMxOTcwODI0MTgsODIwOTYzODY4LDQ2MzI0MzAwNSwyODE1MTMwMDQ1LDM4MzUzNTQ2NTddLCJxZiI6eyJiIjpbMCw0LDAsMCwwLDAsMCwwLDAsMCwwLDAsMCwwLDAsMCwzMiwwLDEyOCw5MCwxNzMsODYsMTcxLDIxMywxMDYsMTgxLDkwLDE3Myw4NiwxNzEsMjEzLDEwNiwxODEsOTAsMTczLDg2LDE3MSwyMTMsMTA2LDE4MSw5MCwxNzMsODYsMTcxLDIxMywxMDYsMTgxLDkwLDE3Myw4NiwxNzEsMjEzLDEwNiwxODEsOTAsMTczLDg2LDE3MSwyMTMsMTA2LDE4MSw5MCwxNzMsODYsMTcxLDIxMywxMDYsMTgxLDkwLDE3Myw4NiwzLDBdLCJsIjo2MCwicSI6NiwiciI6N319AAAAAAAAAAAAAAAAAAAAnAEAAAAAAAAIAAAAMTY3NDY1LjCJAQAAeyJ3YXNfZmlyc3RfZXZlbnQiOmZhbHNlLCJpbWFnZV9pZCI6WzI5NDg2MzA3OTIsMjQ4MjEzNjcxMSwxNTEyNjE4NjkyLDMxOTcwODI0MTgsODIwOTYzODY4LDQ2MzI0MzAwNSwyODE1MTMwMDQ1LDM4MzUzNTQ2NTddLCJxZiI6eyJiIjpbMCw0LDAsMCwwLDAsMCwwLDAsMCwwLDAsMCwwLDAsMCwzMiwwLDEyOCw5MCwxNzMsODYsMTcxLDIxMywxMDYsMTgxLDkwLDE3Myw4NiwxNzEsMjEzLDEwNiwxODEsOTAsMTczLDg2LDE3MSwyMTMsMTA2LDE4MSw5MCwxNzMsODYsMTcxLDIxMywxMDYsMTgxLDkwLDE3Myw4NiwxNzEsMjEzLDEwNiwxODEsOTAsMTczLDg2LDE3MSwyMTMsMTA2LDE4MSw5MCwxNzMsODYsMTcxLDIxMywxMDYsMTgxLDkwLDE3Myw4NiwzLDBdLCJsIjo2MCwicSI6NiwiciI6N319AAAAAAAAAAAAAAAAAAAAAAAAAAAAAAAAAAAAAAAAAAAAAAA='}}
prove_69;94;15;Mul;1410;168875;168875.0;1025;0.07338370900106383;{'verificationValue': 168875.0, 'proof': {'imageId': [2948630792, 2482136711, 1512618692, 3197082418, 820963868, 463243005, 2815130045, 3835354657], 'receipt': 'AwAAAAAAAAAAAAAAxAciAPPsD8genbvcCN2DvDmorNgPyU2p6hAM/h+8IU0pSDuhAAAAAAAAAAAAAAAAAAAAAAAAAAAAAAAAAAAAAAAAAAAAAAAAAAAAAAAAAAAAAAAAAQAAAAAAAAAAAAAAAAAAAAAAAAAAAAAAAAAAAAAAAAAAAAAAAAAAAAEAAAAAnAEAAAAAAAAIAAAAMTY4ODc1LjCJAQAAeyJ3YXNfZmlyc3RfZXZlbnQiOmZhbHNlLCJpbWFnZV9pZCI6WzI5NDg2MzA3OTIsMjQ4MjEzNjcxMSwxNTEyNjE4NjkyLDMxOTcwODI0MTgsODIwOTYzODY4LDQ2MzI0MzAwNSwyODE1MTMwMDQ1LDM4MzUzNTQ2NTddLCJxZiI6eyJiIjpbMCw0LDAsMCwwLDAsMCwwLDAsMCwwLDAsMCwwLDAsMCwzMiwwLDEyOCw5MCwxNzMsODYsMTcxLDIxMywxMDYsMTgxLDkwLDE3Myw4NiwxNzEsMjEzLDEwNiwxODEsOTAsMTczLDg2LDE3MSwyMTMsMTA2LDE4MSw5MCwxNzMsODYsMTcxLDIxMywxMDYsMTgxLDkwLDE3Myw4NiwxNzEsMjEzLDEwNiwxODEsOTAsMTczLDg2LDE3MSwyMTMsMTA2LDE4MSw5MCwxNzMsODYsMTcxLDIxMywxMDYsMTgxLDkwLDE3Myw4NiwzLDBdLCJsIjo2MCwicSI6NiwiciI6N319AAAAAAAAAAAAAAAAAAAAnAEAAAAAAAAIAAAAMTY4ODc1LjCJAQAAeyJ3YXNfZmlyc3RfZXZlbnQiOmZhbHNlLCJpbWFnZV9pZCI6WzI5NDg2MzA3OTIsMjQ4MjEzNjcxMSwxNTEyNjE4NjkyLDMxOTcwODI0MTgsODIwOTYzODY4LDQ2MzI0MzAwNSwyODE1MTMwMDQ1LDM4MzUzNTQ2NTddLCJxZiI6eyJiIjpbMCw0LDAsMCwwLDAsMCwwLDAsMCwwLDAsMCwwLDAsMCwzMiwwLDEyOCw5MCwxNzMsODYsMTcxLDIxMywxMDYsMTgxLDkwLDE3Myw4NiwxNzEsMjEzLDEwNiwxODEsOTAsMTczLDg2LDE3MSwyMTMsMTA2LDE4MSw5MCwxNzMsODYsMTcxLDIxMywxMDYsMTgxLDkwLDE3Myw4NiwxNzEsMjEzLDEwNiwxODEsOTAsMTczLDg2LDE3MSwyMTMsMTA2LDE4MSw5MCwxNzMsODYsMTcxLDIxMywxMDYsMTgxLDkwLDE3Myw4NiwzLDBdLCJsIjo2MCwicSI6NiwiciI6N319AAAAAAAAAAAAAAAAAAAAAAAAAAAAAAAAAAAAAAAAAAAAAAA='}}
prove_70;21;59;Mul;1239;170114;170114.0;1025;0.07245900000089023;{'verificationValue': 170114.0, 'proof': {'imageId': [2948630792, 2482136711, 1512618692, 3197082418, 820963868, 463243005, 2815130045, 3835354657], 'receipt': 'AwAAAAAAAAAAAAAAxAciAPPsD8genbvcCN2DvDmorNgPyU2p6hAM/h+8IU0pSDuhAAAAAAAAAAAAAAAAAAAAAAAAAAAAAAAAAAAAAAAAAAAAAAAAAAAAAAAAAAAAAAAAAQAAAAAAAAAAAAAAAAAAAAAAAAAAAAAAAAAAAAAAAAAAAAAAAAAAAAEAAAAAnAEAAAAAAAAIAAAAMTcwMTE0LjCJAQAAeyJ3YXNfZmlyc3RfZXZlbnQiOmZhbHNlLCJpbWFnZV9pZCI6WzI5NDg2MzA3OTIsMjQ4MjEzNjcxMSwxNTEyNjE4NjkyLDMxOTcwODI0MTgsODIwOTYzODY4LDQ2MzI0MzAwNSwyODE1MTMwMDQ1LDM4MzUzNTQ2NTddLCJxZiI6eyJiIjpbMCw0LDAsMCwwLDAsMCwwLDAsMCwwLDAsMCwwLDAsMCwzMiwwLDEyOCw5MCwxNzMsODYsMTcxLDIxMywxMDYsMTgxLDkwLDE3Myw4NiwxNzEsMjEzLDEwNiwxODEsOTAsMTczLDg2LDE3MSwyMTMsMTA2LDE4MSw5MCwxNzMsODYsMTcxLDIxMywxMDYsMTgxLDkwLDE3Myw4NiwxNzEsMjEzLDEwNiwxODEsOTAsMTczLDg2LDE3MSwyMTMsMTA2LDE4MSw5MCwxNzMsODYsMTcxLDIxMywxMDYsMTgxLDkwLDE3Myw4NiwzLDBdLCJsIjo2MCwicSI6NiwiciI6N319AAAAAAAAAAAAAAAAAAAAnAEAAAAAAAAIAAAAMTcwMTE0LjCJAQAAeyJ3YXNfZmlyc3RfZXZlbnQiOmZhbHNlLCJpbWFnZV9pZCI6WzI5NDg2MzA3OTIsMjQ4MjEzNjcxMSwxNTEyNjE4NjkyLDMxOTcwODI0MTgsODIwOTYzODY4LDQ2MzI0MzAwNSwyODE1MTMwMDQ1LDM4MzUzNTQ2NTddLCJxZiI6eyJiIjpbMCw0LDAsMCwwLDAsMCwwLDAsMCwwLDAsMCwwLDAsMCwzMiwwLDEyOCw5MCwxNzMsODYsMTcxLDIxMywxMDYsMTgxLDkwLDE3Myw4NiwxNzEsMjEzLDEwNiwxODEsOTAsMTczLDg2LDE3MSwyMTMsMTA2LDE4MSw5MCwxNzMsODYsMTcxLDIxMywxMDYsMTgxLDkwLDE3Myw4NiwxNzEsMjEzLDEwNiwxODEsOTAsMTczLDg2LDE3MSwyMTMsMTA2LDE4MSw5MCwxNzMsODYsMTcxLDIxMywxMDYsMTgxLDkwLDE3Myw4NiwzLDBdLCJsIjo2MCwicSI6NiwiciI6N319AAAAAAAAAAAAAAAAAAAAAAAAAAAAAAAAAAAAAAAAAAAAAAA='}}
prove_71;99;52;Mul;5148;175262;175262.0;1025;0.07270783300009498;{'verificationValue': 175262.0, 'proof': {'imageId': [2948630792, 2482136711, 1512618692, 3197082418, 820963868, 463243005, 2815130045, 3835354657], 'receipt': 'AwAAAAAAAAAAAAAAxAciAPPsD8genbvcCN2DvDmorNgPyU2p6hAM/h+8IU0pSDuhAAAAAAAAAAAAAAAAAAAAAAAAAAAAAAAAAAAAAAAAAAAAAAAAAAAAAAAAAAAAAAAAAQAAAAAAAAAAAAAAAAAAAAAAAAAAAAAAAAAAAAAAAAAAAAAAAAAAAAEAAAAAnAEAAAAAAAAIAAAAMTc1MjYyLjCJAQAAeyJ3YXNfZmlyc3RfZXZlbnQiOmZhbHNlLCJpbWFnZV9pZCI6WzI5NDg2MzA3OTIsMjQ4MjEzNjcxMSwxNTEyNjE4NjkyLDMxOTcwODI0MTgsODIwOTYzODY4LDQ2MzI0MzAwNSwyODE1MTMwMDQ1LDM4MzUzNTQ2NTddLCJxZiI6eyJiIjpbMCw0LDAsMCwwLDAsMCwwLDAsMCwwLDAsMCwwLDAsMCwzMiwwLDEyOCw5MCwxNzMsODYsMTcxLDIxMywxMDYsMTgxLDkwLDE3Myw4NiwxNzEsMjEzLDEwNiwxODEsOTAsMTczLDg2LDE3MSwyMTMsMTA2LDE4MSw5MCwxNzMsODYsMTcxLDIxMywxMDYsMTgxLDkwLDE3Myw4NiwxNzEsMjEzLDEwNiwxODEsOTAsMTczLDg2LDE3MSwyMTMsMTA2LDE4MSw5MCwxNzMsODYsMTcxLDIxMywxMDYsMTgxLDkwLDE3Myw4NiwzLDBdLCJsIjo2MCwicSI6NiwiciI6N319AAAAAAAAAAAAAAAAAAAAnAEAAAAAAAAIAAAAMTc1MjYyLjCJAQAAeyJ3YXNfZmlyc3RfZXZlbnQiOmZhbHNlLCJpbWFnZV9pZCI6WzI5NDg2MzA3OTIsMjQ4MjEzNjcxMSwxNTEyNjE4NjkyLDMxOTcwODI0MTgsODIwOTYzODY4LDQ2MzI0MzAwNSwyODE1MTMwMDQ1LDM4MzUzNTQ2NTddLCJxZiI6eyJiIjpbMCw0LDAsMCwwLDAsMCwwLDAsMCwwLDAsMCwwLDAsMCwzMiwwLDEyOCw5MCwxNzMsODYsMTcxLDIxMywxMDYsMTgxLDkwLDE3Myw4NiwxNzEsMjEzLDEwNiwxODEsOTAsMTczLDg2LDE3MSwyMTMsMTA2LDE4MSw5MCwxNzMsODYsMTcxLDIxMywxMDYsMTgxLDkwLDE3Myw4NiwxNzEsMjEzLDEwNiwxODEsOTAsMTczLDg2LDE3MSwyMTMsMTA2LDE4MSw5MCwxNzMsODYsMTcxLDIxMywxMDYsMTgxLDkwLDE3Myw4NiwzLDBdLCJsIjo2MCwicSI6NiwiciI6N319AAAAAAAAAAAAAAAAAAAAAAAAAAAAAAAAAAAAAAAAAAAAAAA='}}
prove_72;73;74;Mul;5402;180664;180664.0;1025;0.07268583299992315;{'verificationValue': 180664.0, 'proof': {'imageId': [2948630792, 2482136711, 1512618692, 3197082418, 820963868, 463243005, 2815130045, 3835354657], 'receipt': 'AwAAAAAAAAAAAAAAxAciAPPsD8genbvcCN2DvDmorNgPyU2p6hAM/h+8IU0pSDuhAAAAAAAAAAAAAAAAAAAAAAAAAAAAAAAAAAAAAAAAAAAAAAAAAAAAAAAAAAAAAAAAAQAAAAAAAAAAAAAAAAAAAAAAAAAAAAAAAAAAAAAAAAAAAAAAAAAAAAEAAAAAnAEAAAAAAAAIAAAAMTgwNjY0LjCJAQAAeyJ3YXNfZmlyc3RfZXZlbnQiOmZhbHNlLCJpbWFnZV9pZCI6WzI5NDg2MzA3OTIsMjQ4MjEzNjcxMSwxNTEyNjE4NjkyLDMxOTcwODI0MTgsODIwOTYzODY4LDQ2MzI0MzAwNSwyODE1MTMwMDQ1LDM4MzUzNTQ2NTddLCJxZiI6eyJiIjpbMCw0LDAsMCwwLDAsMCwwLDAsMCwwLDAsMCwwLDAsMCwzMiwwLDEyOCw5MCwxNzMsODYsMTcxLDIxMywxMDYsMTgxLDkwLDE3Myw4NiwxNzEsMjEzLDEwNiwxODEsOTAsMTczLDg2LDE3MSwyMTMsMTA2LDE4MSw5MCwxNzMsODYsMTcxLDIxMywxMDYsMTgxLDkwLDE3Myw4NiwxNzEsMjEzLDEwNiwxODEsOTAsMTczLDg2LDE3MSwyMTMsMTA2LDE4MSw5MCwxNzMsODYsMTcxLDIxMywxMDYsMTgxLDkwLDE3Myw4NiwzLDBdLCJsIjo2MCwicSI6NiwiciI6N319AAAAAAAAAAAAAAAAAAAAnAEAAAAAAAAIAAAAMTgwNjY0LjCJAQAAeyJ3YXNfZmlyc3RfZXZlbnQiOmZhbHNlLCJpbWFnZV9pZCI6WzI5NDg2MzA3OTIsMjQ4MjEzNjcxMSwxNTEyNjE4NjkyLDMxOTcwODI0MTgsODIwOTYzODY4LDQ2MzI0MzAwNSwyODE1MTMwMDQ1LDM4MzUzNTQ2NTddLCJxZiI6eyJiIjpbMCw0LDAsMCwwLDAsMCwwLDAsMCwwLDAsMCwwLDAsMCwzMiwwLDEyOCw5MCwxNzMsODYsMTcxLDIxMywxMDYsMTgxLDkwLDE3Myw4NiwxNzEsMjEzLDEwNiwxODEsOTAsMTczLDg2LDE3MSwyMTMsMTA2LDE4MSw5MCwxNzMsODYsMTcxLDIxMywxMDYsMTgxLDkwLDE3Myw4NiwxNzEsMjEzLDEwNiwxODEsOTAsMTczLDg2LDE3MSwyMTMsMTA2LDE4MSw5MCwxNzMsODYsMTcxLDIxMywxMDYsMTgxLDkwLDE3Myw4NiwzLDBdLCJsIjo2MCwicSI6NiwiciI6N319AAAAAAAAAAAAAAAAAAAAAAAAAAAAAAAAAAAAAAAAAAAAAAA='}}
prove_73;48;3;Mul;144;180808;180808.0;1025;0.07306466699992598;{'verificationValue': 180808.0, 'proof': {'imageId': [2948630792, 2482136711, 1512618692, 3197082418, 820963868, 463243005, 2815130045, 3835354657], 'receipt': 'AwAAAAAAAAAAAAAAxAciAPPsD8genbvcCN2DvDmorNgPyU2p6hAM/h+8IU0pSDuhAAAAAAAAAAAAAAAAAAAAAAAAAAAAAAAAAAAAAAAAAAAAAAAAAAAAAAAAAAAAAAAAAQAAAAAAAAAAAAAAAAAAAAAAAAAAAAAAAAAAAAAAAAAAAAAAAAAAAAEAAAAAnAEAAAAAAAAIAAAAMTgwODA4LjCJAQAAeyJ3YXNfZmlyc3RfZXZlbnQiOmZhbHNlLCJpbWFnZV9pZCI6WzI5NDg2MzA3OTIsMjQ4MjEzNjcxMSwxNTEyNjE4NjkyLDMxOTcwODI0MTgsODIwOTYzODY4LDQ2MzI0MzAwNSwyODE1MTMwMDQ1LDM4MzUzNTQ2NTddLCJxZiI6eyJiIjpbMCw0LDAsMCwwLDAsMCwwLDAsMCwwLDAsMCwwLDAsMCwzMiwwLDEyOCw5MCwxNzMsODYsMTcxLDIxMywxMDYsMTgxLDkwLDE3Myw4NiwxNzEsMjEzLDEwNiwxODEsOTAsMTczLDg2LDE3MSwyMTMsMTA2LDE4MSw5MCwxNzMsODYsMTcxLDIxMywxMDYsMTgxLDkwLDE3Myw4NiwxNzEsMjEzLDEwNiwxODEsOTAsMTczLDg2LDE3MSwyMTMsMTA2LDE4MSw5MCwxNzMsODYsMTcxLDIxMywxMDYsMTgxLDkwLDE3Myw4NiwzLDBdLCJsIjo2MCwicSI6NiwiciI6N319AAAAAAAAAAAAAAAAAAAAnAEAAAAAAAAIAAAAMTgwODA4LjCJAQAAeyJ3YXNfZmlyc3RfZXZlbnQiOmZhbHNlLCJpbWFnZV9pZCI6WzI5NDg2MzA3OTIsMjQ4MjEzNjcxMSwxNTEyNjE4NjkyLDMxOTcwODI0MTgsODIwOTYzODY4LDQ2MzI0MzAwNSwyODE1MTMwMDQ1LDM4MzUzNTQ2NTddLCJxZiI6eyJiIjpbMCw0LDAsMCwwLDAsMCwwLDAsMCwwLDAsMCwwLDAsMCwzMiwwLDEyOCw5MCwxNzMsODYsMTcxLDIxMywxMDYsMTgxLDkwLDE3Myw4NiwxNzEsMjEzLDEwNiwxODEsOTAsMTczLDg2LDE3MSwyMTMsMTA2LDE4MSw5MCwxNzMsODYsMTcxLDIxMywxMDYsMTgxLDkwLDE3Myw4NiwxNzEsMjEzLDEwNiwxODEsOTAsMTczLDg2LDE3MSwyMTMsMTA2LDE4MSw5MCwxNzMsODYsMTcxLDIxMywxMDYsMTgxLDkwLDE3Myw4NiwzLDBdLCJsIjo2MCwicSI6NiwiciI6N319AAAAAAAAAAAAAAAAAAAAAAAAAAAAAAAAAAAAAAAAAAAAAAA='}}
prove_74;8;29;Mul;232;181040;181040.0;1025;0.07257104100062861;{'verificationValue': 181040.0, 'proof': {'imageId': [2948630792, 2482136711, 1512618692, 3197082418, 820963868, 463243005, 2815130045, 3835354657], 'receipt': 'AwAAAAAAAAAAAAAAxAciAPPsD8genbvcCN2DvDmorNgPyU2p6hAM/h+8IU0pSDuhAAAAAAAAAAAAAAAAAAAAAAAAAAAAAAAAAAAAAAAAAAAAAAAAAAAAAAAAAAAAAAAAAQAAAAAAAAAAAAAAAAAAAAAAAAAAAAAAAAAAAAAAAAAAAAAAAAAAAAEAAAAAnAEAAAAAAAAIAAAAMTgxMDQwLjCJAQAAeyJ3YXNfZmlyc3RfZXZlbnQiOmZhbHNlLCJpbWFnZV9pZCI6WzI5NDg2MzA3OTIsMjQ4MjEzNjcxMSwxNTEyNjE4NjkyLDMxOTcwODI0MTgsODIwOTYzODY4LDQ2MzI0MzAwNSwyODE1MTMwMDQ1LDM4MzUzNTQ2NTddLCJxZiI6eyJiIjpbMCw0LDAsMCwwLDAsMCwwLDAsMCwwLDAsMCwwLDAsMCwzMiwwLDEyOCw5MCwxNzMsODYsMTcxLDIxMywxMDYsMTgxLDkwLDE3Myw4NiwxNzEsMjEzLDEwNiwxODEsOTAsMTczLDg2LDE3MSwyMTMsMTA2LDE4MSw5MCwxNzMsODYsMTcxLDIxMywxMDYsMTgxLDkwLDE3Myw4NiwxNzEsMjEzLDEwNiwxODEsOTAsMTczLDg2LDE3MSwyMTMsMTA2LDE4MSw5MCwxNzMsODYsMTcxLDIxMywxMDYsMTgxLDkwLDE3Myw4NiwzLDBdLCJsIjo2MCwicSI6NiwiciI6N319AAAAAAAAAAAAAAAAAAAAnAEAAAAAAAAIAAAAMTgxMDQwLjCJAQAAeyJ3YXNfZmlyc3RfZXZlbnQiOmZhbHNlLCJpbWFnZV9pZCI6WzI5NDg2MzA3OTIsMjQ4MjEzNjcxMSwxNTEyNjE4NjkyLDMxOTcwODI0MTgsODIwOTYzODY4LDQ2MzI0MzAwNSwyODE1MTMwMDQ1LDM4MzUzNTQ2NTddLCJxZiI6eyJiIjpbMCw0LDAsMCwwLDAsMCwwLDAsMCwwLDAsMCwwLDAsMCwzMiwwLDEyOCw5MCwxNzMsODYsMTcxLDIxMywxMDYsMTgxLDkwLDE3Myw4NiwxNzEsMjEzLDEwNiwxODEsOTAsMTczLDg2LDE3MSwyMTMsMTA2LDE4MSw5MCwxNzMsODYsMTcxLDIxMywxMDYsMTgxLDkwLDE3Myw4NiwxNzEsMjEzLDEwNiwxODEsOTAsMTczLDg2LDE3MSwyMTMsMTA2LDE4MSw5MCwxNzMsODYsMTcxLDIxMywxMDYsMTgxLDkwLDE3Myw4NiwzLDBdLCJsIjo2MCwicSI6NiwiciI6N319AAAAAAAAAAAAAAAAAAAAAAAAAAAAAAAAAAAAAAAAAAAAAAA='}}
prove_75;15;77;Mul;1155;182195;182195.0;1025;0.07325645799937774;{'verificationValue': 182195.0, 'proof': {'imageId': [2948630792, 2482136711, 1512618692, 3197082418, 820963868, 463243005, 2815130045, 3835354657], 'receipt': 'AwAAAAAAAAAAAAAAxAciAPPsD8genbvcCN2DvDmorNgPyU2p6hAM/h+8IU0pSDuhAAAAAAAAAAAAAAAAAAAAAAAAAAAAAAAAAAAAAAAAAAAAAAAAAAAAAAAAAAAAAAAAAQAAAAAAAAAAAAAAAAAAAAAAAAAAAAAAAAAAAAAAAAAAAAAAAAAAAAEAAAAAnAEAAAAAAAAIAAAAMTgyMTk1LjCJAQAAeyJ3YXNfZmlyc3RfZXZlbnQiOmZhbHNlLCJpbWFnZV9pZCI6WzI5NDg2MzA3OTIsMjQ4MjEzNjcxMSwxNTEyNjE4NjkyLDMxOTcwODI0MTgsODIwOTYzODY4LDQ2MzI0MzAwNSwyODE1MTMwMDQ1LDM4MzUzNTQ2NTddLCJxZiI6eyJiIjpbMCw0LDAsMCwwLDAsMCwwLDAsMCwwLDAsMCwwLDAsMCwzMiwwLDEyOCw5MCwxNzMsODYsMTcxLDIxMywxMDYsMTgxLDkwLDE3Myw4NiwxNzEsMjEzLDEwNiwxODEsOTAsMTczLDg2LDE3MSwyMTMsMTA2LDE4MSw5MCwxNzMsODYsMTcxLDIxMywxMDYsMTgxLDkwLDE3Myw4NiwxNzEsMjEzLDEwNiwxODEsOTAsMTczLDg2LDE3MSwyMTMsMTA2LDE4MSw5MCwxNzMsODYsMTcxLDIxMywxMDYsMTgxLDkwLDE3Myw4NiwzLDBdLCJsIjo2MCwicSI6NiwiciI6N319AAAAAAAAAAAAAAAAAAAAnAEAAAAAAAAIAAAAMTgyMTk1LjCJAQAAeyJ3YXNfZmlyc3RfZXZlbnQiOmZhbHNlLCJpbWFnZV9pZCI6WzI5NDg2MzA3OTIsMjQ4MjEzNjcxMSwxNTEyNjE4NjkyLDMxOTcwODI0MTgsODIwOTYzODY4LDQ2MzI0MzAwNSwyODE1MTMwMDQ1LDM4MzUzNTQ2NTddLCJxZiI6eyJiIjpbMCw0LDAsMCwwLDAsMCwwLDAsMCwwLDAsMCwwLDAsMCwzMiwwLDEyOCw5MCwxNzMsODYsMTcxLDIxMywxMDYsMTgxLDkwLDE3Myw4NiwxNzEsMjEzLDEwNiwxODEsOTAsMTczLDg2LDE3MSwyMTMsMTA2LDE4MSw5MCwxNzMsODYsMTcxLDIxMywxMDYsMTgxLDkwLDE3Myw4NiwxNzEsMjEzLDEwNiwxODEsOTAsMTczLDg2LDE3MSwyMTMsMTA2LDE4MSw5MCwxNzMsODYsMTcxLDIxMywxMDYsMTgxLDkwLDE3Myw4NiwzLDBdLCJsIjo2MCwicSI6NiwiciI6N319AAAAAAAAAAAAAAAAAAAAAAAAAAAAAAAAAAAAAAAAAAAAAAA='}}
prove_76;62;68;Mul;4216;186411;186411.0;1025;0.07319195899981423;{'verificationValue': 186411.0, 'proof': {'imageId': [2948630792, 2482136711, 1512618692, 3197082418, 820963868, 463243005, 2815130045, 3835354657], 'receipt': 'AwAAAAAAAAAAAAAAxAciAPPsD8genbvcCN2DvDmorNgPyU2p6hAM/h+8IU0pSDuhAAAAAAAAAAAAAAAAAAAAAAAAAAAAAAAAAAAAAAAAAAAAAAAAAAAAAAAAAAAAAAAAAQAAAAAAAAAAAAAAAAAAAAAAAAAAAAAAAAAAAAAAAAAAAAAAAAAAAAEAAAAAnAEAAAAAAAAIAAAAMTg2NDExLjCJAQAAeyJ3YXNfZmlyc3RfZXZlbnQiOmZhbHNlLCJpbWFnZV9pZCI6WzI5NDg2MzA3OTIsMjQ4MjEzNjcxMSwxNTEyNjE4NjkyLDMxOTcwODI0MTgsODIwOTYzODY4LDQ2MzI0MzAwNSwyODE1MTMwMDQ1LDM4MzUzNTQ2NTddLCJxZiI6eyJiIjpbMCw0LDAsMCwwLDAsMCwwLDAsMCwwLDAsMCwwLDAsMCwzMiwwLDEyOCw5MCwxNzMsODYsMTcxLDIxMywxMDYsMTgxLDkwLDE3Myw4NiwxNzEsMjEzLDEwNiwxODEsOTAsMTczLDg2LDE3MSwyMTMsMTA2LDE4MSw5MCwxNzMsODYsMTcxLDIxMywxMDYsMTgxLDkwLDE3Myw4NiwxNzEsMjEzLDEwNiwxODEsOTAsMTczLDg2LDE3MSwyMTMsMTA2LDE4MSw5MCwxNzMsODYsMTcxLDIxMywxMDYsMTgxLDkwLDE3Myw4NiwzLDBdLCJsIjo2MCwicSI6NiwiciI6N319AAAAAAAAAAAAAAAAAAAAnAEAAAAAAAAIAAAAMTg2NDExLjCJAQAAeyJ3YXNfZmlyc3RfZXZlbnQiOmZhbHNlLCJpbWFnZV9pZCI6WzI5NDg2MzA3OTIsMjQ4MjEzNjcxMSwxNTEyNjE4NjkyLDMxOTcwODI0MTgsODIwOTYzODY4LDQ2MzI0MzAwNSwyODE1MTMwMDQ1LDM4MzUzNTQ2NTddLCJxZiI6eyJiIjpbMCw0LDAsMCwwLDAsMCwwLDAsMCwwLDAsMCwwLDAsMCwzMiwwLDEyOCw5MCwxNzMsODYsMTcxLDIxMywxMDYsMTgxLDkwLDE3Myw4NiwxNzEsMjEzLDEwNiwxODEsOTAsMTczLDg2LDE3MSwyMTMsMTA2LDE4MSw5MCwxNzMsODYsMTcxLDIxMywxMDYsMTgxLDkwLDE3Myw4NiwxNzEsMjEzLDEwNiwxODEsOTAsMTczLDg2LDE3MSwyMTMsMTA2LDE4MSw5MCwxNzMsODYsMTcxLDIxMywxMDYsMTgxLDkwLDE3Myw4NiwzLDBdLCJsIjo2MCwicSI6NiwiciI6N319AAAAAAAAAAAAAAAAAAAAAAAAAAAAAAAAAAAAAAAAAAAAAAA='}}
prove_77;50;68;Mul;3400;189811;189811.0;1025;0.07336174999909417;{'verificationValue': 189811.0, 'proof': {'imageId': [2948630792, 2482136711, 1512618692, 3197082418, 820963868, 463243005, 2815130045, 3835354657], 'receipt': 'AwAAAAAAAAAAAAAAxAciAPPsD8genbvcCN2DvDmorNgPyU2p6hAM/h+8IU0pSDuhAAAAAAAAAAAAAAAAAAAAAAAAAAAAAAAAAAAAAAAAAAAAAAAAAAAAAAAAAAAAAAAAAQAAAAAAAAAAAAAAAAAAAAAAAAAAAAAAAAAAAAAAAAAAAAAAAAAAAAEAAAAAnAEAAAAAAAAIAAAAMTg5ODExLjCJAQAAeyJ3YXNfZmlyc3RfZXZlbnQiOmZhbHNlLCJpbWFnZV9pZCI6WzI5NDg2MzA3OTIsMjQ4MjEzNjcxMSwxNTEyNjE4NjkyLDMxOTcwODI0MTgsODIwOTYzODY4LDQ2MzI0MzAwNSwyODE1MTMwMDQ1LDM4MzUzNTQ2NTddLCJxZiI6eyJiIjpbMCw0LDAsMCwwLDAsMCwwLDAsMCwwLDAsMCwwLDAsMCwzMiwwLDEyOCw5MCwxNzMsODYsMTcxLDIxMywxMDYsMTgxLDkwLDE3Myw4NiwxNzEsMjEzLDEwNiwxODEsOTAsMTczLDg2LDE3MSwyMTMsMTA2LDE4MSw5MCwxNzMsODYsMTcxLDIxMywxMDYsMTgxLDkwLDE3Myw4NiwxNzEsMjEzLDEwNiwxODEsOTAsMTczLDg2LDE3MSwyMTMsMTA2LDE4MSw5MCwxNzMsODYsMTcxLDIxMywxMDYsMTgxLDkwLDE3Myw4NiwzLDBdLCJsIjo2MCwicSI6NiwiciI6N319AAAAAAAAAAAAAAAAAAAAnAEAAAAAAAAIAAAAMTg5ODExLjCJAQAAeyJ3YXNfZmlyc3RfZXZlbnQiOmZhbHNlLCJpbWFnZV9pZCI6WzI5NDg2MzA3OTIsMjQ4MjEzNjcxMSwxNTEyNjE4NjkyLDMxOTcwODI0MTgsODIwOTYzODY4LDQ2MzI0MzAwNSwyODE1MTMwMDQ1LDM4MzUzNTQ2NTddLCJxZiI6eyJiIjpbMCw0LDAsMCwwLDAsMCwwLDAsMCwwLDAsMCwwLDAsMCwzMiwwLDEyOCw5MCwxNzMsODYsMTcxLDIxMywxMDYsMTgxLDkwLDE3Myw4NiwxNzEsMjEzLDEwNiwxODEsOTAsMTczLDg2LDE3MSwyMTMsMTA2LDE4MSw5MCwxNzMsODYsMTcxLDIxMywxMDYsMTgxLDkwLDE3Myw4NiwxNzEsMjEzLDEwNiwxODEsOTAsMTczLDg2LDE3MSwyMTMsMTA2LDE4MSw5MCwxNzMsODYsMTcxLDIxMywxMDYsMTgxLDkwLDE3Myw4NiwzLDBdLCJsIjo2MCwicSI6NiwiciI6N319AAAAAAAAAAAAAAAAAAAAAAAAAAAAAAAAAAAAAAAAAAAAAAA='}}
prove_78;65;77;Mul;5005;194816;194816.0;1025;0.07418604099984805;{'verificationValue': 194816.0, 'proof': {'imageId': [2948630792, 2482136711, 1512618692, 3197082418, 820963868, 463243005, 2815130045, 3835354657], 'receipt': 'AwAAAAAAAAAAAAAAxAciAPPsD8genbvcCN2DvDmorNgPyU2p6hAM/h+8IU0pSDuhAAAAAAAAAAAAAAAAAAAAAAAAAAAAAAAAAAAAAAAAAAAAAAAAAAAAAAAAAAAAAAAAAQAAAAAAAAAAAAAAAAAAAAAAAAAAAAAAAAAAAAAAAAAAAAAAAAAAAAEAAAAAnAEAAAAAAAAIAAAAMTk0ODE2LjCJAQAAeyJ3YXNfZmlyc3RfZXZlbnQiOmZhbHNlLCJpbWFnZV9pZCI6WzI5NDg2MzA3OTIsMjQ4MjEzNjcxMSwxNTEyNjE4NjkyLDMxOTcwODI0MTgsODIwOTYzODY4LDQ2MzI0MzAwNSwyODE1MTMwMDQ1LDM4MzUzNTQ2NTddLCJxZiI6eyJiIjpbMCw0LDAsMCwwLDAsMCwwLDAsMCwwLDAsMCwwLDAsMCwzMiwwLDEyOCw5MCwxNzMsODYsMTcxLDIxMywxMDYsMTgxLDkwLDE3Myw4NiwxNzEsMjEzLDEwNiwxODEsOTAsMTczLDg2LDE3MSwyMTMsMTA2LDE4MSw5MCwxNzMsODYsMTcxLDIxMywxMDYsMTgxLDkwLDE3Myw4NiwxNzEsMjEzLDEwNiwxODEsOTAsMTczLDg2LDE3MSwyMTMsMTA2LDE4MSw5MCwxNzMsODYsMTcxLDIxMywxMDYsMTgxLDkwLDE3Myw4NiwzLDBdLCJsIjo2MCwicSI6NiwiciI6N319AAAAAAAAAAAAAAAAAAAAnAEAAAAAAAAIAAAAMTk0ODE2LjCJAQAAeyJ3YXNfZmlyc3RfZXZlbnQiOmZhbHNlLCJpbWFnZV9pZCI6WzI5NDg2MzA3OTIsMjQ4MjEzNjcxMSwxNTEyNjE4NjkyLDMxOTcwODI0MTgsODIwOTYzODY4LDQ2MzI0MzAwNSwyODE1MTMwMDQ1LDM4MzUzNTQ2NTddLCJxZiI6eyJiIjpbMCw0LDAsMCwwLDAsMCwwLDAsMCwwLDAsMCwwLDAsMCwzMiwwLDEyOCw5MCwxNzMsODYsMTcxLDIxMywxMDYsMTgxLDkwLDE3Myw4NiwxNzEsMjEzLDEwNiwxODEsOTAsMTczLDg2LDE3MSwyMTMsMTA2LDE4MSw5MCwxNzMsODYsMTcxLDIxMywxMDYsMTgxLDkwLDE3Myw4NiwxNzEsMjEzLDEwNiwxODEsOTAsMTczLDg2LDE3MSwyMTMsMTA2LDE4MSw5MCwxNzMsODYsMTcxLDIxMywxMDYsMTgxLDkwLDE3Myw4NiwzLDBdLCJsIjo2MCwicSI6NiwiciI6N319AAAAAAAAAAAAAAAAAAAAAAAAAAAAAAAAAAAAAAAAAAAAAAA='}}
prove_79;14;35;Mul;490;195306;195306.0;1025;0.07307924999986426;{'verificationValue': 195306.0, 'proof': {'imageId': [2948630792, 2482136711, 1512618692, 3197082418, 820963868, 463243005, 2815130045, 3835354657], 'receipt': 'AwAAAAAAAAAAAAAAxAciAPPsD8genbvcCN2DvDmorNgPyU2p6hAM/h+8IU0pSDuhAAAAAAAAAAAAAAAAAAAAAAAAAAAAAAAAAAAAAAAAAAAAAAAAAAAAAAAAAAAAAAAAAQAAAAAAAAAAAAAAAAAAAAAAAAAAAAAAAAAAAAAAAAAAAAAAAAAAAAEAAAAAnAEAAAAAAAAIAAAAMTk1MzA2LjCJAQAAeyJ3YXNfZmlyc3RfZXZlbnQiOmZhbHNlLCJpbWFnZV9pZCI6WzI5NDg2MzA3OTIsMjQ4MjEzNjcxMSwxNTEyNjE4NjkyLDMxOTcwODI0MTgsODIwOTYzODY4LDQ2MzI0MzAwNSwyODE1MTMwMDQ1LDM4MzUzNTQ2NTddLCJxZiI6eyJiIjpbMCw0LDAsMCwwLDAsMCwwLDAsMCwwLDAsMCwwLDAsMCwzMiwwLDEyOCw5MCwxNzMsODYsMTcxLDIxMywxMDYsMTgxLDkwLDE3Myw4NiwxNzEsMjEzLDEwNiwxODEsOTAsMTczLDg2LDE3MSwyMTMsMTA2LDE4MSw5MCwxNzMsODYsMTcxLDIxMywxMDYsMTgxLDkwLDE3Myw4NiwxNzEsMjEzLDEwNiwxODEsOTAsMTczLDg2LDE3MSwyMTMsMTA2LDE4MSw5MCwxNzMsODYsMTcxLDIxMywxMDYsMTgxLDkwLDE3Myw4NiwzLDBdLCJsIjo2MCwicSI6NiwiciI6N319AAAAAAAAAAAAAAAAAAAAnAEAAAAAAAAIAAAAMTk1MzA2LjCJAQAAeyJ3YXNfZmlyc3RfZXZlbnQiOmZhbHNlLCJpbWFnZV9pZCI6WzI5NDg2MzA3OTIsMjQ4MjEzNjcxMSwxNTEyNjE4NjkyLDMxOTcwODI0MTgsODIwOTYzODY4LDQ2MzI0MzAwNSwyODE1MTMwMDQ1LDM4MzUzNTQ2NTddLCJxZiI6eyJiIjpbMCw0LDAsMCwwLDAsMCwwLDAsMCwwLDAsMCwwLDAsMCwzMiwwLDEyOCw5MCwxNzMsODYsMTcxLDIxMywxMDYsMTgxLDkwLDE3Myw4NiwxNzEsMjEzLDEwNiwxODEsOTAsMTczLDg2LDE3MSwyMTMsMTA2LDE4MSw5MCwxNzMsODYsMTcxLDIxMywxMDYsMTgxLDkwLDE3Myw4NiwxNzEsMjEzLDEwNiwxODEsOTAsMTczLDg2LDE3MSwyMTMsMTA2LDE4MSw5MCwxNzMsODYsMTcxLDIxMywxMDYsMTgxLDkwLDE3Myw4NiwzLDBdLCJsIjo2MCwicSI6NiwiciI6N319AAAAAAAAAAAAAAAAAAAAAAAAAAAAAAAAAAAAAAAAAAAAAAA='}}
prove_80;42;89;Mul;3738;199044;199044.0;1025;0.07367254200107709;{'verificationValue': 199044.0, 'proof': {'imageId': [2948630792, 2482136711, 1512618692, 3197082418, 820963868, 463243005, 2815130045, 3835354657], 'receipt': 'AwAAAAAAAAAAAAAAxAciAPPsD8genbvcCN2DvDmorNgPyU2p6hAM/h+8IU0pSDuhAAAAAAAAAAAAAAAAAAAAAAAAAAAAAAAAAAAAAAAAAAAAAAAAAAAAAAAAAAAAAAAAAQAAAAAAAAAAAAAAAAAAAAAAAAAAAAAAAAAAAAAAAAAAAAAAAAAAAAEAAAAAnAEAAAAAAAAIAAAAMTk5MDQ0LjCJAQAAeyJ3YXNfZmlyc3RfZXZlbnQiOmZhbHNlLCJpbWFnZV9pZCI6WzI5NDg2MzA3OTIsMjQ4MjEzNjcxMSwxNTEyNjE4NjkyLDMxOTcwODI0MTgsODIwOTYzODY4LDQ2MzI0MzAwNSwyODE1MTMwMDQ1LDM4MzUzNTQ2NTddLCJxZiI6eyJiIjpbMCw0LDAsMCwwLDAsMCwwLDAsMCwwLDAsMCwwLDAsMCwzMiwwLDEyOCw5MCwxNzMsODYsMTcxLDIxMywxMDYsMTgxLDkwLDE3Myw4NiwxNzEsMjEzLDEwNiwxODEsOTAsMTczLDg2LDE3MSwyMTMsMTA2LDE4MSw5MCwxNzMsODYsMTcxLDIxMywxMDYsMTgxLDkwLDE3Myw4NiwxNzEsMjEzLDEwNiwxODEsOTAsMTczLDg2LDE3MSwyMTMsMTA2LDE4MSw5MCwxNzMsODYsMTcxLDIxMywxMDYsMTgxLDkwLDE3Myw4NiwzLDBdLCJsIjo2MCwicSI6NiwiciI6N319AAAAAAAAAAAAAAAAAAAAnAEAAAAAAAAIAAAAMTk5MDQ0LjCJAQAAeyJ3YXNfZmlyc3RfZXZlbnQiOmZhbHNlLCJpbWFnZV9pZCI6WzI5NDg2MzA3OTIsMjQ4MjEzNjcxMSwxNTEyNjE4NjkyLDMxOTcwODI0MTgsODIwOTYzODY4LDQ2MzI0MzAwNSwyODE1MTMwMDQ1LDM4MzUzNTQ2NTddLCJxZiI6eyJiIjpbMCw0LDAsMCwwLDAsMCwwLDAsMCwwLDAsMCwwLDAsMCwzMiwwLDEyOCw5MCwxNzMsODYsMTcxLDIxMywxMDYsMTgxLDkwLDE3Myw4NiwxNzEsMjEzLDEwNiwxODEsOTAsMTczLDg2LDE3MSwyMTMsMTA2LDE4MSw5MCwxNzMsODYsMTcxLDIxMywxMDYsMTgxLDkwLDE3Myw4NiwxNzEsMjEzLDEwNiwxODEsOTAsMTczLDg2LDE3MSwyMTMsMTA2LDE4MSw5MCwxNzMsODYsMTcxLDIxMywxMDYsMTgxLDkwLDE3Myw4NiwzLDBdLCJsIjo2MCwicSI6NiwiciI6N319AAAAAAAAAAAAAAAAAAAAAAAAAAAAAAAAAAAAAAAAAAAAAAA='}}
prove_81;65;25;Mul;1625;200669;200669.0;1025;0.07320904199877987;{'verificationValue': 200669.0, 'proof': {'imageId': [2948630792, 2482136711, 1512618692, 3197082418, 820963868, 463243005, 2815130045, 3835354657], 'receipt': 'AwAAAAAAAAAAAAAAxAciAPPsD8genbvcCN2DvDmorNgPyU2p6hAM/h+8IU0pSDuhAAAAAAAAAAAAAAAAAAAAAAAAAAAAAAAAAAAAAAAAAAAAAAAAAAAAAAAAAAAAAAAAAQAAAAAAAAAAAAAAAAAAAAAAAAAAAAAAAAAAAAAAAAAAAAAAAAAAAAEAAAAAnAEAAAAAAAAIAAAAMjAwNjY5LjCJAQAAeyJ3YXNfZmlyc3RfZXZlbnQiOmZhbHNlLCJpbWFnZV9pZCI6WzI5NDg2MzA3OTIsMjQ4MjEzNjcxMSwxNTEyNjE4NjkyLDMxOTcwODI0MTgsODIwOTYzODY4LDQ2MzI0MzAwNSwyODE1MTMwMDQ1LDM4MzUzNTQ2NTddLCJxZiI6eyJiIjpbMCw0LDAsMCwwLDAsMCwwLDAsMCwwLDAsMCwwLDAsMCwzMiwwLDEyOCw5MCwxNzMsODYsMTcxLDIxMywxMDYsMTgxLDkwLDE3Myw4NiwxNzEsMjEzLDEwNiwxODEsOTAsMTczLDg2LDE3MSwyMTMsMTA2LDE4MSw5MCwxNzMsODYsMTcxLDIxMywxMDYsMTgxLDkwLDE3Myw4NiwxNzEsMjEzLDEwNiwxODEsOTAsMTczLDg2LDE3MSwyMTMsMTA2LDE4MSw5MCwxNzMsODYsMTcxLDIxMywxMDYsMTgxLDkwLDE3Myw4NiwzLDBdLCJsIjo2MCwicSI6NiwiciI6N319AAAAAAAAAAAAAAAAAAAAnAEAAAAAAAAIAAAAMjAwNjY5LjCJAQAAeyJ3YXNfZmlyc3RfZXZlbnQiOmZhbHNlLCJpbWFnZV9pZCI6WzI5NDg2MzA3OTIsMjQ4MjEzNjcxMSwxNTEyNjE4NjkyLDMxOTcwODI0MTgsODIwOTYzODY4LDQ2MzI0MzAwNSwyODE1MTMwMDQ1LDM4MzUzNTQ2NTddLCJxZiI6eyJiIjpbMCw0LDAsMCwwLDAsMCwwLDAsMCwwLDAsMCwwLDAsMCwzMiwwLDEyOCw5MCwxNzMsODYsMTcxLDIxMywxMDYsMTgxLDkwLDE3Myw4NiwxNzEsMjEzLDEwNiwxODEsOTAsMTczLDg2LDE3MSwyMTMsMTA2LDE4MSw5MCwxNzMsODYsMTcxLDIxMywxMDYsMTgxLDkwLDE3Myw4NiwxNzEsMjEzLDEwNiwxODEsOTAsMTczLDg2LDE3MSwyMTMsMTA2LDE4MSw5MCwxNzMsODYsMTcxLDIxMywxMDYsMTgxLDkwLDE3Myw4NiwzLDBdLCJsIjo2MCwicSI6NiwiciI6N319AAAAAAAAAAAAAAAAAAAAAAAAAAAAAAAAAAAAAAAAAAAAAAA='}}
prove_82;73;55;Mul;4015;204684;204684.0;1025;0.07359879199975694;{'verificationValue': 204684.0, 'proof': {'imageId': [2948630792, 2482136711, 1512618692, 3197082418, 820963868, 463243005, 2815130045, 3835354657], 'receipt': 'AwAAAAAAAAAAAAAAxAciAPPsD8genbvcCN2DvDmorNgPyU2p6hAM/h+8IU0pSDuhAAAAAAAAAAAAAAAAAAAAAAAAAAAAAAAAAAAAAAAAAAAAAAAAAAAAAAAAAAAAAAAAAQAAAAAAAAAAAAAAAAAAAAAAAAAAAAAAAAAAAAAAAAAAAAAAAAAAAAEAAAAAnAEAAAAAAAAIAAAAMjA0Njg0LjCJAQAAeyJ3YXNfZmlyc3RfZXZlbnQiOmZhbHNlLCJpbWFnZV9pZCI6WzI5NDg2MzA3OTIsMjQ4MjEzNjcxMSwxNTEyNjE4NjkyLDMxOTcwODI0MTgsODIwOTYzODY4LDQ2MzI0MzAwNSwyODE1MTMwMDQ1LDM4MzUzNTQ2NTddLCJxZiI6eyJiIjpbMCw0LDAsMCwwLDAsMCwwLDAsMCwwLDAsMCwwLDAsMCwzMiwwLDEyOCw5MCwxNzMsODYsMTcxLDIxMywxMDYsMTgxLDkwLDE3Myw4NiwxNzEsMjEzLDEwNiwxODEsOTAsMTczLDg2LDE3MSwyMTMsMTA2LDE4MSw5MCwxNzMsODYsMTcxLDIxMywxMDYsMTgxLDkwLDE3Myw4NiwxNzEsMjEzLDEwNiwxODEsOTAsMTczLDg2LDE3MSwyMTMsMTA2LDE4MSw5MCwxNzMsODYsMTcxLDIxMywxMDYsMTgxLDkwLDE3Myw4NiwzLDBdLCJsIjo2MCwicSI6NiwiciI6N319AAAAAAAAAAAAAAAAAAAAnAEAAAAAAAAIAAAAMjA0Njg0LjCJAQAAeyJ3YXNfZmlyc3RfZXZlbnQiOmZhbHNlLCJpbWFnZV9pZCI6WzI5NDg2MzA3OTIsMjQ4MjEzNjcxMSwxNTEyNjE4NjkyLDMxOTcwODI0MTgsODIwOTYzODY4LDQ2MzI0MzAwNSwyODE1MTMwMDQ1LDM4MzUzNTQ2NTddLCJxZiI6eyJiIjpbMCw0LDAsMCwwLDAsMCwwLDAsMCwwLDAsMCwwLDAsMCwzMiwwLDEyOCw5MCwxNzMsODYsMTcxLDIxMywxMDYsMTgxLDkwLDE3Myw4NiwxNzEsMjEzLDEwNiwxODEsOTAsMTczLDg2LDE3MSwyMTMsMTA2LDE4MSw5MCwxNzMsODYsMTcxLDIxMywxMDYsMTgxLDkwLDE3Myw4NiwxNzEsMjEzLDEwNiwxODEsOTAsMTczLDg2LDE3MSwyMTMsMTA2LDE4MSw5MCwxNzMsODYsMTcxLDIxMywxMDYsMTgxLDkwLDE3Myw4NiwzLDBdLCJsIjo2MCwicSI6NiwiciI6N319AAAAAAAAAAAAAAAAAAAAAAAAAAAAAAAAAAAAAAAAAAAAAAA='}}
prove_83;21;5;Mul;105;204789;204789.0;1025;0.07418941600008111;{'verificationValue': 204789.0, 'proof': {'imageId': [2948630792, 2482136711, 1512618692, 3197082418, 820963868, 463243005, 2815130045, 3835354657], 'receipt': 'AwAAAAAAAAAAAAAAxAciAPPsD8genbvcCN2DvDmorNgPyU2p6hAM/h+8IU0pSDuhAAAAAAAAAAAAAAAAAAAAAAAAAAAAAAAAAAAAAAAAAAAAAAAAAAAAAAAAAAAAAAAAAQAAAAAAAAAAAAAAAAAAAAAAAAAAAAAAAAAAAAAAAAAAAAAAAAAAAAEAAAAAnAEAAAAAAAAIAAAAMjA0Nzg5LjCJAQAAeyJ3YXNfZmlyc3RfZXZlbnQiOmZhbHNlLCJpbWFnZV9pZCI6WzI5NDg2MzA3OTIsMjQ4MjEzNjcxMSwxNTEyNjE4NjkyLDMxOTcwODI0MTgsODIwOTYzODY4LDQ2MzI0MzAwNSwyODE1MTMwMDQ1LDM4MzUzNTQ2NTddLCJxZiI6eyJiIjpbMCw0LDAsMCwwLDAsMCwwLDAsMCwwLDAsMCwwLDAsMCwzMiwwLDEyOCw5MCwxNzMsODYsMTcxLDIxMywxMDYsMTgxLDkwLDE3Myw4NiwxNzEsMjEzLDEwNiwxODEsOTAsMTczLDg2LDE3MSwyMTMsMTA2LDE4MSw5MCwxNzMsODYsMTcxLDIxMywxMDYsMTgxLDkwLDE3Myw4NiwxNzEsMjEzLDEwNiwxODEsOTAsMTczLDg2LDE3MSwyMTMsMTA2LDE4MSw5MCwxNzMsODYsMTcxLDIxMywxMDYsMTgxLDkwLDE3Myw4NiwzLDBdLCJsIjo2MCwicSI6NiwiciI6N319AAAAAAAAAAAAAAAAAAAAnAEAAAAAAAAIAAAAMjA0Nzg5LjCJAQAAeyJ3YXNfZmlyc3RfZXZlbnQiOmZhbHNlLCJpbWFnZV9pZCI6WzI5NDg2MzA3OTIsMjQ4MjEzNjcxMSwxNTEyNjE4NjkyLDMxOTcwODI0MTgsODIwOTYzODY4LDQ2MzI0MzAwNSwyODE1MTMwMDQ1LDM4MzUzNTQ2NTddLCJxZiI6eyJiIjpbMCw0LDAsMCwwLDAsMCwwLDAsMCwwLDAsMCwwLDAsMCwzMiwwLDEyOCw5MCwxNzMsODYsMTcxLDIxMywxMDYsMTgxLDkwLDE3Myw4NiwxNzEsMjEzLDEwNiwxODEsOTAsMTczLDg2LDE3MSwyMTMsMTA2LDE4MSw5MCwxNzMsODYsMTcxLDIxMywxMDYsMTgxLDkwLDE3Myw4NiwxNzEsMjEzLDEwNiwxODEsOTAsMTczLDg2LDE3MSwyMTMsMTA2LDE4MSw5MCwxNzMsODYsMTcxLDIxMywxMDYsMTgxLDkwLDE3Myw4NiwzLDBdLCJsIjo2MCwicSI6NiwiciI6N319AAAAAAAAAAAAAAAAAAAAAAAAAAAAAAAAAAAAAAAAAAAAAAA='}}
prove_84;90;74;Mul;6660;211449;211449.0;1025;0.07232837499941525;{'verificationValue': 211449.0, 'proof': {'imageId': [2948630792, 2482136711, 1512618692, 3197082418, 820963868, 463243005, 2815130045, 3835354657], 'receipt': 'AwAAAAAAAAAAAAAAxAciAPPsD8genbvcCN2DvDmorNgPyU2p6hAM/h+8IU0pSDuhAAAAAAAAAAAAAAAAAAAAAAAAAAAAAAAAAAAAAAAAAAAAAAAAAAAAAAAAAAAAAAAAAQAAAAAAAAAAAAAAAAAAAAAAAAAAAAAAAAAAAAAAAAAAAAAAAAAAAAEAAAAAnAEAAAAAAAAIAAAAMjExNDQ5LjCJAQAAeyJ3YXNfZmlyc3RfZXZlbnQiOmZhbHNlLCJpbWFnZV9pZCI6WzI5NDg2MzA3OTIsMjQ4MjEzNjcxMSwxNTEyNjE4NjkyLDMxOTcwODI0MTgsODIwOTYzODY4LDQ2MzI0MzAwNSwyODE1MTMwMDQ1LDM4MzUzNTQ2NTddLCJxZiI6eyJiIjpbMCw0LDAsMCwwLDAsMCwwLDAsMCwwLDAsMCwwLDAsMCwzMiwwLDEyOCw5MCwxNzMsODYsMTcxLDIxMywxMDYsMTgxLDkwLDE3Myw4NiwxNzEsMjEzLDEwNiwxODEsOTAsMTczLDg2LDE3MSwyMTMsMTA2LDE4MSw5MCwxNzMsODYsMTcxLDIxMywxMDYsMTgxLDkwLDE3Myw4NiwxNzEsMjEzLDEwNiwxODEsOTAsMTczLDg2LDE3MSwyMTMsMTA2LDE4MSw5MCwxNzMsODYsMTcxLDIxMywxMDYsMTgxLDkwLDE3Myw4NiwzLDBdLCJsIjo2MCwicSI6NiwiciI6N319AAAAAAAAAAAAAAAAAAAAnAEAAAAAAAAIAAAAMjExNDQ5LjCJAQAAeyJ3YXNfZmlyc3RfZXZlbnQiOmZhbHNlLCJpbWFnZV9pZCI6WzI5NDg2MzA3OTIsMjQ4MjEzNjcxMSwxNTEyNjE4NjkyLDMxOTcwODI0MTgsODIwOTYzODY4LDQ2MzI0MzAwNSwyODE1MTMwMDQ1LDM4MzUzNTQ2NTddLCJxZiI6eyJiIjpbMCw0LDAsMCwwLDAsMCwwLDAsMCwwLDAsMCwwLDAsMCwzMiwwLDEyOCw5MCwxNzMsODYsMTcxLDIxMywxMDYsMTgxLDkwLDE3Myw4NiwxNzEsMjEzLDEwNiwxODEsOTAsMTczLDg2LDE3MSwyMTMsMTA2LDE4MSw5MCwxNzMsODYsMTcxLDIxMywxMDYsMTgxLDkwLDE3Myw4NiwxNzEsMjEzLDEwNiwxODEsOTAsMTczLDg2LDE3MSwyMTMsMTA2LDE4MSw5MCwxNzMsODYsMTcxLDIxMywxMDYsMTgxLDkwLDE3Myw4NiwzLDBdLCJsIjo2MCwicSI6NiwiciI6N319AAAAAAAAAAAAAAAAAAAAAAAAAAAAAAAAAAAAAAAAAAAAAAA='}}
prove_85;29;27;Mul;783;212232;212232.0;1025;0.07325083300020196;{'verificationValue': 212232.0, 'proof': {'imageId': [2948630792, 2482136711, 1512618692, 3197082418, 820963868, 463243005, 2815130045, 3835354657], 'receipt': 'AwAAAAAAAAAAAAAAxAciAPPsD8genbvcCN2DvDmorNgPyU2p6hAM/h+8IU0pSDuhAAAAAAAAAAAAAAAAAAAAAAAAAAAAAAAAAAAAAAAAAAAAAAAAAAAAAAAAAAAAAAAAAQAAAAAAAAAAAAAAAAAAAAAAAAAAAAAAAAAAAAAAAAAAAAAAAAAAAAEAAAAAnAEAAAAAAAAIAAAAMjEyMjMyLjCJAQAAeyJ3YXNfZmlyc3RfZXZlbnQiOmZhbHNlLCJpbWFnZV9pZCI6WzI5NDg2MzA3OTIsMjQ4MjEzNjcxMSwxNTEyNjE4NjkyLDMxOTcwODI0MTgsODIwOTYzODY4LDQ2MzI0MzAwNSwyODE1MTMwMDQ1LDM4MzUzNTQ2NTddLCJxZiI6eyJiIjpbMCw0LDAsMCwwLDAsMCwwLDAsMCwwLDAsMCwwLDAsMCwzMiwwLDEyOCw5MCwxNzMsODYsMTcxLDIxMywxMDYsMTgxLDkwLDE3Myw4NiwxNzEsMjEzLDEwNiwxODEsOTAsMTczLDg2LDE3MSwyMTMsMTA2LDE4MSw5MCwxNzMsODYsMTcxLDIxMywxMDYsMTgxLDkwLDE3Myw4NiwxNzEsMjEzLDEwNiwxODEsOTAsMTczLDg2LDE3MSwyMTMsMTA2LDE4MSw5MCwxNzMsODYsMTcxLDIxMywxMDYsMTgxLDkwLDE3Myw4NiwzLDBdLCJsIjo2MCwicSI6NiwiciI6N319AAAAAAAAAAAAAAAAAAAAnAEAAAAAAAAIAAAAMjEyMjMyLjCJAQAAeyJ3YXNfZmlyc3RfZXZlbnQiOmZhbHNlLCJpbWFnZV9pZCI6WzI5NDg2MzA3OTIsMjQ4MjEzNjcxMSwxNTEyNjE4NjkyLDMxOTcwODI0MTgsODIwOTYzODY4LDQ2MzI0MzAwNSwyODE1MTMwMDQ1LDM4MzUzNTQ2NTddLCJxZiI6eyJiIjpbMCw0LDAsMCwwLDAsMCwwLDAsMCwwLDAsMCwwLDAsMCwzMiwwLDEyOCw5MCwxNzMsODYsMTcxLDIxMywxMDYsMTgxLDkwLDE3Myw4NiwxNzEsMjEzLDEwNiwxODEsOTAsMTczLDg2LDE3MSwyMTMsMTA2LDE4MSw5MCwxNzMsODYsMTcxLDIxMywxMDYsMTgxLDkwLDE3Myw4NiwxNzEsMjEzLDEwNiwxODEsOTAsMTczLDg2LDE3MSwyMTMsMTA2LDE4MSw5MCwxNzMsODYsMTcxLDIxMywxMDYsMTgxLDkwLDE3Myw4NiwzLDBdLCJsIjo2MCwicSI6NiwiciI6N319AAAAAAAAAAAAAAAAAAAAAAAAAAAAAAAAAAAAAAAAAAAAAAA='}}
prove_86;25;49;Mul;1225;213457;213457.0;1025;0.07274849999885191;{'verificationValue': 213457.0, 'proof': {'imageId': [2948630792, 2482136711, 1512618692, 3197082418, 820963868, 463243005, 2815130045, 3835354657], 'receipt': 'AwAAAAAAAAAAAAAAxAciAPPsD8genbvcCN2DvDmorNgPyU2p6hAM/h+8IU0pSDuhAAAAAAAAAAAAAAAAAAAAAAAAAAAAAAAAAAAAAAAAAAAAAAAAAAAAAAAAAAAAAAAAAQAAAAAAAAAAAAAAAAAAAAAAAAAAAAAAAAAAAAAAAAAAAAAAAAAAAAEAAAAAnAEAAAAAAAAIAAAAMjEzNDU3LjCJAQAAeyJ3YXNfZmlyc3RfZXZlbnQiOmZhbHNlLCJpbWFnZV9pZCI6WzI5NDg2MzA3OTIsMjQ4MjEzNjcxMSwxNTEyNjE4NjkyLDMxOTcwODI0MTgsODIwOTYzODY4LDQ2MzI0MzAwNSwyODE1MTMwMDQ1LDM4MzUzNTQ2NTddLCJxZiI6eyJiIjpbMCw0LDAsMCwwLDAsMCwwLDAsMCwwLDAsMCwwLDAsMCwzMiwwLDEyOCw5MCwxNzMsODYsMTcxLDIxMywxMDYsMTgxLDkwLDE3Myw4NiwxNzEsMjEzLDEwNiwxODEsOTAsMTczLDg2LDE3MSwyMTMsMTA2LDE4MSw5MCwxNzMsODYsMTcxLDIxMywxMDYsMTgxLDkwLDE3Myw4NiwxNzEsMjEzLDEwNiwxODEsOTAsMTczLDg2LDE3MSwyMTMsMTA2LDE4MSw5MCwxNzMsODYsMTcxLDIxMywxMDYsMTgxLDkwLDE3Myw4NiwzLDBdLCJsIjo2MCwicSI6NiwiciI6N319AAAAAAAAAAAAAAAAAAAAnAEAAAAAAAAIAAAAMjEzNDU3LjCJAQAAeyJ3YXNfZmlyc3RfZXZlbnQiOmZhbHNlLCJpbWFnZV9pZCI6WzI5NDg2MzA3OTIsMjQ4MjEzNjcxMSwxNTEyNjE4NjkyLDMxOTcwODI0MTgsODIwOTYzODY4LDQ2MzI0MzAwNSwyODE1MTMwMDQ1LDM4MzUzNTQ2NTddLCJxZiI6eyJiIjpbMCw0LDAsMCwwLDAsMCwwLDAsMCwwLDAsMCwwLDAsMCwzMiwwLDEyOCw5MCwxNzMsODYsMTcxLDIxMywxMDYsMTgxLDkwLDE3Myw4NiwxNzEsMjEzLDEwNiwxODEsOTAsMTczLDg2LDE3MSwyMTMsMTA2LDE4MSw5MCwxNzMsODYsMTcxLDIxMywxMDYsMTgxLDkwLDE3Myw4NiwxNzEsMjEzLDEwNiwxODEsOTAsMTczLDg2LDE3MSwyMTMsMTA2LDE4MSw5MCwxNzMsODYsMTcxLDIxMywxMDYsMTgxLDkwLDE3Myw4NiwzLDBdLCJsIjo2MCwicSI6NiwiciI6N319AAAAAAAAAAAAAAAAAAAAAAAAAAAAAAAAAAAAAAAAAAAAAAA='}}
prove_87;67;67;Mul;4489;217946;217946.0;1025;0.07371079100084899;{'verificationValue': 217946.0, 'proof': {'imageId': [2948630792, 2482136711, 1512618692, 3197082418, 820963868, 463243005, 2815130045, 3835354657], 'receipt': 'AwAAAAAAAAAAAAAAxAciAPPsD8genbvcCN2DvDmorNgPyU2p6hAM/h+8IU0pSDuhAAAAAAAAAAAAAAAAAAAAAAAAAAAAAAAAAAAAAAAAAAAAAAAAAAAAAAAAAAAAAAAAAQAAAAAAAAAAAAAAAAAAAAAAAAAAAAAAAAAAAAAAAAAAAAAAAAAAAAEAAAAAnAEAAAAAAAAIAAAAMjE3OTQ2LjCJAQAAeyJ3YXNfZmlyc3RfZXZlbnQiOmZhbHNlLCJpbWFnZV9pZCI6WzI5NDg2MzA3OTIsMjQ4MjEzNjcxMSwxNTEyNjE4NjkyLDMxOTcwODI0MTgsODIwOTYzODY4LDQ2MzI0MzAwNSwyODE1MTMwMDQ1LDM4MzUzNTQ2NTddLCJxZiI6eyJiIjpbMCw0LDAsMCwwLDAsMCwwLDAsMCwwLDAsMCwwLDAsMCwzMiwwLDEyOCw5MCwxNzMsODYsMTcxLDIxMywxMDYsMTgxLDkwLDE3Myw4NiwxNzEsMjEzLDEwNiwxODEsOTAsMTczLDg2LDE3MSwyMTMsMTA2LDE4MSw5MCwxNzMsODYsMTcxLDIxMywxMDYsMTgxLDkwLDE3Myw4NiwxNzEsMjEzLDEwNiwxODEsOTAsMTczLDg2LDE3MSwyMTMsMTA2LDE4MSw5MCwxNzMsODYsMTcxLDIxMywxMDYsMTgxLDkwLDE3Myw4NiwzLDBdLCJsIjo2MCwicSI6NiwiciI6N319AAAAAAAAAAAAAAAAAAAAnAEAAAAAAAAIAAAAMjE3OTQ2LjCJAQAAeyJ3YXNfZmlyc3RfZXZlbnQiOmZhbHNlLCJpbWFnZV9pZCI6WzI5NDg2MzA3OTIsMjQ4MjEzNjcxMSwxNTEyNjE4NjkyLDMxOTcwODI0MTgsODIwOTYzODY4LDQ2MzI0MzAwNSwyODE1MTMwMDQ1LDM4MzUzNTQ2NTddLCJxZiI6eyJiIjpbMCw0LDAsMCwwLDAsMCwwLDAsMCwwLDAsMCwwLDAsMCwzMiwwLDEyOCw5MCwxNzMsODYsMTcxLDIxMywxMDYsMTgxLDkwLDE3Myw4NiwxNzEsMjEzLDEwNiwxODEsOTAsMTczLDg2LDE3MSwyMTMsMTA2LDE4MSw5MCwxNzMsODYsMTcxLDIxMywxMDYsMTgxLDkwLDE3Myw4NiwxNzEsMjEzLDEwNiwxODEsOTAsMTczLDg2LDE3MSwyMTMsMTA2LDE4MSw5MCwxNzMsODYsMTcxLDIxMywxMDYsMTgxLDkwLDE3Myw4NiwzLDBdLCJsIjo2MCwicSI6NiwiciI6N319AAAAAAAAAAAAAAAAAAAAAAAAAAAAAAAAAAAAAAAAAAAAAAA='}}
prove_88;38;38;Mul;1444;219390;219390.0;1025;0.07255875000009837;{'verificationValue': 219390.0, 'proof': {'imageId': [2948630792, 2482136711, 1512618692, 3197082418, 820963868, 463243005, 2815130045, 3835354657], 'receipt': 'AwAAAAAAAAAAAAAAxAciAPPsD8genbvcCN2DvDmorNgPyU2p6hAM/h+8IU0pSDuhAAAAAAAAAAAAAAAAAAAAAAAAAAAAAAAAAAAAAAAAAAAAAAAAAAAAAAAAAAAAAAAAAQAAAAAAAAAAAAAAAAAAAAAAAAAAAAAAAAAAAAAAAAAAAAAAAAAAAAEAAAAAnAEAAAAAAAAIAAAAMjE5MzkwLjCJAQAAeyJ3YXNfZmlyc3RfZXZlbnQiOmZhbHNlLCJpbWFnZV9pZCI6WzI5NDg2MzA3OTIsMjQ4MjEzNjcxMSwxNTEyNjE4NjkyLDMxOTcwODI0MTgsODIwOTYzODY4LDQ2MzI0MzAwNSwyODE1MTMwMDQ1LDM4MzUzNTQ2NTddLCJxZiI6eyJiIjpbMCw0LDAsMCwwLDAsMCwwLDAsMCwwLDAsMCwwLDAsMCwzMiwwLDEyOCw5MCwxNzMsODYsMTcxLDIxMywxMDYsMTgxLDkwLDE3Myw4NiwxNzEsMjEzLDEwNiwxODEsOTAsMTczLDg2LDE3MSwyMTMsMTA2LDE4MSw5MCwxNzMsODYsMTcxLDIxMywxMDYsMTgxLDkwLDE3Myw4NiwxNzEsMjEzLDEwNiwxODEsOTAsMTczLDg2LDE3MSwyMTMsMTA2LDE4MSw5MCwxNzMsODYsMTcxLDIxMywxMDYsMTgxLDkwLDE3Myw4NiwzLDBdLCJsIjo2MCwicSI6NiwiciI6N319AAAAAAAAAAAAAAAAAAAAnAEAAAAAAAAIAAAAMjE5MzkwLjCJAQAAeyJ3YXNfZmlyc3RfZXZlbnQiOmZhbHNlLCJpbWFnZV9pZCI6WzI5NDg2MzA3OTIsMjQ4MjEzNjcxMSwxNTEyNjE4NjkyLDMxOTcwODI0MTgsODIwOTYzODY4LDQ2MzI0MzAwNSwyODE1MTMwMDQ1LDM4MzUzNTQ2NTddLCJxZiI6eyJiIjpbMCw0LDAsMCwwLDAsMCwwLDAsMCwwLDAsMCwwLDAsMCwzMiwwLDEyOCw5MCwxNzMsODYsMTcxLDIxMywxMDYsMTgxLDkwLDE3Myw4NiwxNzEsMjEzLDEwNiwxODEsOTAsMTczLDg2LDE3MSwyMTMsMTA2LDE4MSw5MCwxNzMsODYsMTcxLDIxMywxMDYsMTgxLDkwLDE3Myw4NiwxNzEsMjEzLDEwNiwxODEsOTAsMTczLDg2LDE3MSwyMTMsMTA2LDE4MSw5MCwxNzMsODYsMTcxLDIxMywxMDYsMTgxLDkwLDE3Myw4NiwzLDBdLCJsIjo2MCwicSI6NiwiciI6N319AAAAAAAAAAAAAAAAAAAAAAAAAAAAAAAAAAAAAAAAAAAAAAA='}}
prove_89;62;20;Mul;1240;220630;220630.0;1025;0.07356450000042969;{'verificationValue': 220630.0, 'proof': {'imageId': [2948630792, 2482136711, 1512618692, 3197082418, 820963868, 463243005, 2815130045, 3835354657], 'receipt': 'AwAAAAAAAAAAAAAAxAciAPPsD8genbvcCN2DvDmorNgPyU2p6hAM/h+8IU0pSDuhAAAAAAAAAAAAAAAAAAAAAAAAAAAAAAAAAAAAAAAAAAAAAAAAAAAAAAAAAAAAAAAAAQAAAAAAAAAAAAAAAAAAAAAAAAAAAAAAAAAAAAAAAAAAAAAAAAAAAAEAAAAAnAEAAAAAAAAIAAAAMjIwNjMwLjCJAQAAeyJ3YXNfZmlyc3RfZXZlbnQiOmZhbHNlLCJpbWFnZV9pZCI6WzI5NDg2MzA3OTIsMjQ4MjEzNjcxMSwxNTEyNjE4NjkyLDMxOTcwODI0MTgsODIwOTYzODY4LDQ2MzI0MzAwNSwyODE1MTMwMDQ1LDM4MzUzNTQ2NTddLCJxZiI6eyJiIjpbMCw0LDAsMCwwLDAsMCwwLDAsMCwwLDAsMCwwLDAsMCwzMiwwLDEyOCw5MCwxNzMsODYsMTcxLDIxMywxMDYsMTgxLDkwLDE3Myw4NiwxNzEsMjEzLDEwNiwxODEsOTAsMTczLDg2LDE3MSwyMTMsMTA2LDE4MSw5MCwxNzMsODYsMTcxLDIxMywxMDYsMTgxLDkwLDE3Myw4NiwxNzEsMjEzLDEwNiwxODEsOTAsMTczLDg2LDE3MSwyMTMsMTA2LDE4MSw5MCwxNzMsODYsMTcxLDIxMywxMDYsMTgxLDkwLDE3Myw4NiwzLDBdLCJsIjo2MCwicSI6NiwiciI6N319AAAAAAAAAAAAAAAAAAAAnAEAAAAAAAAIAAAAMjIwNjMwLjCJAQAAeyJ3YXNfZmlyc3RfZXZlbnQiOmZhbHNlLCJpbWFnZV9pZCI6WzI5NDg2MzA3OTIsMjQ4MjEzNjcxMSwxNTEyNjE4NjkyLDMxOTcwODI0MTgsODIwOTYzODY4LDQ2MzI0MzAwNSwyODE1MTMwMDQ1LDM4MzUzNTQ2NTddLCJxZiI6eyJiIjpbMCw0LDAsMCwwLDAsMCwwLDAsMCwwLDAsMCwwLDAsMCwzMiwwLDEyOCw5MCwxNzMsODYsMTcxLDIxMywxMDYsMTgxLDkwLDE3Myw4NiwxNzEsMjEzLDEwNiwxODEsOTAsMTczLDg2LDE3MSwyMTMsMTA2LDE4MSw5MCwxNzMsODYsMTcxLDIxMywxMDYsMTgxLDkwLDE3Myw4NiwxNzEsMjEzLDEwNiwxODEsOTAsMTczLDg2LDE3MSwyMTMsMTA2LDE4MSw5MCwxNzMsODYsMTcxLDIxMywxMDYsMTgxLDkwLDE3Myw4NiwzLDBdLCJsIjo2MCwicSI6NiwiciI6N319AAAAAAAAAAAAAAAAAAAAAAAAAAAAAAAAAAAAAAAAAAAAAAA='}}
prove_90;44;77;Mul;3388;224018;224018.0;1025;0.07227295899974706;{'verificationValue': 224018.0, 'proof': {'imageId': [2948630792, 2482136711, 1512618692, 3197082418, 820963868, 463243005, 2815130045, 3835354657], 'receipt': 'AwAAAAAAAAAAAAAAxAciAPPsD8genbvcCN2DvDmorNgPyU2p6hAM/h+8IU0pSDuhAAAAAAAAAAAAAAAAAAAAAAAAAAAAAAAAAAAAAAAAAAAAAAAAAAAAAAAAAAAAAAAAAQAAAAAAAAAAAAAAAAAAAAAAAAAAAAAAAAAAAAAAAAAAAAAAAAAAAAEAAAAAnAEAAAAAAAAIAAAAMjI0MDE4LjCJAQAAeyJ3YXNfZmlyc3RfZXZlbnQiOmZhbHNlLCJpbWFnZV9pZCI6WzI5NDg2MzA3OTIsMjQ4MjEzNjcxMSwxNTEyNjE4NjkyLDMxOTcwODI0MTgsODIwOTYzODY4LDQ2MzI0MzAwNSwyODE1MTMwMDQ1LDM4MzUzNTQ2NTddLCJxZiI6eyJiIjpbMCw0LDAsMCwwLDAsMCwwLDAsMCwwLDAsMCwwLDAsMCwzMiwwLDEyOCw5MCwxNzMsODYsMTcxLDIxMywxMDYsMTgxLDkwLDE3Myw4NiwxNzEsMjEzLDEwNiwxODEsOTAsMTczLDg2LDE3MSwyMTMsMTA2LDE4MSw5MCwxNzMsODYsMTcxLDIxMywxMDYsMTgxLDkwLDE3Myw4NiwxNzEsMjEzLDEwNiwxODEsOTAsMTczLDg2LDE3MSwyMTMsMTA2LDE4MSw5MCwxNzMsODYsMTcxLDIxMywxMDYsMTgxLDkwLDE3Myw4NiwzLDBdLCJsIjo2MCwicSI6NiwiciI6N319AAAAAAAAAAAAAAAAAAAAnAEAAAAAAAAIAAAAMjI0MDE4LjCJAQAAeyJ3YXNfZmlyc3RfZXZlbnQiOmZhbHNlLCJpbWFnZV9pZCI6WzI5NDg2MzA3OTIsMjQ4MjEzNjcxMSwxNTEyNjE4NjkyLDMxOTcwODI0MTgsODIwOTYzODY4LDQ2MzI0MzAwNSwyODE1MTMwMDQ1LDM4MzUzNTQ2NTddLCJxZiI6eyJiIjpbMCw0LDAsMCwwLDAsMCwwLDAsMCwwLDAsMCwwLDAsMCwzMiwwLDEyOCw5MCwxNzMsODYsMTcxLDIxMywxMDYsMTgxLDkwLDE3Myw4NiwxNzEsMjEzLDEwNiwxODEsOTAsMTczLDg2LDE3MSwyMTMsMTA2LDE4MSw5MCwxNzMsODYsMTcxLDIxMywxMDYsMTgxLDkwLDE3Myw4NiwxNzEsMjEzLDEwNiwxODEsOTAsMTczLDg2LDE3MSwyMTMsMTA2LDE4MSw5MCwxNzMsODYsMTcxLDIxMywxMDYsMTgxLDkwLDE3Myw4NiwzLDBdLCJsIjo2MCwicSI6NiwiciI6N319AAAAAAAAAAAAAAAAAAAAAAAAAAAAAAAAAAAAAAAAAAAAAAA='}}
prove_91;88;89;Mul;7832;231850;231850.0;1025;0.07313829200029431;{'verificationValue': 231850.0, 'proof': {'imageId': [2948630792, 2482136711, 1512618692, 3197082418, 820963868, 463243005, 2815130045, 3835354657], 'receipt': 'AwAAAAAAAAAAAAAAxAciAPPsD8genbvcCN2DvDmorNgPyU2p6hAM/h+8IU0pSDuhAAAAAAAAAAAAAAAAAAAAAAAAAAAAAAAAAAAAAAAAAAAAAAAAAAAAAAAAAAAAAAAAAQAAAAAAAAAAAAAAAAAAAAAAAAAAAAAAAAAAAAAAAAAAAAAAAAAAAAEAAAAAnAEAAAAAAAAIAAAAMjMxODUwLjCJAQAAeyJ3YXNfZmlyc3RfZXZlbnQiOmZhbHNlLCJpbWFnZV9pZCI6WzI5NDg2MzA3OTIsMjQ4MjEzNjcxMSwxNTEyNjE4NjkyLDMxOTcwODI0MTgsODIwOTYzODY4LDQ2MzI0MzAwNSwyODE1MTMwMDQ1LDM4MzUzNTQ2NTddLCJxZiI6eyJiIjpbMCw0LDAsMCwwLDAsMCwwLDAsMCwwLDAsMCwwLDAsMCwzMiwwLDEyOCw5MCwxNzMsODYsMTcxLDIxMywxMDYsMTgxLDkwLDE3Myw4NiwxNzEsMjEzLDEwNiwxODEsOTAsMTczLDg2LDE3MSwyMTMsMTA2LDE4MSw5MCwxNzMsODYsMTcxLDIxMywxMDYsMTgxLDkwLDE3Myw4NiwxNzEsMjEzLDEwNiwxODEsOTAsMTczLDg2LDE3MSwyMTMsMTA2LDE4MSw5MCwxNzMsODYsMTcxLDIxMywxMDYsMTgxLDkwLDE3Myw4NiwzLDBdLCJsIjo2MCwicSI6NiwiciI6N319AAAAAAAAAAAAAAAAAAAAnAEAAAAAAAAIAAAAMjMxODUwLjCJAQAAeyJ3YXNfZmlyc3RfZXZlbnQiOmZhbHNlLCJpbWFnZV9pZCI6WzI5NDg2MzA3OTIsMjQ4MjEzNjcxMSwxNTEyNjE4NjkyLDMxOTcwODI0MTgsODIwOTYzODY4LDQ2MzI0MzAwNSwyODE1MTMwMDQ1LDM4MzUzNTQ2NTddLCJxZiI6eyJiIjpbMCw0LDAsMCwwLDAsMCwwLDAsMCwwLDAsMCwwLDAsMCwzMiwwLDEyOCw5MCwxNzMsODYsMTcxLDIxMywxMDYsMTgxLDkwLDE3Myw4NiwxNzEsMjEzLDEwNiwxODEsOTAsMTczLDg2LDE3MSwyMTMsMTA2LDE4MSw5MCwxNzMsODYsMTcxLDIxMywxMDYsMTgxLDkwLDE3Myw4NiwxNzEsMjEzLDEwNiwxODEsOTAsMTczLDg2LDE3MSwyMTMsMTA2LDE4MSw5MCwxNzMsODYsMTcxLDIxMywxMDYsMTgxLDkwLDE3Myw4NiwzLDBdLCJsIjo2MCwicSI6NiwiciI6N319AAAAAAAAAAAAAAAAAAAAAAAAAAAAAAAAAAAAAAAAAAAAAAA='}}
prove_92;68;74;Mul;5032;236882;236882.0;1025;0.07307987499916635;{'verificationValue': 236882.0, 'proof': {'imageId': [2948630792, 2482136711, 1512618692, 3197082418, 820963868, 463243005, 2815130045, 3835354657], 'receipt': 'AwAAAAAAAAAAAAAAxAciAPPsD8genbvcCN2DvDmorNgPyU2p6hAM/h+8IU0pSDuhAAAAAAAAAAAAAAAAAAAAAAAAAAAAAAAAAAAAAAAAAAAAAAAAAAAAAAAAAAAAAAAAAQAAAAAAAAAAAAAAAAAAAAAAAAAAAAAAAAAAAAAAAAAAAAAAAAAAAAEAAAAAnAEAAAAAAAAIAAAAMjM2ODgyLjCJAQAAeyJ3YXNfZmlyc3RfZXZlbnQiOmZhbHNlLCJpbWFnZV9pZCI6WzI5NDg2MzA3OTIsMjQ4MjEzNjcxMSwxNTEyNjE4NjkyLDMxOTcwODI0MTgsODIwOTYzODY4LDQ2MzI0MzAwNSwyODE1MTMwMDQ1LDM4MzUzNTQ2NTddLCJxZiI6eyJiIjpbMCw0LDAsMCwwLDAsMCwwLDAsMCwwLDAsMCwwLDAsMCwzMiwwLDEyOCw5MCwxNzMsODYsMTcxLDIxMywxMDYsMTgxLDkwLDE3Myw4NiwxNzEsMjEzLDEwNiwxODEsOTAsMTczLDg2LDE3MSwyMTMsMTA2LDE4MSw5MCwxNzMsODYsMTcxLDIxMywxMDYsMTgxLDkwLDE3Myw4NiwxNzEsMjEzLDEwNiwxODEsOTAsMTczLDg2LDE3MSwyMTMsMTA2LDE4MSw5MCwxNzMsODYsMTcxLDIxMywxMDYsMTgxLDkwLDE3Myw4NiwzLDBdLCJsIjo2MCwicSI6NiwiciI6N319AAAAAAAAAAAAAAAAAAAAnAEAAAAAAAAIAAAAMjM2ODgyLjCJAQAAeyJ3YXNfZmlyc3RfZXZlbnQiOmZhbHNlLCJpbWFnZV9pZCI6WzI5NDg2MzA3OTIsMjQ4MjEzNjcxMSwxNTEyNjE4NjkyLDMxOTcwODI0MTgsODIwOTYzODY4LDQ2MzI0MzAwNSwyODE1MTMwMDQ1LDM4MzUzNTQ2NTddLCJxZiI6eyJiIjpbMCw0LDAsMCwwLDAsMCwwLDAsMCwwLDAsMCwwLDAsMCwzMiwwLDEyOCw5MCwxNzMsODYsMTcxLDIxMywxMDYsMTgxLDkwLDE3Myw4NiwxNzEsMjEzLDEwNiwxODEsOTAsMTczLDg2LDE3MSwyMTMsMTA2LDE4MSw5MCwxNzMsODYsMTcxLDIxMywxMDYsMTgxLDkwLDE3Myw4NiwxNzEsMjEzLDEwNiwxODEsOTAsMTczLDg2LDE3MSwyMTMsMTA2LDE4MSw5MCwxNzMsODYsMTcxLDIxMywxMDYsMTgxLDkwLDE3Myw4NiwzLDBdLCJsIjo2MCwicSI6NiwiciI6N319AAAAAAAAAAAAAAAAAAAAAAAAAAAAAAAAAAAAAAAAAAAAAAA='}}
prove_93;96;33;Mul;3168;240050;240050.0;1025;0.07361104199844704;{'verificationValue': 240050.0, 'proof': {'imageId': [2948630792, 2482136711, 1512618692, 3197082418, 820963868, 463243005, 2815130045, 3835354657], 'receipt': 'AwAAAAAAAAAAAAAAxAciAPPsD8genbvcCN2DvDmorNgPyU2p6hAM/h+8IU0pSDuhAAAAAAAAAAAAAAAAAAAAAAAAAAAAAAAAAAAAAAAAAAAAAAAAAAAAAAAAAAAAAAAAAQAAAAAAAAAAAAAAAAAAAAAAAAAAAAAAAAAAAAAAAAAAAAAAAAAAAAEAAAAAnAEAAAAAAAAIAAAAMjQwMDUwLjCJAQAAeyJ3YXNfZmlyc3RfZXZlbnQiOmZhbHNlLCJpbWFnZV9pZCI6WzI5NDg2MzA3OTIsMjQ4MjEzNjcxMSwxNTEyNjE4NjkyLDMxOTcwODI0MTgsODIwOTYzODY4LDQ2MzI0MzAwNSwyODE1MTMwMDQ1LDM4MzUzNTQ2NTddLCJxZiI6eyJiIjpbMCw0LDAsMCwwLDAsMCwwLDAsMCwwLDAsMCwwLDAsMCwzMiwwLDEyOCw5MCwxNzMsODYsMTcxLDIxMywxMDYsMTgxLDkwLDE3Myw4NiwxNzEsMjEzLDEwNiwxODEsOTAsMTczLDg2LDE3MSwyMTMsMTA2LDE4MSw5MCwxNzMsODYsMTcxLDIxMywxMDYsMTgxLDkwLDE3Myw4NiwxNzEsMjEzLDEwNiwxODEsOTAsMTczLDg2LDE3MSwyMTMsMTA2LDE4MSw5MCwxNzMsODYsMTcxLDIxMywxMDYsMTgxLDkwLDE3Myw4NiwzLDBdLCJsIjo2MCwicSI6NiwiciI6N319AAAAAAAAAAAAAAAAAAAAnAEAAAAAAAAIAAAAMjQwMDUwLjCJAQAAeyJ3YXNfZmlyc3RfZXZlbnQiOmZhbHNlLCJpbWFnZV9pZCI6WzI5NDg2MzA3OTIsMjQ4MjEzNjcxMSwxNTEyNjE4NjkyLDMxOTcwODI0MTgsODIwOTYzODY4LDQ2MzI0MzAwNSwyODE1MTMwMDQ1LDM4MzUzNTQ2NTddLCJxZiI6eyJiIjpbMCw0LDAsMCwwLDAsMCwwLDAsMCwwLDAsMCwwLDAsMCwzMiwwLDEyOCw5MCwxNzMsODYsMTcxLDIxMywxMDYsMTgxLDkwLDE3Myw4NiwxNzEsMjEzLDEwNiwxODEsOTAsMTczLDg2LDE3MSwyMTMsMTA2LDE4MSw5MCwxNzMsODYsMTcxLDIxMywxMDYsMTgxLDkwLDE3Myw4NiwxNzEsMjEzLDEwNiwxODEsOTAsMTczLDg2LDE3MSwyMTMsMTA2LDE4MSw5MCwxNzMsODYsMTcxLDIxMywxMDYsMTgxLDkwLDE3Myw4NiwzLDBdLCJsIjo2MCwicSI6NiwiciI6N319AAAAAAAAAAAAAAAAAAAAAAAAAAAAAAAAAAAAAAAAAAAAAAA='}}
prove_94;72;12;Mul;864;240914;240914.0;1025;0.0722958340011246;{'verificationValue': 240914.0, 'proof': {'imageId': [2948630792, 2482136711, 1512618692, 3197082418, 820963868, 463243005, 2815130045, 3835354657], 'receipt': 'AwAAAAAAAAAAAAAAxAciAPPsD8genbvcCN2DvDmorNgPyU2p6hAM/h+8IU0pSDuhAAAAAAAAAAAAAAAAAAAAAAAAAAAAAAAAAAAAAAAAAAAAAAAAAAAAAAAAAAAAAAAAAQAAAAAAAAAAAAAAAAAAAAAAAAAAAAAAAAAAAAAAAAAAAAAAAAAAAAEAAAAAnAEAAAAAAAAIAAAAMjQwOTE0LjCJAQAAeyJ3YXNfZmlyc3RfZXZlbnQiOmZhbHNlLCJpbWFnZV9pZCI6WzI5NDg2MzA3OTIsMjQ4MjEzNjcxMSwxNTEyNjE4NjkyLDMxOTcwODI0MTgsODIwOTYzODY4LDQ2MzI0MzAwNSwyODE1MTMwMDQ1LDM4MzUzNTQ2NTddLCJxZiI6eyJiIjpbMCw0LDAsMCwwLDAsMCwwLDAsMCwwLDAsMCwwLDAsMCwzMiwwLDEyOCw5MCwxNzMsODYsMTcxLDIxMywxMDYsMTgxLDkwLDE3Myw4NiwxNzEsMjEzLDEwNiwxODEsOTAsMTczLDg2LDE3MSwyMTMsMTA2LDE4MSw5MCwxNzMsODYsMTcxLDIxMywxMDYsMTgxLDkwLDE3Myw4NiwxNzEsMjEzLDEwNiwxODEsOTAsMTczLDg2LDE3MSwyMTMsMTA2LDE4MSw5MCwxNzMsODYsMTcxLDIxMywxMDYsMTgxLDkwLDE3Myw4NiwzLDBdLCJsIjo2MCwicSI6NiwiciI6N319AAAAAAAAAAAAAAAAAAAAnAEAAAAAAAAIAAAAMjQwOTE0LjCJAQAAeyJ3YXNfZmlyc3RfZXZlbnQiOmZhbHNlLCJpbWFnZV9pZCI6WzI5NDg2MzA3OTIsMjQ4MjEzNjcxMSwxNTEyNjE4NjkyLDMxOTcwODI0MTgsODIwOTYzODY4LDQ2MzI0MzAwNSwyODE1MTMwMDQ1LDM4MzUzNTQ2NTddLCJxZiI6eyJiIjpbMCw0LDAsMCwwLDAsMCwwLDAsMCwwLDAsMCwwLDAsMCwzMiwwLDEyOCw5MCwxNzMsODYsMTcxLDIxMywxMDYsMTgxLDkwLDE3Myw4NiwxNzEsMjEzLDEwNiwxODEsOTAsMTczLDg2LDE3MSwyMTMsMTA2LDE4MSw5MCwxNzMsODYsMTcxLDIxMywxMDYsMTgxLDkwLDE3Myw4NiwxNzEsMjEzLDEwNiwxODEsOTAsMTczLDg2LDE3MSwyMTMsMTA2LDE4MSw5MCwxNzMsODYsMTcxLDIxMywxMDYsMTgxLDkwLDE3Myw4NiwzLDBdLCJsIjo2MCwicSI6NiwiciI6N319AAAAAAAAAAAAAAAAAAAAAAAAAAAAAAAAAAAAAAAAAAAAAAA='}}
prove_95;56;83;Mul;4648;245562;245562.0;1025;0.07336304199998267;{'verificationValue': 245562.0, 'proof': {'imageId': [2948630792, 2482136711, 1512618692, 3197082418, 820963868, 463243005, 2815130045, 3835354657], 'receipt': 'AwAAAAAAAAAAAAAAxAciAPPsD8genbvcCN2DvDmorNgPyU2p6hAM/h+8IU0pSDuhAAAAAAAAAAAAAAAAAAAAAAAAAAAAAAAAAAAAAAAAAAAAAAAAAAAAAAAAAAAAAAAAAQAAAAAAAAAAAAAAAAAAAAAAAAAAAAAAAAAAAAAAAAAAAAAAAAAAAAEAAAAAnAEAAAAAAAAIAAAAMjQ1NTYyLjCJAQAAeyJ3YXNfZmlyc3RfZXZlbnQiOmZhbHNlLCJpbWFnZV9pZCI6WzI5NDg2MzA3OTIsMjQ4MjEzNjcxMSwxNTEyNjE4NjkyLDMxOTcwODI0MTgsODIwOTYzODY4LDQ2MzI0MzAwNSwyODE1MTMwMDQ1LDM4MzUzNTQ2NTddLCJxZiI6eyJiIjpbMCw0LDAsMCwwLDAsMCwwLDAsMCwwLDAsMCwwLDAsMCwzMiwwLDEyOCw5MCwxNzMsODYsMTcxLDIxMywxMDYsMTgxLDkwLDE3Myw4NiwxNzEsMjEzLDEwNiwxODEsOTAsMTczLDg2LDE3MSwyMTMsMTA2LDE4MSw5MCwxNzMsODYsMTcxLDIxMywxMDYsMTgxLDkwLDE3Myw4NiwxNzEsMjEzLDEwNiwxODEsOTAsMTczLDg2LDE3MSwyMTMsMTA2LDE4MSw5MCwxNzMsODYsMTcxLDIxMywxMDYsMTgxLDkwLDE3Myw4NiwzLDBdLCJsIjo2MCwicSI6NiwiciI6N319AAAAAAAAAAAAAAAAAAAAnAEAAAAAAAAIAAAAMjQ1NTYyLjCJAQAAeyJ3YXNfZmlyc3RfZXZlbnQiOmZhbHNlLCJpbWFnZV9pZCI6WzI5NDg2MzA3OTIsMjQ4MjEzNjcxMSwxNTEyNjE4NjkyLDMxOTcwODI0MTgsODIwOTYzODY4LDQ2MzI0MzAwNSwyODE1MTMwMDQ1LDM4MzUzNTQ2NTddLCJxZiI6eyJiIjpbMCw0LDAsMCwwLDAsMCwwLDAsMCwwLDAsMCwwLDAsMCwzMiwwLDEyOCw5MCwxNzMsODYsMTcxLDIxMywxMDYsMTgxLDkwLDE3Myw4NiwxNzEsMjEzLDEwNiwxODEsOTAsMTczLDg2LDE3MSwyMTMsMTA2LDE4MSw5MCwxNzMsODYsMTcxLDIxMywxMDYsMTgxLDkwLDE3Myw4NiwxNzEsMjEzLDEwNiwxODEsOTAsMTczLDg2LDE3MSwyMTMsMTA2LDE4MSw5MCwxNzMsODYsMTcxLDIxMywxMDYsMTgxLDkwLDE3Myw4NiwzLDBdLCJsIjo2MCwicSI6NiwiciI6N319AAAAAAAAAAAAAAAAAAAAAAAAAAAAAAAAAAAAAAAAAAAAAAA='}}
prove_96;60;76;Mul;4560;250122;250122.0;1025;0.07351766700048756;{'verificationValue': 250122.0, 'proof': {'imageId': [2948630792, 2482136711, 1512618692, 3197082418, 820963868, 463243005, 2815130045, 3835354657], 'receipt': 'AwAAAAAAAAAAAAAAxAciAPPsD8genbvcCN2DvDmorNgPyU2p6hAM/h+8IU0pSDuhAAAAAAAAAAAAAAAAAAAAAAAAAAAAAAAAAAAAAAAAAAAAAAAAAAAAAAAAAAAAAAAAAQAAAAAAAAAAAAAAAAAAAAAAAAAAAAAAAAAAAAAAAAAAAAAAAAAAAAEAAAAAnAEAAAAAAAAIAAAAMjUwMTIyLjCJAQAAeyJ3YXNfZmlyc3RfZXZlbnQiOmZhbHNlLCJpbWFnZV9pZCI6WzI5NDg2MzA3OTIsMjQ4MjEzNjcxMSwxNTEyNjE4NjkyLDMxOTcwODI0MTgsODIwOTYzODY4LDQ2MzI0MzAwNSwyODE1MTMwMDQ1LDM4MzUzNTQ2NTddLCJxZiI6eyJiIjpbMCw0LDAsMCwwLDAsMCwwLDAsMCwwLDAsMCwwLDAsMCwzMiwwLDEyOCw5MCwxNzMsODYsMTcxLDIxMywxMDYsMTgxLDkwLDE3Myw4NiwxNzEsMjEzLDEwNiwxODEsOTAsMTczLDg2LDE3MSwyMTMsMTA2LDE4MSw5MCwxNzMsODYsMTcxLDIxMywxMDYsMTgxLDkwLDE3Myw4NiwxNzEsMjEzLDEwNiwxODEsOTAsMTczLDg2LDE3MSwyMTMsMTA2LDE4MSw5MCwxNzMsODYsMTcxLDIxMywxMDYsMTgxLDkwLDE3Myw4NiwzLDBdLCJsIjo2MCwicSI6NiwiciI6N319AAAAAAAAAAAAAAAAAAAAnAEAAAAAAAAIAAAAMjUwMTIyLjCJAQAAeyJ3YXNfZmlyc3RfZXZlbnQiOmZhbHNlLCJpbWFnZV9pZCI6WzI5NDg2MzA3OTIsMjQ4MjEzNjcxMSwxNTEyNjE4NjkyLDMxOTcwODI0MTgsODIwOTYzODY4LDQ2MzI0MzAwNSwyODE1MTMwMDQ1LDM4MzUzNTQ2NTddLCJxZiI6eyJiIjpbMCw0LDAsMCwwLDAsMCwwLDAsMCwwLDAsMCwwLDAsMCwzMiwwLDEyOCw5MCwxNzMsODYsMTcxLDIxMywxMDYsMTgxLDkwLDE3Myw4NiwxNzEsMjEzLDEwNiwxODEsOTAsMTczLDg2LDE3MSwyMTMsMTA2LDE4MSw5MCwxNzMsODYsMTcxLDIxMywxMDYsMTgxLDkwLDE3Myw4NiwxNzEsMjEzLDEwNiwxODEsOTAsMTczLDg2LDE3MSwyMTMsMTA2LDE4MSw5MCwxNzMsODYsMTcxLDIxMywxMDYsMTgxLDkwLDE3Myw4NiwzLDBdLCJsIjo2MCwicSI6NiwiciI6N319AAAAAAAAAAAAAAAAAAAAAAAAAAAAAAAAAAAAAAAAAAAAAAA='}}
prove_97;61;26;Mul;1586;251708;251708.0;1025;0.07329483300054562;{'verificationValue': 251708.0, 'proof': {'imageId': [2948630792, 2482136711, 1512618692, 3197082418, 820963868, 463243005, 2815130045, 3835354657], 'receipt': 'AwAAAAAAAAAAAAAAxAciAPPsD8genbvcCN2DvDmorNgPyU2p6hAM/h+8IU0pSDuhAAAAAAAAAAAAAAAAAAAAAAAAAAAAAAAAAAAAAAAAAAAAAAAAAAAAAAAAAAAAAAAAAQAAAAAAAAAAAAAAAAAAAAAAAAAAAAAAAAAAAAAAAAAAAAAAAAAAAAEAAAAAnAEAAAAAAAAIAAAAMjUxNzA4LjCJAQAAeyJ3YXNfZmlyc3RfZXZlbnQiOmZhbHNlLCJpbWFnZV9pZCI6WzI5NDg2MzA3OTIsMjQ4MjEzNjcxMSwxNTEyNjE4NjkyLDMxOTcwODI0MTgsODIwOTYzODY4LDQ2MzI0MzAwNSwyODE1MTMwMDQ1LDM4MzUzNTQ2NTddLCJxZiI6eyJiIjpbMCw0LDAsMCwwLDAsMCwwLDAsMCwwLDAsMCwwLDAsMCwzMiwwLDEyOCw5MCwxNzMsODYsMTcxLDIxMywxMDYsMTgxLDkwLDE3Myw4NiwxNzEsMjEzLDEwNiwxODEsOTAsMTczLDg2LDE3MSwyMTMsMTA2LDE4MSw5MCwxNzMsODYsMTcxLDIxMywxMDYsMTgxLDkwLDE3Myw4NiwxNzEsMjEzLDEwNiwxODEsOTAsMTczLDg2LDE3MSwyMTMsMTA2LDE4MSw5MCwxNzMsODYsMTcxLDIxMywxMDYsMTgxLDkwLDE3Myw4NiwzLDBdLCJsIjo2MCwicSI6NiwiciI6N319AAAAAAAAAAAAAAAAAAAAnAEAAAAAAAAIAAAAMjUxNzA4LjCJAQAAeyJ3YXNfZmlyc3RfZXZlbnQiOmZhbHNlLCJpbWFnZV9pZCI6WzI5NDg2MzA3OTIsMjQ4MjEzNjcxMSwxNTEyNjE4NjkyLDMxOTcwODI0MTgsODIwOTYzODY4LDQ2MzI0MzAwNSwyODE1MTMwMDQ1LDM4MzUzNTQ2NTddLCJxZiI6eyJiIjpbMCw0LDAsMCwwLDAsMCwwLDAsMCwwLDAsMCwwLDAsMCwzMiwwLDEyOCw5MCwxNzMsODYsMTcxLDIxMywxMDYsMTgxLDkwLDE3Myw4NiwxNzEsMjEzLDEwNiwxODEsOTAsMTczLDg2LDE3MSwyMTMsMTA2LDE4MSw5MCwxNzMsODYsMTcxLDIxMywxMDYsMTgxLDkwLDE3Myw4NiwxNzEsMjEzLDEwNiwxODEsOTAsMTczLDg2LDE3MSwyMTMsMTA2LDE4MSw5MCwxNzMsODYsMTcxLDIxMywxMDYsMTgxLDkwLDE3Myw4NiwzLDBdLCJsIjo2MCwicSI6NiwiciI6N319AAAAAAAAAAAAAAAAAAAAAAAAAAAAAAAAAAAAAAAAAAAAAAA='}}
prove_98;50;72;Mul;3600;255308;255308.0;1025;0.07254904199908196;{'verificationValue': 255308.0, 'proof': {'imageId': [2948630792, 2482136711, 1512618692, 3197082418, 820963868, 463243005, 2815130045, 3835354657], 'receipt': 'AwAAAAAAAAAAAAAAxAciAPPsD8genbvcCN2DvDmorNgPyU2p6hAM/h+8IU0pSDuhAAAAAAAAAAAAAAAAAAAAAAAAAAAAAAAAAAAAAAAAAAAAAAAAAAAAAAAAAAAAAAAAAQAAAAAAAAAAAAAAAAAAAAAAAAAAAAAAAAAAAAAAAAAAAAAAAAAAAAEAAAAAnAEAAAAAAAAIAAAAMjU1MzA4LjCJAQAAeyJ3YXNfZmlyc3RfZXZlbnQiOmZhbHNlLCJpbWFnZV9pZCI6WzI5NDg2MzA3OTIsMjQ4MjEzNjcxMSwxNTEyNjE4NjkyLDMxOTcwODI0MTgsODIwOTYzODY4LDQ2MzI0MzAwNSwyODE1MTMwMDQ1LDM4MzUzNTQ2NTddLCJxZiI6eyJiIjpbMCw0LDAsMCwwLDAsMCwwLDAsMCwwLDAsMCwwLDAsMCwzMiwwLDEyOCw5MCwxNzMsODYsMTcxLDIxMywxMDYsMTgxLDkwLDE3Myw4NiwxNzEsMjEzLDEwNiwxODEsOTAsMTczLDg2LDE3MSwyMTMsMTA2LDE4MSw5MCwxNzMsODYsMTcxLDIxMywxMDYsMTgxLDkwLDE3Myw4NiwxNzEsMjEzLDEwNiwxODEsOTAsMTczLDg2LDE3MSwyMTMsMTA2LDE4MSw5MCwxNzMsODYsMTcxLDIxMywxMDYsMTgxLDkwLDE3Myw4NiwzLDBdLCJsIjo2MCwicSI6NiwiciI6N319AAAAAAAAAAAAAAAAAAAAnAEAAAAAAAAIAAAAMjU1MzA4LjCJAQAAeyJ3YXNfZmlyc3RfZXZlbnQiOmZhbHNlLCJpbWFnZV9pZCI6WzI5NDg2MzA3OTIsMjQ4MjEzNjcxMSwxNTEyNjE4NjkyLDMxOTcwODI0MTgsODIwOTYzODY4LDQ2MzI0MzAwNSwyODE1MTMwMDQ1LDM4MzUzNTQ2NTddLCJxZiI6eyJiIjpbMCw0LDAsMCwwLDAsMCwwLDAsMCwwLDAsMCwwLDAsMCwzMiwwLDEyOCw5MCwxNzMsODYsMTcxLDIxMywxMDYsMTgxLDkwLDE3Myw4NiwxNzEsMjEzLDEwNiwxODEsOTAsMTczLDg2LDE3MSwyMTMsMTA2LDE4MSw5MCwxNzMsODYsMTcxLDIxMywxMDYsMTgxLDkwLDE3Myw4NiwxNzEsMjEzLDEwNiwxODEsOTAsMTczLDg2LDE3MSwyMTMsMTA2LDE4MSw5MCwxNzMsODYsMTcxLDIxMywxMDYsMTgxLDkwLDE3Myw4NiwzLDBdLCJsIjo2MCwicSI6NiwiciI6N319AAAAAAAAAAAAAAAAAAAAAAAAAAAAAAAAAAAAAAAAAAAAAAA='}}
prove_99;54;34;Mul;1836;257144;257144.0;1025;0.0735051250012475;{'verificationValue': 257144.0, 'proof': {'imageId': [2948630792, 2482136711, 1512618692, 3197082418, 820963868, 463243005, 2815130045, 3835354657], 'receipt': 'AwAAAAAAAAAAAAAAxAciAPPsD8genbvcCN2DvDmorNgPyU2p6hAM/h+8IU0pSDuhAAAAAAAAAAAAAAAAAAAAAAAAAAAAAAAAAAAAAAAAAAAAAAAAAAAAAAAAAAAAAAAAAQAAAAAAAAAAAAAAAAAAAAAAAAAAAAAAAAAAAAAAAAAAAAAAAAAAAAEAAAAAnAEAAAAAAAAIAAAAMjU3MTQ0LjCJAQAAeyJ3YXNfZmlyc3RfZXZlbnQiOmZhbHNlLCJpbWFnZV9pZCI6WzI5NDg2MzA3OTIsMjQ4MjEzNjcxMSwxNTEyNjE4NjkyLDMxOTcwODI0MTgsODIwOTYzODY4LDQ2MzI0MzAwNSwyODE1MTMwMDQ1LDM4MzUzNTQ2NTddLCJxZiI6eyJiIjpbMCw0LDAsMCwwLDAsMCwwLDAsMCwwLDAsMCwwLDAsMCwzMiwwLDEyOCw5MCwxNzMsODYsMTcxLDIxMywxMDYsMTgxLDkwLDE3Myw4NiwxNzEsMjEzLDEwNiwxODEsOTAsMTczLDg2LDE3MSwyMTMsMTA2LDE4MSw5MCwxNzMsODYsMTcxLDIxMywxMDYsMTgxLDkwLDE3Myw4NiwxNzEsMjEzLDEwNiwxODEsOTAsMTczLDg2LDE3MSwyMTMsMTA2LDE4MSw5MCwxNzMsODYsMTcxLDIxMywxMDYsMTgxLDkwLDE3Myw4NiwzLDBdLCJsIjo2MCwicSI6NiwiciI6N319AAAAAAAAAAAAAAAAAAAAnAEAAAAAAAAIAAAAMjU3MTQ0LjCJAQAAeyJ3YXNfZmlyc3RfZXZlbnQiOmZhbHNlLCJpbWFnZV9pZCI6WzI5NDg2MzA3OTIsMjQ4MjEzNjcxMSwxNTEyNjE4NjkyLDMxOTcwODI0MTgsODIwOTYzODY4LDQ2MzI0MzAwNSwyODE1MTMwMDQ1LDM4MzUzNTQ2NTddLCJxZiI6eyJiIjpbMCw0LDAsMCwwLDAsMCwwLDAsMCwwLDAsMCwwLDAsMCwzMiwwLDEyOCw5MCwxNzMsODYsMTcxLDIxMywxMDYsMTgxLDkwLDE3Myw4NiwxNzEsMjEzLDEwNiwxODEsOTAsMTczLDg2LDE3MSwyMTMsMTA2LDE4MSw5MCwxNzMsODYsMTcxLDIxMywxMDYsMTgxLDkwLDE3Myw4NiwxNzEsMjEzLDEwNiwxODEsOTAsMTczLDg2LDE3MSwyMTMsMTA2LDE4MSw5MCwxNzMsODYsMTcxLDIxMywxMDYsMTgxLDkwLDE3Myw4NiwzLDBdLCJsIjo2MCwicSI6NiwiciI6N319AAAAAAAAAAAAAAAAAAAAAAAAAAAAAAAAAAAAAAAAAAAAAAA='}}
