;a;b;operation;calculated;cumulative;result;proof_size;seconds;response
prove_0;92;2;Mul;184;184;184.0;841;0.10115379200033203;{'verificationValue': 184.0, 'proof': {'imageId': [2948630792, 2482136711, 1512618692, 3197082418, 820963868, 463243005, 2815130045, 3835354657], 'receipt': 'AwAAAAAAAAAAAAAAxAciAPPsD8genbvcCN2DvDmorNgPyU2p6hAM/h+8IU0pSDuhAAAAAAAAAAAAAAAAAAAAAAAAAAAAAAAAAAAAAAAAAAAAAAAAAAAAAAAAAAAAAAAAAQAAAAAAAAAAAAAAAAAAAAAAAAAAAAAAAAAAAAAAAAAAAAAAAAAAAAEAAAAAQAEAAAAAAAAFAAAAMTg0LjAAAAAvAQAAeyJ3YXNfZmlyc3RfZXZlbnQiOnRydWUsImltYWdlX2lkIjpbMjk0ODYzMDc5MiwyNDgyMTM2NzExLDE1MTI2MTg2OTIsMzE5NzA4MjQxOCw4MjA5NjM4NjgsNDYzMjQzMDA1LDI4MTUxMzAwNDUsMzgzNTM1NDY1N10sInFmIjp7ImIiOlswLDQsMCwwLDAsMCwwLDAsMCw0LDAsMCwwLDAsMCwwLDAsMCwxMjgsMjYsMCwwLDAsMCwwLDAsMCwwLDAsMCwwLDAsMCwwLDAsMCwwLDAsMCwwLDAsMCwwLDAsMCwwLDAsMCwwLDAsMCwwLDAsMCwwLDAsMCwwLDAsMCwwLDAsMCwwLDAsMCwwLDAsMCwwLDAsMCwwXSwibCI6MSwicSI6NiwiciI6N319AAAAAAAAAAAAAAAAAEABAAAAAAAABQAAADE4NC4wAAAALwEAAHsid2FzX2ZpcnN0X2V2ZW50Ijp0cnVlLCJpbWFnZV9pZCI6WzI5NDg2MzA3OTIsMjQ4MjEzNjcxMSwxNTEyNjE4NjkyLDMxOTcwODI0MTgsODIwOTYzODY4LDQ2MzI0MzAwNSwyODE1MTMwMDQ1LDM4MzUzNTQ2NTddLCJxZiI6eyJiIjpbMCw0LDAsMCwwLDAsMCwwLDAsNCwwLDAsMCwwLDAsMCwwLDAsMTI4LDI2LDAsMCwwLDAsMCwwLDAsMCwwLDAsMCwwLDAsMCwwLDAsMCwwLDAsMCwwLDAsMCwwLDAsMCwwLDAsMCwwLDAsMCwwLDAsMCwwLDAsMCwwLDAsMCwwLDAsMCwwLDAsMCwwLDAsMCwwLDAsMF0sImwiOjEsInEiOjYsInIiOjd9fQAAAAAAAAAAAAAAAAAAAAAAAAAAAAAAAAAAAAAAAAAAAA=='}}
prove_1;8;9;Mul;72;256;72.0;833;0.06839416700131551;{'verificationValue': 72.0, 'proof': {'imageId': [2948630792, 2482136711, 1512618692, 3197082418, 820963868, 463243005, 2815130045, 3835354657], 'receipt': 'AwAAAAAAAAAAAAAAxAciAPPsD8genbvcCN2DvDmorNgPyU2p6hAM/h+8IU0pSDuhAAAAAAAAAAAAAAAAAAAAAAAAAAAAAAAAAAAAAAAAAAAAAAAAAAAAAAAAAAAAAAAAAQAAAAAAAAAAAAAAAAAAAAAAAAAAAAAAAAAAAAAAAAAAAAAAAAAAAAEAAAAAPAEAAAAAAAAEAAAANzIuMC8BAAB7Indhc19maXJzdF9ldmVudCI6dHJ1ZSwiaW1hZ2VfaWQiOlsyOTQ4NjMwNzkyLDI0ODIxMzY3MTEsMTUxMjYxODY5MiwzMTk3MDgyNDE4LDgyMDk2Mzg2OCw0NjMyNDMwMDUsMjgxNTEzMDA0NSwzODM1MzU0NjU3XSwicWYiOnsiYiI6WzAsNCwwLDAsMCwwLDAsMCwwLDQsMCwwLDAsMCwwLDAsMCwwLDEyOCwyNiwwLDAsMCwwLDAsMCwwLDAsMCwwLDAsMCwwLDAsMCwwLDAsMCwwLDAsMCwwLDAsMCwwLDAsMCwwLDAsMCwwLDAsMCwwLDAsMCwwLDAsMCwwLDAsMCwwLDAsMCwwLDAsMCwwLDAsMCwwLDBdLCJsIjoxLCJxIjo2LCJyIjo3fX0AAAAAAAAAAAAAAAAAPAEAAAAAAAAEAAAANzIuMC8BAAB7Indhc19maXJzdF9ldmVudCI6dHJ1ZSwiaW1hZ2VfaWQiOlsyOTQ4NjMwNzkyLDI0ODIxMzY3MTEsMTUxMjYxODY5MiwzMTk3MDgyNDE4LDgyMDk2Mzg2OCw0NjMyNDMwMDUsMjgxNTEzMDA0NSwzODM1MzU0NjU3XSwicWYiOnsiYiI6WzAsNCwwLDAsMCwwLDAsMCwwLDQsMCwwLDAsMCwwLDAsMCwwLDEyOCwyNiwwLDAsMCwwLDAsMCwwLDAsMCwwLDAsMCwwLDAsMCwwLDAsMCwwLDAsMCwwLDAsMCwwLDAsMCwwLDAsMCwwLDAsMCwwLDAsMCwwLDAsMCwwLDAsMCwwLDAsMCwwLDAsMCwwLDAsMCwwLDBdLCJsIjoxLCJxIjo2LCJyIjo3fX0AAAAAAAAAAAAAAAAAAAAAAAAAAAAAAAAAAAAAAAAAAAA='}}
prove_2;68;16;Mul;1088;1344;1088.0;841;0.06966975000068487;{'verificationValue': 1088.0, 'proof': {'imageId': [2948630792, 2482136711, 1512618692, 3197082418, 820963868, 463243005, 2815130045, 3835354657], 'receipt': 'AwAAAAAAAAAAAAAAxAciAPPsD8genbvcCN2DvDmorNgPyU2p6hAM/h+8IU0pSDuhAAAAAAAAAAAAAAAAAAAAAAAAAAAAAAAAAAAAAAAAAAAAAAAAAAAAAAAAAAAAAAAAAQAAAAAAAAAAAAAAAAAAAAAAAAAAAAAAAAAAAAAAAAAAAAAAAAAAAAEAAAAAQAEAAAAAAAAGAAAAMTA4OC4wAAAvAQAAeyJ3YXNfZmlyc3RfZXZlbnQiOnRydWUsImltYWdlX2lkIjpbMjk0ODYzMDc5MiwyNDgyMTM2NzExLDE1MTI2MTg2OTIsMzE5NzA4MjQxOCw4MjA5NjM4NjgsNDYzMjQzMDA1LDI4MTUxMzAwNDUsMzgzNTM1NDY1N10sInFmIjp7ImIiOlswLDQsMCwwLDAsMCwwLDAsMCw0LDAsMCwwLDAsMCwwLDAsMCwxMjgsMjYsMCwwLDAsMCwwLDAsMCwwLDAsMCwwLDAsMCwwLDAsMCwwLDAsMCwwLDAsMCwwLDAsMCwwLDAsMCwwLDAsMCwwLDAsMCwwLDAsMCwwLDAsMCwwLDAsMCwwLDAsMCwwLDAsMCwwLDAsMCwwXSwibCI6MSwicSI6NiwiciI6N319AAAAAAAAAAAAAAAAAEABAAAAAAAABgAAADEwODguMAAALwEAAHsid2FzX2ZpcnN0X2V2ZW50Ijp0cnVlLCJpbWFnZV9pZCI6WzI5NDg2MzA3OTIsMjQ4MjEzNjcxMSwxNTEyNjE4NjkyLDMxOTcwODI0MTgsODIwOTYzODY4LDQ2MzI0MzAwNSwyODE1MTMwMDQ1LDM4MzUzNTQ2NTddLCJxZiI6eyJiIjpbMCw0LDAsMCwwLDAsMCwwLDAsNCwwLDAsMCwwLDAsMCwwLDAsMTI4LDI2LDAsMCwwLDAsMCwwLDAsMCwwLDAsMCwwLDAsMCwwLDAsMCwwLDAsMCwwLDAsMCwwLDAsMCwwLDAsMCwwLDAsMCwwLDAsMCwwLDAsMCwwLDAsMCwwLDAsMCwwLDAsMCwwLDAsMCwwLDAsMF0sImwiOjEsInEiOjYsInIiOjd9fQAAAAAAAAAAAAAAAAAAAAAAAAAAAAAAAAAAAAAAAAAAAA=='}}
prove_3;54;58;Mul;3132;4476;3132.0;841;0.0686866670002928;{'verificationValue': 3132.0, 'proof': {'imageId': [2948630792, 2482136711, 1512618692, 3197082418, 820963868, 463243005, 2815130045, 3835354657], 'receipt': 'AwAAAAAAAAAAAAAAxAciAPPsD8genbvcCN2DvDmorNgPyU2p6hAM/h+8IU0pSDuhAAAAAAAAAAAAAAAAAAAAAAAAAAAAAAAAAAAAAAAAAAAAAAAAAAAAAAAAAAAAAAAAAQAAAAAAAAAAAAAAAAAAAAAAAAAAAAAAAAAAAAAAAAAAAAAAAAAAAAEAAAAAQAEAAAAAAAAGAAAAMzEzMi4wAAAvAQAAeyJ3YXNfZmlyc3RfZXZlbnQiOnRydWUsImltYWdlX2lkIjpbMjk0ODYzMDc5MiwyNDgyMTM2NzExLDE1MTI2MTg2OTIsMzE5NzA4MjQxOCw4MjA5NjM4NjgsNDYzMjQzMDA1LDI4MTUxMzAwNDUsMzgzNTM1NDY1N10sInFmIjp7ImIiOlswLDQsMCwwLDAsMCwwLDAsMCw0LDAsMCwwLDAsMCwwLDAsMCwxMjgsMjYsMCwwLDAsMCwwLDAsMCwwLDAsMCwwLDAsMCwwLDAsMCwwLDAsMCwwLDAsMCwwLDAsMCwwLDAsMCwwLDAsMCwwLDAsMCwwLDAsMCwwLDAsMCwwLDAsMCwwLDAsMCwwLDAsMCwwLDAsMCwwXSwibCI6MSwicSI6NiwiciI6N319AAAAAAAAAAAAAAAAAEABAAAAAAAABgAAADMxMzIuMAAALwEAAHsid2FzX2ZpcnN0X2V2ZW50Ijp0cnVlLCJpbWFnZV9pZCI6WzI5NDg2MzA3OTIsMjQ4MjEzNjcxMSwxNTEyNjE4NjkyLDMxOTcwODI0MTgsODIwOTYzODY4LDQ2MzI0MzAwNSwyODE1MTMwMDQ1LDM4MzUzNTQ2NTddLCJxZiI6eyJiIjpbMCw0LDAsMCwwLDAsMCwwLDAsNCwwLDAsMCwwLDAsMCwwLDAsMTI4LDI2LDAsMCwwLDAsMCwwLDAsMCwwLDAsMCwwLDAsMCwwLDAsMCwwLDAsMCwwLDAsMCwwLDAsMCwwLDAsMCwwLDAsMCwwLDAsMCwwLDAsMCwwLDAsMCwwLDAsMCwwLDAsMCwwLDAsMCwwLDAsMF0sImwiOjEsInEiOjYsInIiOjd9fQAAAAAAAAAAAAAAAAAAAAAAAAAAAAAAAAAAAAAAAAAAAA=='}}
prove_4;20;59;Mul;1180;5656;1180.0;841;0.06885795900052472;{'verificationValue': 1180.0, 'proof': {'imageId': [2948630792, 2482136711, 1512618692, 3197082418, 820963868, 463243005, 2815130045, 3835354657], 'receipt': 'AwAAAAAAAAAAAAAAxAciAPPsD8genbvcCN2DvDmorNgPyU2p6hAM/h+8IU0pSDuhAAAAAAAAAAAAAAAAAAAAAAAAAAAAAAAAAAAAAAAAAAAAAAAAAAAAAAAAAAAAAAAAAQAAAAAAAAAAAAAAAAAAAAAAAAAAAAAAAAAAAAAAAAAAAAAAAAAAAAEAAAAAQAEAAAAAAAAGAAAAMTE4MC4wAAAvAQAAeyJ3YXNfZmlyc3RfZXZlbnQiOnRydWUsImltYWdlX2lkIjpbMjk0ODYzMDc5MiwyNDgyMTM2NzExLDE1MTI2MTg2OTIsMzE5NzA4MjQxOCw4MjA5NjM4NjgsNDYzMjQzMDA1LDI4MTUxMzAwNDUsMzgzNTM1NDY1N10sInFmIjp7ImIiOlswLDQsMCwwLDAsMCwwLDAsMCw0LDAsMCwwLDAsMCwwLDAsMCwxMjgsMjYsMCwwLDAsMCwwLDAsMCwwLDAsMCwwLDAsMCwwLDAsMCwwLDAsMCwwLDAsMCwwLDAsMCwwLDAsMCwwLDAsMCwwLDAsMCwwLDAsMCwwLDAsMCwwLDAsMCwwLDAsMCwwLDAsMCwwLDAsMCwwXSwibCI6MSwicSI6NiwiciI6N319AAAAAAAAAAAAAAAAAEABAAAAAAAABgAAADExODAuMAAALwEAAHsid2FzX2ZpcnN0X2V2ZW50Ijp0cnVlLCJpbWFnZV9pZCI6WzI5NDg2MzA3OTIsMjQ4MjEzNjcxMSwxNTEyNjE4NjkyLDMxOTcwODI0MTgsODIwOTYzODY4LDQ2MzI0MzAwNSwyODE1MTMwMDQ1LDM4MzUzNTQ2NTddLCJxZiI6eyJiIjpbMCw0LDAsMCwwLDAsMCwwLDAsNCwwLDAsMCwwLDAsMCwwLDAsMTI4LDI2LDAsMCwwLDAsMCwwLDAsMCwwLDAsMCwwLDAsMCwwLDAsMCwwLDAsMCwwLDAsMCwwLDAsMCwwLDAsMCwwLDAsMCwwLDAsMCwwLDAsMCwwLDAsMCwwLDAsMCwwLDAsMCwwLDAsMCwwLDAsMF0sImwiOjEsInEiOjYsInIiOjd9fQAAAAAAAAAAAAAAAAAAAAAAAAAAAAAAAAAAAAAAAAAAAA=='}}
prove_5;52;15;Mul;780;6436;780.0;841;0.06964362500002608;{'verificationValue': 780.0, 'proof': {'imageId': [2948630792, 2482136711, 1512618692, 3197082418, 820963868, 463243005, 2815130045, 3835354657], 'receipt': 'AwAAAAAAAAAAAAAAxAciAPPsD8genbvcCN2DvDmorNgPyU2p6hAM/h+8IU0pSDuhAAAAAAAAAAAAAAAAAAAAAAAAAAAAAAAAAAAAAAAAAAAAAAAAAAAAAAAAAAAAAAAAAQAAAAAAAAAAAAAAAAAAAAAAAAAAAAAAAAAAAAAAAAAAAAAAAAAAAAEAAAAAQAEAAAAAAAAFAAAANzgwLjAAAAAvAQAAeyJ3YXNfZmlyc3RfZXZlbnQiOnRydWUsImltYWdlX2lkIjpbMjk0ODYzMDc5MiwyNDgyMTM2NzExLDE1MTI2MTg2OTIsMzE5NzA4MjQxOCw4MjA5NjM4NjgsNDYzMjQzMDA1LDI4MTUxMzAwNDUsMzgzNTM1NDY1N10sInFmIjp7ImIiOlswLDQsMCwwLDAsMCwwLDAsMCw0LDAsMCwwLDAsMCwwLDAsMCwxMjgsMjYsMCwwLDAsMCwwLDAsMCwwLDAsMCwwLDAsMCwwLDAsMCwwLDAsMCwwLDAsMCwwLDAsMCwwLDAsMCwwLDAsMCwwLDAsMCwwLDAsMCwwLDAsMCwwLDAsMCwwLDAsMCwwLDAsMCwwLDAsMCwwXSwibCI6MSwicSI6NiwiciI6N319AAAAAAAAAAAAAAAAAEABAAAAAAAABQAAADc4MC4wAAAALwEAAHsid2FzX2ZpcnN0X2V2ZW50Ijp0cnVlLCJpbWFnZV9pZCI6WzI5NDg2MzA3OTIsMjQ4MjEzNjcxMSwxNTEyNjE4NjkyLDMxOTcwODI0MTgsODIwOTYzODY4LDQ2MzI0MzAwNSwyODE1MTMwMDQ1LDM4MzUzNTQ2NTddLCJxZiI6eyJiIjpbMCw0LDAsMCwwLDAsMCwwLDAsNCwwLDAsMCwwLDAsMCwwLDAsMTI4LDI2LDAsMCwwLDAsMCwwLDAsMCwwLDAsMCwwLDAsMCwwLDAsMCwwLDAsMCwwLDAsMCwwLDAsMCwwLDAsMCwwLDAsMCwwLDAsMCwwLDAsMCwwLDAsMCwwLDAsMCwwLDAsMCwwLDAsMCwwLDAsMF0sImwiOjEsInEiOjYsInIiOjd9fQAAAAAAAAAAAAAAAAAAAAAAAAAAAAAAAAAAAAAAAAAAAA=='}}
prove_6;88;38;Mul;3344;9780;3344.0;841;0.06838620799862838;{'verificationValue': 3344.0, 'proof': {'imageId': [2948630792, 2482136711, 1512618692, 3197082418, 820963868, 463243005, 2815130045, 3835354657], 'receipt': 'AwAAAAAAAAAAAAAAxAciAPPsD8genbvcCN2DvDmorNgPyU2p6hAM/h+8IU0pSDuhAAAAAAAAAAAAAAAAAAAAAAAAAAAAAAAAAAAAAAAAAAAAAAAAAAAAAAAAAAAAAAAAAQAAAAAAAAAAAAAAAAAAAAAAAAAAAAAAAAAAAAAAAAAAAAAAAAAAAAEAAAAAQAEAAAAAAAAGAAAAMzM0NC4wAAAvAQAAeyJ3YXNfZmlyc3RfZXZlbnQiOnRydWUsImltYWdlX2lkIjpbMjk0ODYzMDc5MiwyNDgyMTM2NzExLDE1MTI2MTg2OTIsMzE5NzA4MjQxOCw4MjA5NjM4NjgsNDYzMjQzMDA1LDI4MTUxMzAwNDUsMzgzNTM1NDY1N10sInFmIjp7ImIiOlswLDQsMCwwLDAsMCwwLDAsMCw0LDAsMCwwLDAsMCwwLDAsMCwxMjgsMjYsMCwwLDAsMCwwLDAsMCwwLDAsMCwwLDAsMCwwLDAsMCwwLDAsMCwwLDAsMCwwLDAsMCwwLDAsMCwwLDAsMCwwLDAsMCwwLDAsMCwwLDAsMCwwLDAsMCwwLDAsMCwwLDAsMCwwLDAsMCwwXSwibCI6MSwicSI6NiwiciI6N319AAAAAAAAAAAAAAAAAEABAAAAAAAABgAAADMzNDQuMAAALwEAAHsid2FzX2ZpcnN0X2V2ZW50Ijp0cnVlLCJpbWFnZV9pZCI6WzI5NDg2MzA3OTIsMjQ4MjEzNjcxMSwxNTEyNjE4NjkyLDMxOTcwODI0MTgsODIwOTYzODY4LDQ2MzI0MzAwNSwyODE1MTMwMDQ1LDM4MzUzNTQ2NTddLCJxZiI6eyJiIjpbMCw0LDAsMCwwLDAsMCwwLDAsNCwwLDAsMCwwLDAsMCwwLDAsMTI4LDI2LDAsMCwwLDAsMCwwLDAsMCwwLDAsMCwwLDAsMCwwLDAsMCwwLDAsMCwwLDAsMCwwLDAsMCwwLDAsMCwwLDAsMCwwLDAsMCwwLDAsMCwwLDAsMCwwLDAsMCwwLDAsMCwwLDAsMCwwLDAsMF0sImwiOjEsInEiOjYsInIiOjd9fQAAAAAAAAAAAAAAAAAAAAAAAAAAAAAAAAAAAAAAAAAAAA=='}}
prove_7;89;61;Mul;5429;15209;5429.0;841;0.06961962500099617;{'verificationValue': 5429.0, 'proof': {'imageId': [2948630792, 2482136711, 1512618692, 3197082418, 820963868, 463243005, 2815130045, 3835354657], 'receipt': 'AwAAAAAAAAAAAAAAxAciAPPsD8genbvcCN2DvDmorNgPyU2p6hAM/h+8IU0pSDuhAAAAAAAAAAAAAAAAAAAAAAAAAAAAAAAAAAAAAAAAAAAAAAAAAAAAAAAAAAAAAAAAAQAAAAAAAAAAAAAAAAAAAAAAAAAAAAAAAAAAAAAAAAAAAAAAAAAAAAEAAAAAQAEAAAAAAAAGAAAANTQyOS4wAAAvAQAAeyJ3YXNfZmlyc3RfZXZlbnQiOnRydWUsImltYWdlX2lkIjpbMjk0ODYzMDc5MiwyNDgyMTM2NzExLDE1MTI2MTg2OTIsMzE5NzA4MjQxOCw4MjA5NjM4NjgsNDYzMjQzMDA1LDI4MTUxMzAwNDUsMzgzNTM1NDY1N10sInFmIjp7ImIiOlswLDQsMCwwLDAsMCwwLDAsMCw0LDAsMCwwLDAsMCwwLDAsMCwxMjgsMjYsMCwwLDAsMCwwLDAsMCwwLDAsMCwwLDAsMCwwLDAsMCwwLDAsMCwwLDAsMCwwLDAsMCwwLDAsMCwwLDAsMCwwLDAsMCwwLDAsMCwwLDAsMCwwLDAsMCwwLDAsMCwwLDAsMCwwLDAsMCwwXSwibCI6MSwicSI6NiwiciI6N319AAAAAAAAAAAAAAAAAEABAAAAAAAABgAAADU0MjkuMAAALwEAAHsid2FzX2ZpcnN0X2V2ZW50Ijp0cnVlLCJpbWFnZV9pZCI6WzI5NDg2MzA3OTIsMjQ4MjEzNjcxMSwxNTEyNjE4NjkyLDMxOTcwODI0MTgsODIwOTYzODY4LDQ2MzI0MzAwNSwyODE1MTMwMDQ1LDM4MzUzNTQ2NTddLCJxZiI6eyJiIjpbMCw0LDAsMCwwLDAsMCwwLDAsNCwwLDAsMCwwLDAsMCwwLDAsMTI4LDI2LDAsMCwwLDAsMCwwLDAsMCwwLDAsMCwwLDAsMCwwLDAsMCwwLDAsMCwwLDAsMCwwLDAsMCwwLDAsMCwwLDAsMCwwLDAsMCwwLDAsMCwwLDAsMCwwLDAsMCwwLDAsMCwwLDAsMCwwLDAsMF0sImwiOjEsInEiOjYsInIiOjd9fQAAAAAAAAAAAAAAAAAAAAAAAAAAAAAAAAAAAAAAAAAAAA=='}}
prove_8;3;72;Mul;216;15425;216.0;841;0.0690734590007196;{'verificationValue': 216.0, 'proof': {'imageId': [2948630792, 2482136711, 1512618692, 3197082418, 820963868, 463243005, 2815130045, 3835354657], 'receipt': 'AwAAAAAAAAAAAAAAxAciAPPsD8genbvcCN2DvDmorNgPyU2p6hAM/h+8IU0pSDuhAAAAAAAAAAAAAAAAAAAAAAAAAAAAAAAAAAAAAAAAAAAAAAAAAAAAAAAAAAAAAAAAAQAAAAAAAAAAAAAAAAAAAAAAAAAAAAAAAAAAAAAAAAAAAAAAAAAAAAEAAAAAQAEAAAAAAAAFAAAAMjE2LjAAAAAvAQAAeyJ3YXNfZmlyc3RfZXZlbnQiOnRydWUsImltYWdlX2lkIjpbMjk0ODYzMDc5MiwyNDgyMTM2NzExLDE1MTI2MTg2OTIsMzE5NzA4MjQxOCw4MjA5NjM4NjgsNDYzMjQzMDA1LDI4MTUxMzAwNDUsMzgzNTM1NDY1N10sInFmIjp7ImIiOlswLDQsMCwwLDAsMCwwLDAsMCw0LDAsMCwwLDAsMCwwLDAsMCwxMjgsMjYsMCwwLDAsMCwwLDAsMCwwLDAsMCwwLDAsMCwwLDAsMCwwLDAsMCwwLDAsMCwwLDAsMCwwLDAsMCwwLDAsMCwwLDAsMCwwLDAsMCwwLDAsMCwwLDAsMCwwLDAsMCwwLDAsMCwwLDAsMCwwXSwibCI6MSwicSI6NiwiciI6N319AAAAAAAAAAAAAAAAAEABAAAAAAAABQAAADIxNi4wAAAALwEAAHsid2FzX2ZpcnN0X2V2ZW50Ijp0cnVlLCJpbWFnZV9pZCI6WzI5NDg2MzA3OTIsMjQ4MjEzNjcxMSwxNTEyNjE4NjkyLDMxOTcwODI0MTgsODIwOTYzODY4LDQ2MzI0MzAwNSwyODE1MTMwMDQ1LDM4MzUzNTQ2NTddLCJxZiI6eyJiIjpbMCw0LDAsMCwwLDAsMCwwLDAsNCwwLDAsMCwwLDAsMCwwLDAsMTI4LDI2LDAsMCwwLDAsMCwwLDAsMCwwLDAsMCwwLDAsMCwwLDAsMCwwLDAsMCwwLDAsMCwwLDAsMCwwLDAsMCwwLDAsMCwwLDAsMCwwLDAsMCwwLDAsMCwwLDAsMCwwLDAsMCwwLDAsMCwwLDAsMF0sImwiOjEsInEiOjYsInIiOjd9fQAAAAAAAAAAAAAAAAAAAAAAAAAAAAAAAAAAAAAAAAAAAA=='}}
prove_9;2;77;Mul;154;15579;154.0;841;0.0696962080000958;{'verificationValue': 154.0, 'proof': {'imageId': [2948630792, 2482136711, 1512618692, 3197082418, 820963868, 463243005, 2815130045, 3835354657], 'receipt': 'AwAAAAAAAAAAAAAAxAciAPPsD8genbvcCN2DvDmorNgPyU2p6hAM/h+8IU0pSDuhAAAAAAAAAAAAAAAAAAAAAAAAAAAAAAAAAAAAAAAAAAAAAAAAAAAAAAAAAAAAAAAAAQAAAAAAAAAAAAAAAAAAAAAAAAAAAAAAAAAAAAAAAAAAAAAAAAAAAAEAAAAAQAEAAAAAAAAFAAAAMTU0LjAAAAAvAQAAeyJ3YXNfZmlyc3RfZXZlbnQiOnRydWUsImltYWdlX2lkIjpbMjk0ODYzMDc5MiwyNDgyMTM2NzExLDE1MTI2MTg2OTIsMzE5NzA4MjQxOCw4MjA5NjM4NjgsNDYzMjQzMDA1LDI4MTUxMzAwNDUsMzgzNTM1NDY1N10sInFmIjp7ImIiOlswLDQsMCwwLDAsMCwwLDAsMCw0LDAsMCwwLDAsMCwwLDAsMCwxMjgsMjYsMCwwLDAsMCwwLDAsMCwwLDAsMCwwLDAsMCwwLDAsMCwwLDAsMCwwLDAsMCwwLDAsMCwwLDAsMCwwLDAsMCwwLDAsMCwwLDAsMCwwLDAsMCwwLDAsMCwwLDAsMCwwLDAsMCwwLDAsMCwwXSwibCI6MSwicSI6NiwiciI6N319AAAAAAAAAAAAAAAAAEABAAAAAAAABQAAADE1NC4wAAAALwEAAHsid2FzX2ZpcnN0X2V2ZW50Ijp0cnVlLCJpbWFnZV9pZCI6WzI5NDg2MzA3OTIsMjQ4MjEzNjcxMSwxNTEyNjE4NjkyLDMxOTcwODI0MTgsODIwOTYzODY4LDQ2MzI0MzAwNSwyODE1MTMwMDQ1LDM4MzUzNTQ2NTddLCJxZiI6eyJiIjpbMCw0LDAsMCwwLDAsMCwwLDAsNCwwLDAsMCwwLDAsMCwwLDAsMTI4LDI2LDAsMCwwLDAsMCwwLDAsMCwwLDAsMCwwLDAsMCwwLDAsMCwwLDAsMCwwLDAsMCwwLDAsMCwwLDAsMCwwLDAsMCwwLDAsMCwwLDAsMCwwLDAsMCwwLDAsMCwwLDAsMCwwLDAsMCwwLDAsMF0sImwiOjEsInEiOjYsInIiOjd9fQAAAAAAAAAAAAAAAAAAAAAAAAAAAAAAAAAAAAAAAAAAAA=='}}
prove_10;91;38;Mul;3458;19037;3458.0;841;0.06826850000106788;{'verificationValue': 3458.0, 'proof': {'imageId': [2948630792, 2482136711, 1512618692, 3197082418, 820963868, 463243005, 2815130045, 3835354657], 'receipt': 'AwAAAAAAAAAAAAAAxAciAPPsD8genbvcCN2DvDmorNgPyU2p6hAM/h+8IU0pSDuhAAAAAAAAAAAAAAAAAAAAAAAAAAAAAAAAAAAAAAAAAAAAAAAAAAAAAAAAAAAAAAAAAQAAAAAAAAAAAAAAAAAAAAAAAAAAAAAAAAAAAAAAAAAAAAAAAAAAAAEAAAAAQAEAAAAAAAAGAAAAMzQ1OC4wAAAvAQAAeyJ3YXNfZmlyc3RfZXZlbnQiOnRydWUsImltYWdlX2lkIjpbMjk0ODYzMDc5MiwyNDgyMTM2NzExLDE1MTI2MTg2OTIsMzE5NzA4MjQxOCw4MjA5NjM4NjgsNDYzMjQzMDA1LDI4MTUxMzAwNDUsMzgzNTM1NDY1N10sInFmIjp7ImIiOlswLDQsMCwwLDAsMCwwLDAsMCw0LDAsMCwwLDAsMCwwLDAsMCwxMjgsMjYsMCwwLDAsMCwwLDAsMCwwLDAsMCwwLDAsMCwwLDAsMCwwLDAsMCwwLDAsMCwwLDAsMCwwLDAsMCwwLDAsMCwwLDAsMCwwLDAsMCwwLDAsMCwwLDAsMCwwLDAsMCwwLDAsMCwwLDAsMCwwXSwibCI6MSwicSI6NiwiciI6N319AAAAAAAAAAAAAAAAAEABAAAAAAAABgAAADM0NTguMAAALwEAAHsid2FzX2ZpcnN0X2V2ZW50Ijp0cnVlLCJpbWFnZV9pZCI6WzI5NDg2MzA3OTIsMjQ4MjEzNjcxMSwxNTEyNjE4NjkyLDMxOTcwODI0MTgsODIwOTYzODY4LDQ2MzI0MzAwNSwyODE1MTMwMDQ1LDM4MzUzNTQ2NTddLCJxZiI6eyJiIjpbMCw0LDAsMCwwLDAsMCwwLDAsNCwwLDAsMCwwLDAsMCwwLDAsMTI4LDI2LDAsMCwwLDAsMCwwLDAsMCwwLDAsMCwwLDAsMCwwLDAsMCwwLDAsMCwwLDAsMCwwLDAsMCwwLDAsMCwwLDAsMCwwLDAsMCwwLDAsMCwwLDAsMCwwLDAsMCwwLDAsMCwwLDAsMCwwLDAsMF0sImwiOjEsInEiOjYsInIiOjd9fQAAAAAAAAAAAAAAAAAAAAAAAAAAAAAAAAAAAAAAAAAAAA=='}}
prove_11;30;19;Mul;570;19607;570.0;841;0.06907287500143866;{'verificationValue': 570.0, 'proof': {'imageId': [2948630792, 2482136711, 1512618692, 3197082418, 820963868, 463243005, 2815130045, 3835354657], 'receipt': 'AwAAAAAAAAAAAAAAxAciAPPsD8genbvcCN2DvDmorNgPyU2p6hAM/h+8IU0pSDuhAAAAAAAAAAAAAAAAAAAAAAAAAAAAAAAAAAAAAAAAAAAAAAAAAAAAAAAAAAAAAAAAAQAAAAAAAAAAAAAAAAAAAAAAAAAAAAAAAAAAAAAAAAAAAAAAAAAAAAEAAAAAQAEAAAAAAAAFAAAANTcwLjAAAAAvAQAAeyJ3YXNfZmlyc3RfZXZlbnQiOnRydWUsImltYWdlX2lkIjpbMjk0ODYzMDc5MiwyNDgyMTM2NzExLDE1MTI2MTg2OTIsMzE5NzA4MjQxOCw4MjA5NjM4NjgsNDYzMjQzMDA1LDI4MTUxMzAwNDUsMzgzNTM1NDY1N10sInFmIjp7ImIiOlswLDQsMCwwLDAsMCwwLDAsMCw0LDAsMCwwLDAsMCwwLDAsMCwxMjgsMjYsMCwwLDAsMCwwLDAsMCwwLDAsMCwwLDAsMCwwLDAsMCwwLDAsMCwwLDAsMCwwLDAsMCwwLDAsMCwwLDAsMCwwLDAsMCwwLDAsMCwwLDAsMCwwLDAsMCwwLDAsMCwwLDAsMCwwLDAsMCwwXSwibCI6MSwicSI6NiwiciI6N319AAAAAAAAAAAAAAAAAEABAAAAAAAABQAAADU3MC4wAAAALwEAAHsid2FzX2ZpcnN0X2V2ZW50Ijp0cnVlLCJpbWFnZV9pZCI6WzI5NDg2MzA3OTIsMjQ4MjEzNjcxMSwxNTEyNjE4NjkyLDMxOTcwODI0MTgsODIwOTYzODY4LDQ2MzI0MzAwNSwyODE1MTMwMDQ1LDM4MzUzNTQ2NTddLCJxZiI6eyJiIjpbMCw0LDAsMCwwLDAsMCwwLDAsNCwwLDAsMCwwLDAsMCwwLDAsMTI4LDI2LDAsMCwwLDAsMCwwLDAsMCwwLDAsMCwwLDAsMCwwLDAsMCwwLDAsMCwwLDAsMCwwLDAsMCwwLDAsMCwwLDAsMCwwLDAsMCwwLDAsMCwwLDAsMCwwLDAsMCwwLDAsMCwwLDAsMCwwLDAsMF0sImwiOjEsInEiOjYsInIiOjd9fQAAAAAAAAAAAAAAAAAAAAAAAAAAAAAAAAAAAAAAAAAAAA=='}}
prove_12;6;75;Mul;450;20057;450.0;841;0.08346520799932478;{'verificationValue': 450.0, 'proof': {'imageId': [2948630792, 2482136711, 1512618692, 3197082418, 820963868, 463243005, 2815130045, 3835354657], 'receipt': 'AwAAAAAAAAAAAAAAxAciAPPsD8genbvcCN2DvDmorNgPyU2p6hAM/h+8IU0pSDuhAAAAAAAAAAAAAAAAAAAAAAAAAAAAAAAAAAAAAAAAAAAAAAAAAAAAAAAAAAAAAAAAAQAAAAAAAAAAAAAAAAAAAAAAAAAAAAAAAAAAAAAAAAAAAAAAAAAAAAEAAAAAQAEAAAAAAAAFAAAANDUwLjAAAAAvAQAAeyJ3YXNfZmlyc3RfZXZlbnQiOnRydWUsImltYWdlX2lkIjpbMjk0ODYzMDc5MiwyNDgyMTM2NzExLDE1MTI2MTg2OTIsMzE5NzA4MjQxOCw4MjA5NjM4NjgsNDYzMjQzMDA1LDI4MTUxMzAwNDUsMzgzNTM1NDY1N10sInFmIjp7ImIiOlswLDQsMCwwLDAsMCwwLDAsMCw0LDAsMCwwLDAsMCwwLDAsMCwxMjgsMjYsMCwwLDAsMCwwLDAsMCwwLDAsMCwwLDAsMCwwLDAsMCwwLDAsMCwwLDAsMCwwLDAsMCwwLDAsMCwwLDAsMCwwLDAsMCwwLDAsMCwwLDAsMCwwLDAsMCwwLDAsMCwwLDAsMCwwLDAsMCwwXSwibCI6MSwicSI6NiwiciI6N319AAAAAAAAAAAAAAAAAEABAAAAAAAABQAAADQ1MC4wAAAALwEAAHsid2FzX2ZpcnN0X2V2ZW50Ijp0cnVlLCJpbWFnZV9pZCI6WzI5NDg2MzA3OTIsMjQ4MjEzNjcxMSwxNTEyNjE4NjkyLDMxOTcwODI0MTgsODIwOTYzODY4LDQ2MzI0MzAwNSwyODE1MTMwMDQ1LDM4MzUzNTQ2NTddLCJxZiI6eyJiIjpbMCw0LDAsMCwwLDAsMCwwLDAsNCwwLDAsMCwwLDAsMCwwLDAsMTI4LDI2LDAsMCwwLDAsMCwwLDAsMCwwLDAsMCwwLDAsMCwwLDAsMCwwLDAsMCwwLDAsMCwwLDAsMCwwLDAsMCwwLDAsMCwwLDAsMCwwLDAsMCwwLDAsMCwwLDAsMCwwLDAsMCwwLDAsMCwwLDAsMF0sImwiOjEsInEiOjYsInIiOjd9fQAAAAAAAAAAAAAAAAAAAAAAAAAAAAAAAAAAAAAAAAAAAA=='}}
prove_13;40;8;Mul;320;20377;320.0;841;0.06865887499952805;{'verificationValue': 320.0, 'proof': {'imageId': [2948630792, 2482136711, 1512618692, 3197082418, 820963868, 463243005, 2815130045, 3835354657], 'receipt': 'AwAAAAAAAAAAAAAAxAciAPPsD8genbvcCN2DvDmorNgPyU2p6hAM/h+8IU0pSDuhAAAAAAAAAAAAAAAAAAAAAAAAAAAAAAAAAAAAAAAAAAAAAAAAAAAAAAAAAAAAAAAAAQAAAAAAAAAAAAAAAAAAAAAAAAAAAAAAAAAAAAAAAAAAAAAAAAAAAAEAAAAAQAEAAAAAAAAFAAAAMzIwLjAAAAAvAQAAeyJ3YXNfZmlyc3RfZXZlbnQiOnRydWUsImltYWdlX2lkIjpbMjk0ODYzMDc5MiwyNDgyMTM2NzExLDE1MTI2MTg2OTIsMzE5NzA4MjQxOCw4MjA5NjM4NjgsNDYzMjQzMDA1LDI4MTUxMzAwNDUsMzgzNTM1NDY1N10sInFmIjp7ImIiOlswLDQsMCwwLDAsMCwwLDAsMCw0LDAsMCwwLDAsMCwwLDAsMCwxMjgsMjYsMCwwLDAsMCwwLDAsMCwwLDAsMCwwLDAsMCwwLDAsMCwwLDAsMCwwLDAsMCwwLDAsMCwwLDAsMCwwLDAsMCwwLDAsMCwwLDAsMCwwLDAsMCwwLDAsMCwwLDAsMCwwLDAsMCwwLDAsMCwwXSwibCI6MSwicSI6NiwiciI6N319AAAAAAAAAAAAAAAAAEABAAAAAAAABQAAADMyMC4wAAAALwEAAHsid2FzX2ZpcnN0X2V2ZW50Ijp0cnVlLCJpbWFnZV9pZCI6WzI5NDg2MzA3OTIsMjQ4MjEzNjcxMSwxNTEyNjE4NjkyLDMxOTcwODI0MTgsODIwOTYzODY4LDQ2MzI0MzAwNSwyODE1MTMwMDQ1LDM4MzUzNTQ2NTddLCJxZiI6eyJiIjpbMCw0LDAsMCwwLDAsMCwwLDAsNCwwLDAsMCwwLDAsMCwwLDAsMTI4LDI2LDAsMCwwLDAsMCwwLDAsMCwwLDAsMCwwLDAsMCwwLDAsMCwwLDAsMCwwLDAsMCwwLDAsMCwwLDAsMCwwLDAsMCwwLDAsMCwwLDAsMCwwLDAsMCwwLDAsMCwwLDAsMCwwLDAsMCwwLDAsMF0sImwiOjEsInEiOjYsInIiOjd9fQAAAAAAAAAAAAAAAAAAAAAAAAAAAAAAAAAAAAAAAAAAAA=='}}
prove_14;79;5;Mul;395;20772;395.0;841;0.06876391700097884;{'verificationValue': 395.0, 'proof': {'imageId': [2948630792, 2482136711, 1512618692, 3197082418, 820963868, 463243005, 2815130045, 3835354657], 'receipt': 'AwAAAAAAAAAAAAAAxAciAPPsD8genbvcCN2DvDmorNgPyU2p6hAM/h+8IU0pSDuhAAAAAAAAAAAAAAAAAAAAAAAAAAAAAAAAAAAAAAAAAAAAAAAAAAAAAAAAAAAAAAAAAQAAAAAAAAAAAAAAAAAAAAAAAAAAAAAAAAAAAAAAAAAAAAAAAAAAAAEAAAAAQAEAAAAAAAAFAAAAMzk1LjAAAAAvAQAAeyJ3YXNfZmlyc3RfZXZlbnQiOnRydWUsImltYWdlX2lkIjpbMjk0ODYzMDc5MiwyNDgyMTM2NzExLDE1MTI2MTg2OTIsMzE5NzA4MjQxOCw4MjA5NjM4NjgsNDYzMjQzMDA1LDI4MTUxMzAwNDUsMzgzNTM1NDY1N10sInFmIjp7ImIiOlswLDQsMCwwLDAsMCwwLDAsMCw0LDAsMCwwLDAsMCwwLDAsMCwxMjgsMjYsMCwwLDAsMCwwLDAsMCwwLDAsMCwwLDAsMCwwLDAsMCwwLDAsMCwwLDAsMCwwLDAsMCwwLDAsMCwwLDAsMCwwLDAsMCwwLDAsMCwwLDAsMCwwLDAsMCwwLDAsMCwwLDAsMCwwLDAsMCwwXSwibCI6MSwicSI6NiwiciI6N319AAAAAAAAAAAAAAAAAEABAAAAAAAABQAAADM5NS4wAAAALwEAAHsid2FzX2ZpcnN0X2V2ZW50Ijp0cnVlLCJpbWFnZV9pZCI6WzI5NDg2MzA3OTIsMjQ4MjEzNjcxMSwxNTEyNjE4NjkyLDMxOTcwODI0MTgsODIwOTYzODY4LDQ2MzI0MzAwNSwyODE1MTMwMDQ1LDM4MzUzNTQ2NTddLCJxZiI6eyJiIjpbMCw0LDAsMCwwLDAsMCwwLDAsNCwwLDAsMCwwLDAsMCwwLDAsMTI4LDI2LDAsMCwwLDAsMCwwLDAsMCwwLDAsMCwwLDAsMCwwLDAsMCwwLDAsMCwwLDAsMCwwLDAsMCwwLDAsMCwwLDAsMCwwLDAsMCwwLDAsMCwwLDAsMCwwLDAsMCwwLDAsMCwwLDAsMCwwLDAsMF0sImwiOjEsInEiOjYsInIiOjd9fQAAAAAAAAAAAAAAAAAAAAAAAAAAAAAAAAAAAAAAAAAAAA=='}}
prove_15;17;73;Mul;1241;22013;1241.0;841;0.06827420799891115;{'verificationValue': 1241.0, 'proof': {'imageId': [2948630792, 2482136711, 1512618692, 3197082418, 820963868, 463243005, 2815130045, 3835354657], 'receipt': 'AwAAAAAAAAAAAAAAxAciAPPsD8genbvcCN2DvDmorNgPyU2p6hAM/h+8IU0pSDuhAAAAAAAAAAAAAAAAAAAAAAAAAAAAAAAAAAAAAAAAAAAAAAAAAAAAAAAAAAAAAAAAAQAAAAAAAAAAAAAAAAAAAAAAAAAAAAAAAAAAAAAAAAAAAAAAAAAAAAEAAAAAQAEAAAAAAAAGAAAAMTI0MS4wAAAvAQAAeyJ3YXNfZmlyc3RfZXZlbnQiOnRydWUsImltYWdlX2lkIjpbMjk0ODYzMDc5MiwyNDgyMTM2NzExLDE1MTI2MTg2OTIsMzE5NzA4MjQxOCw4MjA5NjM4NjgsNDYzMjQzMDA1LDI4MTUxMzAwNDUsMzgzNTM1NDY1N10sInFmIjp7ImIiOlswLDQsMCwwLDAsMCwwLDAsMCw0LDAsMCwwLDAsMCwwLDAsMCwxMjgsMjYsMCwwLDAsMCwwLDAsMCwwLDAsMCwwLDAsMCwwLDAsMCwwLDAsMCwwLDAsMCwwLDAsMCwwLDAsMCwwLDAsMCwwLDAsMCwwLDAsMCwwLDAsMCwwLDAsMCwwLDAsMCwwLDAsMCwwLDAsMCwwXSwibCI6MSwicSI6NiwiciI6N319AAAAAAAAAAAAAAAAAEABAAAAAAAABgAAADEyNDEuMAAALwEAAHsid2FzX2ZpcnN0X2V2ZW50Ijp0cnVlLCJpbWFnZV9pZCI6WzI5NDg2MzA3OTIsMjQ4MjEzNjcxMSwxNTEyNjE4NjkyLDMxOTcwODI0MTgsODIwOTYzODY4LDQ2MzI0MzAwNSwyODE1MTMwMDQ1LDM4MzUzNTQ2NTddLCJxZiI6eyJiIjpbMCw0LDAsMCwwLDAsMCwwLDAsNCwwLDAsMCwwLDAsMCwwLDAsMTI4LDI2LDAsMCwwLDAsMCwwLDAsMCwwLDAsMCwwLDAsMCwwLDAsMCwwLDAsMCwwLDAsMCwwLDAsMCwwLDAsMCwwLDAsMCwwLDAsMCwwLDAsMCwwLDAsMCwwLDAsMCwwLDAsMCwwLDAsMCwwLDAsMF0sImwiOjEsInEiOjYsInIiOjd9fQAAAAAAAAAAAAAAAAAAAAAAAAAAAAAAAAAAAAAAAAAAAA=='}}
prove_16;19;9;Mul;171;22184;171.0;841;0.06848433400045906;{'verificationValue': 171.0, 'proof': {'imageId': [2948630792, 2482136711, 1512618692, 3197082418, 820963868, 463243005, 2815130045, 3835354657], 'receipt': 'AwAAAAAAAAAAAAAAxAciAPPsD8genbvcCN2DvDmorNgPyU2p6hAM/h+8IU0pSDuhAAAAAAAAAAAAAAAAAAAAAAAAAAAAAAAAAAAAAAAAAAAAAAAAAAAAAAAAAAAAAAAAAQAAAAAAAAAAAAAAAAAAAAAAAAAAAAAAAAAAAAAAAAAAAAAAAAAAAAEAAAAAQAEAAAAAAAAFAAAAMTcxLjAAAAAvAQAAeyJ3YXNfZmlyc3RfZXZlbnQiOnRydWUsImltYWdlX2lkIjpbMjk0ODYzMDc5MiwyNDgyMTM2NzExLDE1MTI2MTg2OTIsMzE5NzA4MjQxOCw4MjA5NjM4NjgsNDYzMjQzMDA1LDI4MTUxMzAwNDUsMzgzNTM1NDY1N10sInFmIjp7ImIiOlswLDQsMCwwLDAsMCwwLDAsMCw0LDAsMCwwLDAsMCwwLDAsMCwxMjgsMjYsMCwwLDAsMCwwLDAsMCwwLDAsMCwwLDAsMCwwLDAsMCwwLDAsMCwwLDAsMCwwLDAsMCwwLDAsMCwwLDAsMCwwLDAsMCwwLDAsMCwwLDAsMCwwLDAsMCwwLDAsMCwwLDAsMCwwLDAsMCwwXSwibCI6MSwicSI6NiwiciI6N319AAAAAAAAAAAAAAAAAEABAAAAAAAABQAAADE3MS4wAAAALwEAAHsid2FzX2ZpcnN0X2V2ZW50Ijp0cnVlLCJpbWFnZV9pZCI6WzI5NDg2MzA3OTIsMjQ4MjEzNjcxMSwxNTEyNjE4NjkyLDMxOTcwODI0MTgsODIwOTYzODY4LDQ2MzI0MzAwNSwyODE1MTMwMDQ1LDM4MzUzNTQ2NTddLCJxZiI6eyJiIjpbMCw0LDAsMCwwLDAsMCwwLDAsNCwwLDAsMCwwLDAsMCwwLDAsMTI4LDI2LDAsMCwwLDAsMCwwLDAsMCwwLDAsMCwwLDAsMCwwLDAsMCwwLDAsMCwwLDAsMCwwLDAsMCwwLDAsMCwwLDAsMCwwLDAsMCwwLDAsMCwwLDAsMCwwLDAsMCwwLDAsMCwwLDAsMCwwLDAsMF0sImwiOjEsInEiOjYsInIiOjd9fQAAAAAAAAAAAAAAAAAAAAAAAAAAAAAAAAAAAAAAAAAAAA=='}}
prove_17;73;5;Mul;365;22549;365.0;841;0.06790662499952305;{'verificationValue': 365.0, 'proof': {'imageId': [2948630792, 2482136711, 1512618692, 3197082418, 820963868, 463243005, 2815130045, 3835354657], 'receipt': 'AwAAAAAAAAAAAAAAxAciAPPsD8genbvcCN2DvDmorNgPyU2p6hAM/h+8IU0pSDuhAAAAAAAAAAAAAAAAAAAAAAAAAAAAAAAAAAAAAAAAAAAAAAAAAAAAAAAAAAAAAAAAAQAAAAAAAAAAAAAAAAAAAAAAAAAAAAAAAAAAAAAAAAAAAAAAAAAAAAEAAAAAQAEAAAAAAAAFAAAAMzY1LjAAAAAvAQAAeyJ3YXNfZmlyc3RfZXZlbnQiOnRydWUsImltYWdlX2lkIjpbMjk0ODYzMDc5MiwyNDgyMTM2NzExLDE1MTI2MTg2OTIsMzE5NzA4MjQxOCw4MjA5NjM4NjgsNDYzMjQzMDA1LDI4MTUxMzAwNDUsMzgzNTM1NDY1N10sInFmIjp7ImIiOlswLDQsMCwwLDAsMCwwLDAsMCw0LDAsMCwwLDAsMCwwLDAsMCwxMjgsMjYsMCwwLDAsMCwwLDAsMCwwLDAsMCwwLDAsMCwwLDAsMCwwLDAsMCwwLDAsMCwwLDAsMCwwLDAsMCwwLDAsMCwwLDAsMCwwLDAsMCwwLDAsMCwwLDAsMCwwLDAsMCwwLDAsMCwwLDAsMCwwXSwibCI6MSwicSI6NiwiciI6N319AAAAAAAAAAAAAAAAAEABAAAAAAAABQAAADM2NS4wAAAALwEAAHsid2FzX2ZpcnN0X2V2ZW50Ijp0cnVlLCJpbWFnZV9pZCI6WzI5NDg2MzA3OTIsMjQ4MjEzNjcxMSwxNTEyNjE4NjkyLDMxOTcwODI0MTgsODIwOTYzODY4LDQ2MzI0MzAwNSwyODE1MTMwMDQ1LDM4MzUzNTQ2NTddLCJxZiI6eyJiIjpbMCw0LDAsMCwwLDAsMCwwLDAsNCwwLDAsMCwwLDAsMCwwLDAsMTI4LDI2LDAsMCwwLDAsMCwwLDAsMCwwLDAsMCwwLDAsMCwwLDAsMCwwLDAsMCwwLDAsMCwwLDAsMCwwLDAsMCwwLDAsMCwwLDAsMCwwLDAsMCwwLDAsMCwwLDAsMCwwLDAsMCwwLDAsMCwwLDAsMF0sImwiOjEsInEiOjYsInIiOjd9fQAAAAAAAAAAAAAAAAAAAAAAAAAAAAAAAAAAAAAAAAAAAA=='}}
prove_18;93;14;Mul;1302;23851;1302.0;841;0.06888695899942832;{'verificationValue': 1302.0, 'proof': {'imageId': [2948630792, 2482136711, 1512618692, 3197082418, 820963868, 463243005, 2815130045, 3835354657], 'receipt': 'AwAAAAAAAAAAAAAAxAciAPPsD8genbvcCN2DvDmorNgPyU2p6hAM/h+8IU0pSDuhAAAAAAAAAAAAAAAAAAAAAAAAAAAAAAAAAAAAAAAAAAAAAAAAAAAAAAAAAAAAAAAAAQAAAAAAAAAAAAAAAAAAAAAAAAAAAAAAAAAAAAAAAAAAAAAAAAAAAAEAAAAAQAEAAAAAAAAGAAAAMTMwMi4wAAAvAQAAeyJ3YXNfZmlyc3RfZXZlbnQiOnRydWUsImltYWdlX2lkIjpbMjk0ODYzMDc5MiwyNDgyMTM2NzExLDE1MTI2MTg2OTIsMzE5NzA4MjQxOCw4MjA5NjM4NjgsNDYzMjQzMDA1LDI4MTUxMzAwNDUsMzgzNTM1NDY1N10sInFmIjp7ImIiOlswLDQsMCwwLDAsMCwwLDAsMCw0LDAsMCwwLDAsMCwwLDAsMCwxMjgsMjYsMCwwLDAsMCwwLDAsMCwwLDAsMCwwLDAsMCwwLDAsMCwwLDAsMCwwLDAsMCwwLDAsMCwwLDAsMCwwLDAsMCwwLDAsMCwwLDAsMCwwLDAsMCwwLDAsMCwwLDAsMCwwLDAsMCwwLDAsMCwwXSwibCI6MSwicSI6NiwiciI6N319AAAAAAAAAAAAAAAAAEABAAAAAAAABgAAADEzMDIuMAAALwEAAHsid2FzX2ZpcnN0X2V2ZW50Ijp0cnVlLCJpbWFnZV9pZCI6WzI5NDg2MzA3OTIsMjQ4MjEzNjcxMSwxNTEyNjE4NjkyLDMxOTcwODI0MTgsODIwOTYzODY4LDQ2MzI0MzAwNSwyODE1MTMwMDQ1LDM4MzUzNTQ2NTddLCJxZiI6eyJiIjpbMCw0LDAsMCwwLDAsMCwwLDAsNCwwLDAsMCwwLDAsMCwwLDAsMTI4LDI2LDAsMCwwLDAsMCwwLDAsMCwwLDAsMCwwLDAsMCwwLDAsMCwwLDAsMCwwLDAsMCwwLDAsMCwwLDAsMCwwLDAsMCwwLDAsMCwwLDAsMCwwLDAsMCwwLDAsMCwwLDAsMCwwLDAsMCwwLDAsMF0sImwiOjEsInEiOjYsInIiOjd9fQAAAAAAAAAAAAAAAAAAAAAAAAAAAAAAAAAAAAAAAAAAAA=='}}
prove_19;90;100;Mul;9000;32851;9000.0;841;0.06860783400043147;{'verificationValue': 9000.0, 'proof': {'imageId': [2948630792, 2482136711, 1512618692, 3197082418, 820963868, 463243005, 2815130045, 3835354657], 'receipt': 'AwAAAAAAAAAAAAAAxAciAPPsD8genbvcCN2DvDmorNgPyU2p6hAM/h+8IU0pSDuhAAAAAAAAAAAAAAAAAAAAAAAAAAAAAAAAAAAAAAAAAAAAAAAAAAAAAAAAAAAAAAAAAQAAAAAAAAAAAAAAAAAAAAAAAAAAAAAAAAAAAAAAAAAAAAAAAAAAAAEAAAAAQAEAAAAAAAAGAAAAOTAwMC4wAAAvAQAAeyJ3YXNfZmlyc3RfZXZlbnQiOnRydWUsImltYWdlX2lkIjpbMjk0ODYzMDc5MiwyNDgyMTM2NzExLDE1MTI2MTg2OTIsMzE5NzA4MjQxOCw4MjA5NjM4NjgsNDYzMjQzMDA1LDI4MTUxMzAwNDUsMzgzNTM1NDY1N10sInFmIjp7ImIiOlswLDQsMCwwLDAsMCwwLDAsMCw0LDAsMCwwLDAsMCwwLDAsMCwxMjgsMjYsMCwwLDAsMCwwLDAsMCwwLDAsMCwwLDAsMCwwLDAsMCwwLDAsMCwwLDAsMCwwLDAsMCwwLDAsMCwwLDAsMCwwLDAsMCwwLDAsMCwwLDAsMCwwLDAsMCwwLDAsMCwwLDAsMCwwLDAsMCwwXSwibCI6MSwicSI6NiwiciI6N319AAAAAAAAAAAAAAAAAEABAAAAAAAABgAAADkwMDAuMAAALwEAAHsid2FzX2ZpcnN0X2V2ZW50Ijp0cnVlLCJpbWFnZV9pZCI6WzI5NDg2MzA3OTIsMjQ4MjEzNjcxMSwxNTEyNjE4NjkyLDMxOTcwODI0MTgsODIwOTYzODY4LDQ2MzI0MzAwNSwyODE1MTMwMDQ1LDM4MzUzNTQ2NTddLCJxZiI6eyJiIjpbMCw0LDAsMCwwLDAsMCwwLDAsNCwwLDAsMCwwLDAsMCwwLDAsMTI4LDI2LDAsMCwwLDAsMCwwLDAsMCwwLDAsMCwwLDAsMCwwLDAsMCwwLDAsMCwwLDAsMCwwLDAsMCwwLDAsMCwwLDAsMCwwLDAsMCwwLDAsMCwwLDAsMCwwLDAsMCwwLDAsMCwwLDAsMCwwLDAsMF0sImwiOjEsInEiOjYsInIiOjd9fQAAAAAAAAAAAAAAAAAAAAAAAAAAAAAAAAAAAAAAAAAAAA=='}}
prove_20;70;90;Mul;6300;39151;6300.0;841;0.06795799999963492;{'verificationValue': 6300.0, 'proof': {'imageId': [2948630792, 2482136711, 1512618692, 3197082418, 820963868, 463243005, 2815130045, 3835354657], 'receipt': 'AwAAAAAAAAAAAAAAxAciAPPsD8genbvcCN2DvDmorNgPyU2p6hAM/h+8IU0pSDuhAAAAAAAAAAAAAAAAAAAAAAAAAAAAAAAAAAAAAAAAAAAAAAAAAAAAAAAAAAAAAAAAAQAAAAAAAAAAAAAAAAAAAAAAAAAAAAAAAAAAAAAAAAAAAAAAAAAAAAEAAAAAQAEAAAAAAAAGAAAANjMwMC4wAAAvAQAAeyJ3YXNfZmlyc3RfZXZlbnQiOnRydWUsImltYWdlX2lkIjpbMjk0ODYzMDc5MiwyNDgyMTM2NzExLDE1MTI2MTg2OTIsMzE5NzA4MjQxOCw4MjA5NjM4NjgsNDYzMjQzMDA1LDI4MTUxMzAwNDUsMzgzNTM1NDY1N10sInFmIjp7ImIiOlswLDQsMCwwLDAsMCwwLDAsMCw0LDAsMCwwLDAsMCwwLDAsMCwxMjgsMjYsMCwwLDAsMCwwLDAsMCwwLDAsMCwwLDAsMCwwLDAsMCwwLDAsMCwwLDAsMCwwLDAsMCwwLDAsMCwwLDAsMCwwLDAsMCwwLDAsMCwwLDAsMCwwLDAsMCwwLDAsMCwwLDAsMCwwLDAsMCwwXSwibCI6MSwicSI6NiwiciI6N319AAAAAAAAAAAAAAAAAEABAAAAAAAABgAAADYzMDAuMAAALwEAAHsid2FzX2ZpcnN0X2V2ZW50Ijp0cnVlLCJpbWFnZV9pZCI6WzI5NDg2MzA3OTIsMjQ4MjEzNjcxMSwxNTEyNjE4NjkyLDMxOTcwODI0MTgsODIwOTYzODY4LDQ2MzI0MzAwNSwyODE1MTMwMDQ1LDM4MzUzNTQ2NTddLCJxZiI6eyJiIjpbMCw0LDAsMCwwLDAsMCwwLDAsNCwwLDAsMCwwLDAsMCwwLDAsMTI4LDI2LDAsMCwwLDAsMCwwLDAsMCwwLDAsMCwwLDAsMCwwLDAsMCwwLDAsMCwwLDAsMCwwLDAsMCwwLDAsMCwwLDAsMCwwLDAsMCwwLDAsMCwwLDAsMCwwLDAsMCwwLDAsMCwwLDAsMCwwLDAsMF0sImwiOjEsInEiOjYsInIiOjd9fQAAAAAAAAAAAAAAAAAAAAAAAAAAAAAAAAAAAAAAAAAAAA=='}}
prove_21;83;87;Mul;7221;46372;7221.0;841;0.06839758299975074;{'verificationValue': 7221.0, 'proof': {'imageId': [2948630792, 2482136711, 1512618692, 3197082418, 820963868, 463243005, 2815130045, 3835354657], 'receipt': 'AwAAAAAAAAAAAAAAxAciAPPsD8genbvcCN2DvDmorNgPyU2p6hAM/h+8IU0pSDuhAAAAAAAAAAAAAAAAAAAAAAAAAAAAAAAAAAAAAAAAAAAAAAAAAAAAAAAAAAAAAAAAAQAAAAAAAAAAAAAAAAAAAAAAAAAAAAAAAAAAAAAAAAAAAAAAAAAAAAEAAAAAQAEAAAAAAAAGAAAANzIyMS4wAAAvAQAAeyJ3YXNfZmlyc3RfZXZlbnQiOnRydWUsImltYWdlX2lkIjpbMjk0ODYzMDc5MiwyNDgyMTM2NzExLDE1MTI2MTg2OTIsMzE5NzA4MjQxOCw4MjA5NjM4NjgsNDYzMjQzMDA1LDI4MTUxMzAwNDUsMzgzNTM1NDY1N10sInFmIjp7ImIiOlswLDQsMCwwLDAsMCwwLDAsMCw0LDAsMCwwLDAsMCwwLDAsMCwxMjgsMjYsMCwwLDAsMCwwLDAsMCwwLDAsMCwwLDAsMCwwLDAsMCwwLDAsMCwwLDAsMCwwLDAsMCwwLDAsMCwwLDAsMCwwLDAsMCwwLDAsMCwwLDAsMCwwLDAsMCwwLDAsMCwwLDAsMCwwLDAsMCwwXSwibCI6MSwicSI6NiwiciI6N319AAAAAAAAAAAAAAAAAEABAAAAAAAABgAAADcyMjEuMAAALwEAAHsid2FzX2ZpcnN0X2V2ZW50Ijp0cnVlLCJpbWFnZV9pZCI6WzI5NDg2MzA3OTIsMjQ4MjEzNjcxMSwxNTEyNjE4NjkyLDMxOTcwODI0MTgsODIwOTYzODY4LDQ2MzI0MzAwNSwyODE1MTMwMDQ1LDM4MzUzNTQ2NTddLCJxZiI6eyJiIjpbMCw0LDAsMCwwLDAsMCwwLDAsNCwwLDAsMCwwLDAsMCwwLDAsMTI4LDI2LDAsMCwwLDAsMCwwLDAsMCwwLDAsMCwwLDAsMCwwLDAsMCwwLDAsMCwwLDAsMCwwLDAsMCwwLDAsMCwwLDAsMCwwLDAsMCwwLDAsMCwwLDAsMCwwLDAsMCwwLDAsMCwwLDAsMCwwLDAsMF0sImwiOjEsInEiOjYsInIiOjd9fQAAAAAAAAAAAAAAAAAAAAAAAAAAAAAAAAAAAAAAAAAAAA=='}}
prove_22;45;42;Mul;1890;48262;1890.0;841;0.0674087919996964;{'verificationValue': 1890.0, 'proof': {'imageId': [2948630792, 2482136711, 1512618692, 3197082418, 820963868, 463243005, 2815130045, 3835354657], 'receipt': 'AwAAAAAAAAAAAAAAxAciAPPsD8genbvcCN2DvDmorNgPyU2p6hAM/h+8IU0pSDuhAAAAAAAAAAAAAAAAAAAAAAAAAAAAAAAAAAAAAAAAAAAAAAAAAAAAAAAAAAAAAAAAAQAAAAAAAAAAAAAAAAAAAAAAAAAAAAAAAAAAAAAAAAAAAAAAAAAAAAEAAAAAQAEAAAAAAAAGAAAAMTg5MC4wAAAvAQAAeyJ3YXNfZmlyc3RfZXZlbnQiOnRydWUsImltYWdlX2lkIjpbMjk0ODYzMDc5MiwyNDgyMTM2NzExLDE1MTI2MTg2OTIsMzE5NzA4MjQxOCw4MjA5NjM4NjgsNDYzMjQzMDA1LDI4MTUxMzAwNDUsMzgzNTM1NDY1N10sInFmIjp7ImIiOlswLDQsMCwwLDAsMCwwLDAsMCw0LDAsMCwwLDAsMCwwLDAsMCwxMjgsMjYsMCwwLDAsMCwwLDAsMCwwLDAsMCwwLDAsMCwwLDAsMCwwLDAsMCwwLDAsMCwwLDAsMCwwLDAsMCwwLDAsMCwwLDAsMCwwLDAsMCwwLDAsMCwwLDAsMCwwLDAsMCwwLDAsMCwwLDAsMCwwXSwibCI6MSwicSI6NiwiciI6N319AAAAAAAAAAAAAAAAAEABAAAAAAAABgAAADE4OTAuMAAALwEAAHsid2FzX2ZpcnN0X2V2ZW50Ijp0cnVlLCJpbWFnZV9pZCI6WzI5NDg2MzA3OTIsMjQ4MjEzNjcxMSwxNTEyNjE4NjkyLDMxOTcwODI0MTgsODIwOTYzODY4LDQ2MzI0MzAwNSwyODE1MTMwMDQ1LDM4MzUzNTQ2NTddLCJxZiI6eyJiIjpbMCw0LDAsMCwwLDAsMCwwLDAsNCwwLDAsMCwwLDAsMCwwLDAsMTI4LDI2LDAsMCwwLDAsMCwwLDAsMCwwLDAsMCwwLDAsMCwwLDAsMCwwLDAsMCwwLDAsMCwwLDAsMCwwLDAsMCwwLDAsMCwwLDAsMCwwLDAsMCwwLDAsMCwwLDAsMCwwLDAsMCwwLDAsMCwwLDAsMF0sImwiOjEsInEiOjYsInIiOjd9fQAAAAAAAAAAAAAAAAAAAAAAAAAAAAAAAAAAAAAAAAAAAA=='}}
prove_23;72;68;Mul;4896;53158;4896.0;841;0.06825941699935356;{'verificationValue': 4896.0, 'proof': {'imageId': [2948630792, 2482136711, 1512618692, 3197082418, 820963868, 463243005, 2815130045, 3835354657], 'receipt': 'AwAAAAAAAAAAAAAAxAciAPPsD8genbvcCN2DvDmorNgPyU2p6hAM/h+8IU0pSDuhAAAAAAAAAAAAAAAAAAAAAAAAAAAAAAAAAAAAAAAAAAAAAAAAAAAAAAAAAAAAAAAAAQAAAAAAAAAAAAAAAAAAAAAAAAAAAAAAAAAAAAAAAAAAAAAAAAAAAAEAAAAAQAEAAAAAAAAGAAAANDg5Ni4wAAAvAQAAeyJ3YXNfZmlyc3RfZXZlbnQiOnRydWUsImltYWdlX2lkIjpbMjk0ODYzMDc5MiwyNDgyMTM2NzExLDE1MTI2MTg2OTIsMzE5NzA4MjQxOCw4MjA5NjM4NjgsNDYzMjQzMDA1LDI4MTUxMzAwNDUsMzgzNTM1NDY1N10sInFmIjp7ImIiOlswLDQsMCwwLDAsMCwwLDAsMCw0LDAsMCwwLDAsMCwwLDAsMCwxMjgsMjYsMCwwLDAsMCwwLDAsMCwwLDAsMCwwLDAsMCwwLDAsMCwwLDAsMCwwLDAsMCwwLDAsMCwwLDAsMCwwLDAsMCwwLDAsMCwwLDAsMCwwLDAsMCwwLDAsMCwwLDAsMCwwLDAsMCwwLDAsMCwwXSwibCI6MSwicSI6NiwiciI6N319AAAAAAAAAAAAAAAAAEABAAAAAAAABgAAADQ4OTYuMAAALwEAAHsid2FzX2ZpcnN0X2V2ZW50Ijp0cnVlLCJpbWFnZV9pZCI6WzI5NDg2MzA3OTIsMjQ4MjEzNjcxMSwxNTEyNjE4NjkyLDMxOTcwODI0MTgsODIwOTYzODY4LDQ2MzI0MzAwNSwyODE1MTMwMDQ1LDM4MzUzNTQ2NTddLCJxZiI6eyJiIjpbMCw0LDAsMCwwLDAsMCwwLDAsNCwwLDAsMCwwLDAsMCwwLDAsMTI4LDI2LDAsMCwwLDAsMCwwLDAsMCwwLDAsMCwwLDAsMCwwLDAsMCwwLDAsMCwwLDAsMCwwLDAsMCwwLDAsMCwwLDAsMCwwLDAsMCwwLDAsMCwwLDAsMCwwLDAsMCwwLDAsMCwwLDAsMCwwLDAsMF0sImwiOjEsInEiOjYsInIiOjd9fQAAAAAAAAAAAAAAAAAAAAAAAAAAAAAAAAAAAAAAAAAAAA=='}}
prove_24;48;75;Mul;3600;56758;3600.0;841;0.06773429200075043;{'verificationValue': 3600.0, 'proof': {'imageId': [2948630792, 2482136711, 1512618692, 3197082418, 820963868, 463243005, 2815130045, 3835354657], 'receipt': 'AwAAAAAAAAAAAAAAxAciAPPsD8genbvcCN2DvDmorNgPyU2p6hAM/h+8IU0pSDuhAAAAAAAAAAAAAAAAAAAAAAAAAAAAAAAAAAAAAAAAAAAAAAAAAAAAAAAAAAAAAAAAAQAAAAAAAAAAAAAAAAAAAAAAAAAAAAAAAAAAAAAAAAAAAAAAAAAAAAEAAAAAQAEAAAAAAAAGAAAAMzYwMC4wAAAvAQAAeyJ3YXNfZmlyc3RfZXZlbnQiOnRydWUsImltYWdlX2lkIjpbMjk0ODYzMDc5MiwyNDgyMTM2NzExLDE1MTI2MTg2OTIsMzE5NzA4MjQxOCw4MjA5NjM4NjgsNDYzMjQzMDA1LDI4MTUxMzAwNDUsMzgzNTM1NDY1N10sInFmIjp7ImIiOlswLDQsMCwwLDAsMCwwLDAsMCw0LDAsMCwwLDAsMCwwLDAsMCwxMjgsMjYsMCwwLDAsMCwwLDAsMCwwLDAsMCwwLDAsMCwwLDAsMCwwLDAsMCwwLDAsMCwwLDAsMCwwLDAsMCwwLDAsMCwwLDAsMCwwLDAsMCwwLDAsMCwwLDAsMCwwLDAsMCwwLDAsMCwwLDAsMCwwXSwibCI6MSwicSI6NiwiciI6N319AAAAAAAAAAAAAAAAAEABAAAAAAAABgAAADM2MDAuMAAALwEAAHsid2FzX2ZpcnN0X2V2ZW50Ijp0cnVlLCJpbWFnZV9pZCI6WzI5NDg2MzA3OTIsMjQ4MjEzNjcxMSwxNTEyNjE4NjkyLDMxOTcwODI0MTgsODIwOTYzODY4LDQ2MzI0MzAwNSwyODE1MTMwMDQ1LDM4MzUzNTQ2NTddLCJxZiI6eyJiIjpbMCw0LDAsMCwwLDAsMCwwLDAsNCwwLDAsMCwwLDAsMCwwLDAsMTI4LDI2LDAsMCwwLDAsMCwwLDAsMCwwLDAsMCwwLDAsMCwwLDAsMCwwLDAsMCwwLDAsMCwwLDAsMCwwLDAsMCwwLDAsMCwwLDAsMCwwLDAsMCwwLDAsMCwwLDAsMCwwLDAsMCwwLDAsMCwwLDAsMF0sImwiOjEsInEiOjYsInIiOjd9fQAAAAAAAAAAAAAAAAAAAAAAAAAAAAAAAAAAAAAAAAAAAA=='}}
prove_25;23;45;Mul;1035;57793;1035.0;841;0.06881116699878476;{'verificationValue': 1035.0, 'proof': {'imageId': [2948630792, 2482136711, 1512618692, 3197082418, 820963868, 463243005, 2815130045, 3835354657], 'receipt': 'AwAAAAAAAAAAAAAAxAciAPPsD8genbvcCN2DvDmorNgPyU2p6hAM/h+8IU0pSDuhAAAAAAAAAAAAAAAAAAAAAAAAAAAAAAAAAAAAAAAAAAAAAAAAAAAAAAAAAAAAAAAAAQAAAAAAAAAAAAAAAAAAAAAAAAAAAAAAAAAAAAAAAAAAAAAAAAAAAAEAAAAAQAEAAAAAAAAGAAAAMTAzNS4wAAAvAQAAeyJ3YXNfZmlyc3RfZXZlbnQiOnRydWUsImltYWdlX2lkIjpbMjk0ODYzMDc5MiwyNDgyMTM2NzExLDE1MTI2MTg2OTIsMzE5NzA4MjQxOCw4MjA5NjM4NjgsNDYzMjQzMDA1LDI4MTUxMzAwNDUsMzgzNTM1NDY1N10sInFmIjp7ImIiOlswLDQsMCwwLDAsMCwwLDAsMCw0LDAsMCwwLDAsMCwwLDAsMCwxMjgsMjYsMCwwLDAsMCwwLDAsMCwwLDAsMCwwLDAsMCwwLDAsMCwwLDAsMCwwLDAsMCwwLDAsMCwwLDAsMCwwLDAsMCwwLDAsMCwwLDAsMCwwLDAsMCwwLDAsMCwwLDAsMCwwLDAsMCwwLDAsMCwwXSwibCI6MSwicSI6NiwiciI6N319AAAAAAAAAAAAAAAAAEABAAAAAAAABgAAADEwMzUuMAAALwEAAHsid2FzX2ZpcnN0X2V2ZW50Ijp0cnVlLCJpbWFnZV9pZCI6WzI5NDg2MzA3OTIsMjQ4MjEzNjcxMSwxNTEyNjE4NjkyLDMxOTcwODI0MTgsODIwOTYzODY4LDQ2MzI0MzAwNSwyODE1MTMwMDQ1LDM4MzUzNTQ2NTddLCJxZiI6eyJiIjpbMCw0LDAsMCwwLDAsMCwwLDAsNCwwLDAsMCwwLDAsMCwwLDAsMTI4LDI2LDAsMCwwLDAsMCwwLDAsMCwwLDAsMCwwLDAsMCwwLDAsMCwwLDAsMCwwLDAsMCwwLDAsMCwwLDAsMCwwLDAsMCwwLDAsMCwwLDAsMCwwLDAsMCwwLDAsMCwwLDAsMCwwLDAsMCwwLDAsMF0sImwiOjEsInEiOjYsInIiOjd9fQAAAAAAAAAAAAAAAAAAAAAAAAAAAAAAAAAAAAAAAAAAAA=='}}
prove_26;37;31;Mul;1147;58940;1147.0;841;0.06719866700041166;{'verificationValue': 1147.0, 'proof': {'imageId': [2948630792, 2482136711, 1512618692, 3197082418, 820963868, 463243005, 2815130045, 3835354657], 'receipt': 'AwAAAAAAAAAAAAAAxAciAPPsD8genbvcCN2DvDmorNgPyU2p6hAM/h+8IU0pSDuhAAAAAAAAAAAAAAAAAAAAAAAAAAAAAAAAAAAAAAAAAAAAAAAAAAAAAAAAAAAAAAAAAQAAAAAAAAAAAAAAAAAAAAAAAAAAAAAAAAAAAAAAAAAAAAAAAAAAAAEAAAAAQAEAAAAAAAAGAAAAMTE0Ny4wAAAvAQAAeyJ3YXNfZmlyc3RfZXZlbnQiOnRydWUsImltYWdlX2lkIjpbMjk0ODYzMDc5MiwyNDgyMTM2NzExLDE1MTI2MTg2OTIsMzE5NzA4MjQxOCw4MjA5NjM4NjgsNDYzMjQzMDA1LDI4MTUxMzAwNDUsMzgzNTM1NDY1N10sInFmIjp7ImIiOlswLDQsMCwwLDAsMCwwLDAsMCw0LDAsMCwwLDAsMCwwLDAsMCwxMjgsMjYsMCwwLDAsMCwwLDAsMCwwLDAsMCwwLDAsMCwwLDAsMCwwLDAsMCwwLDAsMCwwLDAsMCwwLDAsMCwwLDAsMCwwLDAsMCwwLDAsMCwwLDAsMCwwLDAsMCwwLDAsMCwwLDAsMCwwLDAsMCwwXSwibCI6MSwicSI6NiwiciI6N319AAAAAAAAAAAAAAAAAEABAAAAAAAABgAAADExNDcuMAAALwEAAHsid2FzX2ZpcnN0X2V2ZW50Ijp0cnVlLCJpbWFnZV9pZCI6WzI5NDg2MzA3OTIsMjQ4MjEzNjcxMSwxNTEyNjE4NjkyLDMxOTcwODI0MTgsODIwOTYzODY4LDQ2MzI0MzAwNSwyODE1MTMwMDQ1LDM4MzUzNTQ2NTddLCJxZiI6eyJiIjpbMCw0LDAsMCwwLDAsMCwwLDAsNCwwLDAsMCwwLDAsMCwwLDAsMTI4LDI2LDAsMCwwLDAsMCwwLDAsMCwwLDAsMCwwLDAsMCwwLDAsMCwwLDAsMCwwLDAsMCwwLDAsMCwwLDAsMCwwLDAsMCwwLDAsMCwwLDAsMCwwLDAsMCwwLDAsMCwwLDAsMCwwLDAsMCwwLDAsMF0sImwiOjEsInEiOjYsInIiOjd9fQAAAAAAAAAAAAAAAAAAAAAAAAAAAAAAAAAAAAAAAAAAAA=='}}
prove_27;16;16;Mul;256;59196;256.0;841;0.06876349999947706;{'verificationValue': 256.0, 'proof': {'imageId': [2948630792, 2482136711, 1512618692, 3197082418, 820963868, 463243005, 2815130045, 3835354657], 'receipt': 'AwAAAAAAAAAAAAAAxAciAPPsD8genbvcCN2DvDmorNgPyU2p6hAM/h+8IU0pSDuhAAAAAAAAAAAAAAAAAAAAAAAAAAAAAAAAAAAAAAAAAAAAAAAAAAAAAAAAAAAAAAAAAQAAAAAAAAAAAAAAAAAAAAAAAAAAAAAAAAAAAAAAAAAAAAAAAAAAAAEAAAAAQAEAAAAAAAAFAAAAMjU2LjAAAAAvAQAAeyJ3YXNfZmlyc3RfZXZlbnQiOnRydWUsImltYWdlX2lkIjpbMjk0ODYzMDc5MiwyNDgyMTM2NzExLDE1MTI2MTg2OTIsMzE5NzA4MjQxOCw4MjA5NjM4NjgsNDYzMjQzMDA1LDI4MTUxMzAwNDUsMzgzNTM1NDY1N10sInFmIjp7ImIiOlswLDQsMCwwLDAsMCwwLDAsMCw0LDAsMCwwLDAsMCwwLDAsMCwxMjgsMjYsMCwwLDAsMCwwLDAsMCwwLDAsMCwwLDAsMCwwLDAsMCwwLDAsMCwwLDAsMCwwLDAsMCwwLDAsMCwwLDAsMCwwLDAsMCwwLDAsMCwwLDAsMCwwLDAsMCwwLDAsMCwwLDAsMCwwLDAsMCwwXSwibCI6MSwicSI6NiwiciI6N319AAAAAAAAAAAAAAAAAEABAAAAAAAABQAAADI1Ni4wAAAALwEAAHsid2FzX2ZpcnN0X2V2ZW50Ijp0cnVlLCJpbWFnZV9pZCI6WzI5NDg2MzA3OTIsMjQ4MjEzNjcxMSwxNTEyNjE4NjkyLDMxOTcwODI0MTgsODIwOTYzODY4LDQ2MzI0MzAwNSwyODE1MTMwMDQ1LDM4MzUzNTQ2NTddLCJxZiI6eyJiIjpbMCw0LDAsMCwwLDAsMCwwLDAsNCwwLDAsMCwwLDAsMCwwLDAsMTI4LDI2LDAsMCwwLDAsMCwwLDAsMCwwLDAsMCwwLDAsMCwwLDAsMCwwLDAsMCwwLDAsMCwwLDAsMCwwLDAsMCwwLDAsMCwwLDAsMCwwLDAsMCwwLDAsMCwwLDAsMCwwLDAsMCwwLDAsMCwwLDAsMF0sImwiOjEsInEiOjYsInIiOjd9fQAAAAAAAAAAAAAAAAAAAAAAAAAAAAAAAAAAAAAAAAAAAA=='}}
prove_28;39;37;Mul;1443;60639;1443.0;841;0.06757191699944087;{'verificationValue': 1443.0, 'proof': {'imageId': [2948630792, 2482136711, 1512618692, 3197082418, 820963868, 463243005, 2815130045, 3835354657], 'receipt': 'AwAAAAAAAAAAAAAAxAciAPPsD8genbvcCN2DvDmorNgPyU2p6hAM/h+8IU0pSDuhAAAAAAAAAAAAAAAAAAAAAAAAAAAAAAAAAAAAAAAAAAAAAAAAAAAAAAAAAAAAAAAAAQAAAAAAAAAAAAAAAAAAAAAAAAAAAAAAAAAAAAAAAAAAAAAAAAAAAAEAAAAAQAEAAAAAAAAGAAAAMTQ0My4wAAAvAQAAeyJ3YXNfZmlyc3RfZXZlbnQiOnRydWUsImltYWdlX2lkIjpbMjk0ODYzMDc5MiwyNDgyMTM2NzExLDE1MTI2MTg2OTIsMzE5NzA4MjQxOCw4MjA5NjM4NjgsNDYzMjQzMDA1LDI4MTUxMzAwNDUsMzgzNTM1NDY1N10sInFmIjp7ImIiOlswLDQsMCwwLDAsMCwwLDAsMCw0LDAsMCwwLDAsMCwwLDAsMCwxMjgsMjYsMCwwLDAsMCwwLDAsMCwwLDAsMCwwLDAsMCwwLDAsMCwwLDAsMCwwLDAsMCwwLDAsMCwwLDAsMCwwLDAsMCwwLDAsMCwwLDAsMCwwLDAsMCwwLDAsMCwwLDAsMCwwLDAsMCwwLDAsMCwwXSwibCI6MSwicSI6NiwiciI6N319AAAAAAAAAAAAAAAAAEABAAAAAAAABgAAADE0NDMuMAAALwEAAHsid2FzX2ZpcnN0X2V2ZW50Ijp0cnVlLCJpbWFnZV9pZCI6WzI5NDg2MzA3OTIsMjQ4MjEzNjcxMSwxNTEyNjE4NjkyLDMxOTcwODI0MTgsODIwOTYzODY4LDQ2MzI0MzAwNSwyODE1MTMwMDQ1LDM4MzUzNTQ2NTddLCJxZiI6eyJiIjpbMCw0LDAsMCwwLDAsMCwwLDAsNCwwLDAsMCwwLDAsMCwwLDAsMTI4LDI2LDAsMCwwLDAsMCwwLDAsMCwwLDAsMCwwLDAsMCwwLDAsMCwwLDAsMCwwLDAsMCwwLDAsMCwwLDAsMCwwLDAsMCwwLDAsMCwwLDAsMCwwLDAsMCwwLDAsMCwwLDAsMCwwLDAsMCwwLDAsMF0sImwiOjEsInEiOjYsInIiOjd9fQAAAAAAAAAAAAAAAAAAAAAAAAAAAAAAAAAAAAAAAAAAAA=='}}
prove_29;84;18;Mul;1512;62151;1512.0;841;0.06811100000049919;{'verificationValue': 1512.0, 'proof': {'imageId': [2948630792, 2482136711, 1512618692, 3197082418, 820963868, 463243005, 2815130045, 3835354657], 'receipt': 'AwAAAAAAAAAAAAAAxAciAPPsD8genbvcCN2DvDmorNgPyU2p6hAM/h+8IU0pSDuhAAAAAAAAAAAAAAAAAAAAAAAAAAAAAAAAAAAAAAAAAAAAAAAAAAAAAAAAAAAAAAAAAQAAAAAAAAAAAAAAAAAAAAAAAAAAAAAAAAAAAAAAAAAAAAAAAAAAAAEAAAAAQAEAAAAAAAAGAAAAMTUxMi4wAAAvAQAAeyJ3YXNfZmlyc3RfZXZlbnQiOnRydWUsImltYWdlX2lkIjpbMjk0ODYzMDc5MiwyNDgyMTM2NzExLDE1MTI2MTg2OTIsMzE5NzA4MjQxOCw4MjA5NjM4NjgsNDYzMjQzMDA1LDI4MTUxMzAwNDUsMzgzNTM1NDY1N10sInFmIjp7ImIiOlswLDQsMCwwLDAsMCwwLDAsMCw0LDAsMCwwLDAsMCwwLDAsMCwxMjgsMjYsMCwwLDAsMCwwLDAsMCwwLDAsMCwwLDAsMCwwLDAsMCwwLDAsMCwwLDAsMCwwLDAsMCwwLDAsMCwwLDAsMCwwLDAsMCwwLDAsMCwwLDAsMCwwLDAsMCwwLDAsMCwwLDAsMCwwLDAsMCwwXSwibCI6MSwicSI6NiwiciI6N319AAAAAAAAAAAAAAAAAEABAAAAAAAABgAAADE1MTIuMAAALwEAAHsid2FzX2ZpcnN0X2V2ZW50Ijp0cnVlLCJpbWFnZV9pZCI6WzI5NDg2MzA3OTIsMjQ4MjEzNjcxMSwxNTEyNjE4NjkyLDMxOTcwODI0MTgsODIwOTYzODY4LDQ2MzI0MzAwNSwyODE1MTMwMDQ1LDM4MzUzNTQ2NTddLCJxZiI6eyJiIjpbMCw0LDAsMCwwLDAsMCwwLDAsNCwwLDAsMCwwLDAsMCwwLDAsMTI4LDI2LDAsMCwwLDAsMCwwLDAsMCwwLDAsMCwwLDAsMCwwLDAsMCwwLDAsMCwwLDAsMCwwLDAsMCwwLDAsMCwwLDAsMCwwLDAsMCwwLDAsMCwwLDAsMCwwLDAsMCwwLDAsMCwwLDAsMCwwLDAsMF0sImwiOjEsInEiOjYsInIiOjd9fQAAAAAAAAAAAAAAAAAAAAAAAAAAAAAAAAAAAAAAAAAAAA=='}}
prove_30;14;59;Mul;826;62977;826.0;841;0.0673464999999851;{'verificationValue': 826.0, 'proof': {'imageId': [2948630792, 2482136711, 1512618692, 3197082418, 820963868, 463243005, 2815130045, 3835354657], 'receipt': 'AwAAAAAAAAAAAAAAxAciAPPsD8genbvcCN2DvDmorNgPyU2p6hAM/h+8IU0pSDuhAAAAAAAAAAAAAAAAAAAAAAAAAAAAAAAAAAAAAAAAAAAAAAAAAAAAAAAAAAAAAAAAAQAAAAAAAAAAAAAAAAAAAAAAAAAAAAAAAAAAAAAAAAAAAAAAAAAAAAEAAAAAQAEAAAAAAAAFAAAAODI2LjAAAAAvAQAAeyJ3YXNfZmlyc3RfZXZlbnQiOnRydWUsImltYWdlX2lkIjpbMjk0ODYzMDc5MiwyNDgyMTM2NzExLDE1MTI2MTg2OTIsMzE5NzA4MjQxOCw4MjA5NjM4NjgsNDYzMjQzMDA1LDI4MTUxMzAwNDUsMzgzNTM1NDY1N10sInFmIjp7ImIiOlswLDQsMCwwLDAsMCwwLDAsMCw0LDAsMCwwLDAsMCwwLDAsMCwxMjgsMjYsMCwwLDAsMCwwLDAsMCwwLDAsMCwwLDAsMCwwLDAsMCwwLDAsMCwwLDAsMCwwLDAsMCwwLDAsMCwwLDAsMCwwLDAsMCwwLDAsMCwwLDAsMCwwLDAsMCwwLDAsMCwwLDAsMCwwLDAsMCwwXSwibCI6MSwicSI6NiwiciI6N319AAAAAAAAAAAAAAAAAEABAAAAAAAABQAAADgyNi4wAAAALwEAAHsid2FzX2ZpcnN0X2V2ZW50Ijp0cnVlLCJpbWFnZV9pZCI6WzI5NDg2MzA3OTIsMjQ4MjEzNjcxMSwxNTEyNjE4NjkyLDMxOTcwODI0MTgsODIwOTYzODY4LDQ2MzI0MzAwNSwyODE1MTMwMDQ1LDM4MzUzNTQ2NTddLCJxZiI6eyJiIjpbMCw0LDAsMCwwLDAsMCwwLDAsNCwwLDAsMCwwLDAsMCwwLDAsMTI4LDI2LDAsMCwwLDAsMCwwLDAsMCwwLDAsMCwwLDAsMCwwLDAsMCwwLDAsMCwwLDAsMCwwLDAsMCwwLDAsMCwwLDAsMCwwLDAsMCwwLDAsMCwwLDAsMCwwLDAsMCwwLDAsMCwwLDAsMCwwLDAsMF0sImwiOjEsInEiOjYsInIiOjd9fQAAAAAAAAAAAAAAAAAAAAAAAAAAAAAAAAAAAAAAAAAAAA=='}}
prove_31;26;59;Mul;1534;64511;1534.0;841;0.06842874999892956;{'verificationValue': 1534.0, 'proof': {'imageId': [2948630792, 2482136711, 1512618692, 3197082418, 820963868, 463243005, 2815130045, 3835354657], 'receipt': 'AwAAAAAAAAAAAAAAxAciAPPsD8genbvcCN2DvDmorNgPyU2p6hAM/h+8IU0pSDuhAAAAAAAAAAAAAAAAAAAAAAAAAAAAAAAAAAAAAAAAAAAAAAAAAAAAAAAAAAAAAAAAAQAAAAAAAAAAAAAAAAAAAAAAAAAAAAAAAAAAAAAAAAAAAAAAAAAAAAEAAAAAQAEAAAAAAAAGAAAAMTUzNC4wAAAvAQAAeyJ3YXNfZmlyc3RfZXZlbnQiOnRydWUsImltYWdlX2lkIjpbMjk0ODYzMDc5MiwyNDgyMTM2NzExLDE1MTI2MTg2OTIsMzE5NzA4MjQxOCw4MjA5NjM4NjgsNDYzMjQzMDA1LDI4MTUxMzAwNDUsMzgzNTM1NDY1N10sInFmIjp7ImIiOlswLDQsMCwwLDAsMCwwLDAsMCw0LDAsMCwwLDAsMCwwLDAsMCwxMjgsMjYsMCwwLDAsMCwwLDAsMCwwLDAsMCwwLDAsMCwwLDAsMCwwLDAsMCwwLDAsMCwwLDAsMCwwLDAsMCwwLDAsMCwwLDAsMCwwLDAsMCwwLDAsMCwwLDAsMCwwLDAsMCwwLDAsMCwwLDAsMCwwXSwibCI6MSwicSI6NiwiciI6N319AAAAAAAAAAAAAAAAAEABAAAAAAAABgAAADE1MzQuMAAALwEAAHsid2FzX2ZpcnN0X2V2ZW50Ijp0cnVlLCJpbWFnZV9pZCI6WzI5NDg2MzA3OTIsMjQ4MjEzNjcxMSwxNTEyNjE4NjkyLDMxOTcwODI0MTgsODIwOTYzODY4LDQ2MzI0MzAwNSwyODE1MTMwMDQ1LDM4MzUzNTQ2NTddLCJxZiI6eyJiIjpbMCw0LDAsMCwwLDAsMCwwLDAsNCwwLDAsMCwwLDAsMCwwLDAsMTI4LDI2LDAsMCwwLDAsMCwwLDAsMCwwLDAsMCwwLDAsMCwwLDAsMCwwLDAsMCwwLDAsMCwwLDAsMCwwLDAsMCwwLDAsMCwwLDAsMCwwLDAsMCwwLDAsMCwwLDAsMCwwLDAsMCwwLDAsMCwwLDAsMF0sImwiOjEsInEiOjYsInIiOjd9fQAAAAAAAAAAAAAAAAAAAAAAAAAAAAAAAAAAAAAAAAAAAA=='}}
prove_32;40;54;Mul;2160;66671;2160.0;841;0.0678485839998757;{'verificationValue': 2160.0, 'proof': {'imageId': [2948630792, 2482136711, 1512618692, 3197082418, 820963868, 463243005, 2815130045, 3835354657], 'receipt': 'AwAAAAAAAAAAAAAAxAciAPPsD8genbvcCN2DvDmorNgPyU2p6hAM/h+8IU0pSDuhAAAAAAAAAAAAAAAAAAAAAAAAAAAAAAAAAAAAAAAAAAAAAAAAAAAAAAAAAAAAAAAAAQAAAAAAAAAAAAAAAAAAAAAAAAAAAAAAAAAAAAAAAAAAAAAAAAAAAAEAAAAAQAEAAAAAAAAGAAAAMjE2MC4wAAAvAQAAeyJ3YXNfZmlyc3RfZXZlbnQiOnRydWUsImltYWdlX2lkIjpbMjk0ODYzMDc5MiwyNDgyMTM2NzExLDE1MTI2MTg2OTIsMzE5NzA4MjQxOCw4MjA5NjM4NjgsNDYzMjQzMDA1LDI4MTUxMzAwNDUsMzgzNTM1NDY1N10sInFmIjp7ImIiOlswLDQsMCwwLDAsMCwwLDAsMCw0LDAsMCwwLDAsMCwwLDAsMCwxMjgsMjYsMCwwLDAsMCwwLDAsMCwwLDAsMCwwLDAsMCwwLDAsMCwwLDAsMCwwLDAsMCwwLDAsMCwwLDAsMCwwLDAsMCwwLDAsMCwwLDAsMCwwLDAsMCwwLDAsMCwwLDAsMCwwLDAsMCwwLDAsMCwwXSwibCI6MSwicSI6NiwiciI6N319AAAAAAAAAAAAAAAAAEABAAAAAAAABgAAADIxNjAuMAAALwEAAHsid2FzX2ZpcnN0X2V2ZW50Ijp0cnVlLCJpbWFnZV9pZCI6WzI5NDg2MzA3OTIsMjQ4MjEzNjcxMSwxNTEyNjE4NjkyLDMxOTcwODI0MTgsODIwOTYzODY4LDQ2MzI0MzAwNSwyODE1MTMwMDQ1LDM4MzUzNTQ2NTddLCJxZiI6eyJiIjpbMCw0LDAsMCwwLDAsMCwwLDAsNCwwLDAsMCwwLDAsMCwwLDAsMTI4LDI2LDAsMCwwLDAsMCwwLDAsMCwwLDAsMCwwLDAsMCwwLDAsMCwwLDAsMCwwLDAsMCwwLDAsMCwwLDAsMCwwLDAsMCwwLDAsMCwwLDAsMCwwLDAsMCwwLDAsMCwwLDAsMCwwLDAsMCwwLDAsMF0sImwiOjEsInEiOjYsInIiOjd9fQAAAAAAAAAAAAAAAAAAAAAAAAAAAAAAAAAAAAAAAAAAAA=='}}
prove_33;27;83;Mul;2241;68912;2241.0;841;0.0680962919996091;{'verificationValue': 2241.0, 'proof': {'imageId': [2948630792, 2482136711, 1512618692, 3197082418, 820963868, 463243005, 2815130045, 3835354657], 'receipt': 'AwAAAAAAAAAAAAAAxAciAPPsD8genbvcCN2DvDmorNgPyU2p6hAM/h+8IU0pSDuhAAAAAAAAAAAAAAAAAAAAAAAAAAAAAAAAAAAAAAAAAAAAAAAAAAAAAAAAAAAAAAAAAQAAAAAAAAAAAAAAAAAAAAAAAAAAAAAAAAAAAAAAAAAAAAAAAAAAAAEAAAAAQAEAAAAAAAAGAAAAMjI0MS4wAAAvAQAAeyJ3YXNfZmlyc3RfZXZlbnQiOnRydWUsImltYWdlX2lkIjpbMjk0ODYzMDc5MiwyNDgyMTM2NzExLDE1MTI2MTg2OTIsMzE5NzA4MjQxOCw4MjA5NjM4NjgsNDYzMjQzMDA1LDI4MTUxMzAwNDUsMzgzNTM1NDY1N10sInFmIjp7ImIiOlswLDQsMCwwLDAsMCwwLDAsMCw0LDAsMCwwLDAsMCwwLDAsMCwxMjgsMjYsMCwwLDAsMCwwLDAsMCwwLDAsMCwwLDAsMCwwLDAsMCwwLDAsMCwwLDAsMCwwLDAsMCwwLDAsMCwwLDAsMCwwLDAsMCwwLDAsMCwwLDAsMCwwLDAsMCwwLDAsMCwwLDAsMCwwLDAsMCwwXSwibCI6MSwicSI6NiwiciI6N319AAAAAAAAAAAAAAAAAEABAAAAAAAABgAAADIyNDEuMAAALwEAAHsid2FzX2ZpcnN0X2V2ZW50Ijp0cnVlLCJpbWFnZV9pZCI6WzI5NDg2MzA3OTIsMjQ4MjEzNjcxMSwxNTEyNjE4NjkyLDMxOTcwODI0MTgsODIwOTYzODY4LDQ2MzI0MzAwNSwyODE1MTMwMDQ1LDM4MzUzNTQ2NTddLCJxZiI6eyJiIjpbMCw0LDAsMCwwLDAsMCwwLDAsNCwwLDAsMCwwLDAsMCwwLDAsMTI4LDI2LDAsMCwwLDAsMCwwLDAsMCwwLDAsMCwwLDAsMCwwLDAsMCwwLDAsMCwwLDAsMCwwLDAsMCwwLDAsMCwwLDAsMCwwLDAsMCwwLDAsMCwwLDAsMCwwLDAsMCwwLDAsMCwwLDAsMCwwLDAsMF0sImwiOjEsInEiOjYsInIiOjd9fQAAAAAAAAAAAAAAAAAAAAAAAAAAAAAAAAAAAAAAAAAAAA=='}}
prove_34;55;20;Mul;1100;70012;1100.0;841;0.06933916699927067;{'verificationValue': 1100.0, 'proof': {'imageId': [2948630792, 2482136711, 1512618692, 3197082418, 820963868, 463243005, 2815130045, 3835354657], 'receipt': 'AwAAAAAAAAAAAAAAxAciAPPsD8genbvcCN2DvDmorNgPyU2p6hAM/h+8IU0pSDuhAAAAAAAAAAAAAAAAAAAAAAAAAAAAAAAAAAAAAAAAAAAAAAAAAAAAAAAAAAAAAAAAAQAAAAAAAAAAAAAAAAAAAAAAAAAAAAAAAAAAAAAAAAAAAAAAAAAAAAEAAAAAQAEAAAAAAAAGAAAAMTEwMC4wAAAvAQAAeyJ3YXNfZmlyc3RfZXZlbnQiOnRydWUsImltYWdlX2lkIjpbMjk0ODYzMDc5MiwyNDgyMTM2NzExLDE1MTI2MTg2OTIsMzE5NzA4MjQxOCw4MjA5NjM4NjgsNDYzMjQzMDA1LDI4MTUxMzAwNDUsMzgzNTM1NDY1N10sInFmIjp7ImIiOlswLDQsMCwwLDAsMCwwLDAsMCw0LDAsMCwwLDAsMCwwLDAsMCwxMjgsMjYsMCwwLDAsMCwwLDAsMCwwLDAsMCwwLDAsMCwwLDAsMCwwLDAsMCwwLDAsMCwwLDAsMCwwLDAsMCwwLDAsMCwwLDAsMCwwLDAsMCwwLDAsMCwwLDAsMCwwLDAsMCwwLDAsMCwwLDAsMCwwXSwibCI6MSwicSI6NiwiciI6N319AAAAAAAAAAAAAAAAAEABAAAAAAAABgAAADExMDAuMAAALwEAAHsid2FzX2ZpcnN0X2V2ZW50Ijp0cnVlLCJpbWFnZV9pZCI6WzI5NDg2MzA3OTIsMjQ4MjEzNjcxMSwxNTEyNjE4NjkyLDMxOTcwODI0MTgsODIwOTYzODY4LDQ2MzI0MzAwNSwyODE1MTMwMDQ1LDM4MzUzNTQ2NTddLCJxZiI6eyJiIjpbMCw0LDAsMCwwLDAsMCwwLDAsNCwwLDAsMCwwLDAsMCwwLDAsMTI4LDI2LDAsMCwwLDAsMCwwLDAsMCwwLDAsMCwwLDAsMCwwLDAsMCwwLDAsMCwwLDAsMCwwLDAsMCwwLDAsMCwwLDAsMCwwLDAsMCwwLDAsMCwwLDAsMCwwLDAsMCwwLDAsMCwwLDAsMCwwLDAsMF0sImwiOjEsInEiOjYsInIiOjd9fQAAAAAAAAAAAAAAAAAAAAAAAAAAAAAAAAAAAAAAAAAAAA=='}}
prove_35;26;98;Mul;2548;72560;2548.0;841;0.06806270800007042;{'verificationValue': 2548.0, 'proof': {'imageId': [2948630792, 2482136711, 1512618692, 3197082418, 820963868, 463243005, 2815130045, 3835354657], 'receipt': 'AwAAAAAAAAAAAAAAxAciAPPsD8genbvcCN2DvDmorNgPyU2p6hAM/h+8IU0pSDuhAAAAAAAAAAAAAAAAAAAAAAAAAAAAAAAAAAAAAAAAAAAAAAAAAAAAAAAAAAAAAAAAAQAAAAAAAAAAAAAAAAAAAAAAAAAAAAAAAAAAAAAAAAAAAAAAAAAAAAEAAAAAQAEAAAAAAAAGAAAAMjU0OC4wAAAvAQAAeyJ3YXNfZmlyc3RfZXZlbnQiOnRydWUsImltYWdlX2lkIjpbMjk0ODYzMDc5MiwyNDgyMTM2NzExLDE1MTI2MTg2OTIsMzE5NzA4MjQxOCw4MjA5NjM4NjgsNDYzMjQzMDA1LDI4MTUxMzAwNDUsMzgzNTM1NDY1N10sInFmIjp7ImIiOlswLDQsMCwwLDAsMCwwLDAsMCw0LDAsMCwwLDAsMCwwLDAsMCwxMjgsMjYsMCwwLDAsMCwwLDAsMCwwLDAsMCwwLDAsMCwwLDAsMCwwLDAsMCwwLDAsMCwwLDAsMCwwLDAsMCwwLDAsMCwwLDAsMCwwLDAsMCwwLDAsMCwwLDAsMCwwLDAsMCwwLDAsMCwwLDAsMCwwXSwibCI6MSwicSI6NiwiciI6N319AAAAAAAAAAAAAAAAAEABAAAAAAAABgAAADI1NDguMAAALwEAAHsid2FzX2ZpcnN0X2V2ZW50Ijp0cnVlLCJpbWFnZV9pZCI6WzI5NDg2MzA3OTIsMjQ4MjEzNjcxMSwxNTEyNjE4NjkyLDMxOTcwODI0MTgsODIwOTYzODY4LDQ2MzI0MzAwNSwyODE1MTMwMDQ1LDM4MzUzNTQ2NTddLCJxZiI6eyJiIjpbMCw0LDAsMCwwLDAsMCwwLDAsNCwwLDAsMCwwLDAsMCwwLDAsMTI4LDI2LDAsMCwwLDAsMCwwLDAsMCwwLDAsMCwwLDAsMCwwLDAsMCwwLDAsMCwwLDAsMCwwLDAsMCwwLDAsMCwwLDAsMCwwLDAsMCwwLDAsMCwwLDAsMCwwLDAsMCwwLDAsMCwwLDAsMCwwLDAsMF0sImwiOjEsInEiOjYsInIiOjd9fQAAAAAAAAAAAAAAAAAAAAAAAAAAAAAAAAAAAAAAAAAAAA=='}}
prove_36;32;60;Mul;1920;74480;1920.0;841;0.06774616700022307;{'verificationValue': 1920.0, 'proof': {'imageId': [2948630792, 2482136711, 1512618692, 3197082418, 820963868, 463243005, 2815130045, 3835354657], 'receipt': 'AwAAAAAAAAAAAAAAxAciAPPsD8genbvcCN2DvDmorNgPyU2p6hAM/h+8IU0pSDuhAAAAAAAAAAAAAAAAAAAAAAAAAAAAAAAAAAAAAAAAAAAAAAAAAAAAAAAAAAAAAAAAAQAAAAAAAAAAAAAAAAAAAAAAAAAAAAAAAAAAAAAAAAAAAAAAAAAAAAEAAAAAQAEAAAAAAAAGAAAAMTkyMC4wAAAvAQAAeyJ3YXNfZmlyc3RfZXZlbnQiOnRydWUsImltYWdlX2lkIjpbMjk0ODYzMDc5MiwyNDgyMTM2NzExLDE1MTI2MTg2OTIsMzE5NzA4MjQxOCw4MjA5NjM4NjgsNDYzMjQzMDA1LDI4MTUxMzAwNDUsMzgzNTM1NDY1N10sInFmIjp7ImIiOlswLDQsMCwwLDAsMCwwLDAsMCw0LDAsMCwwLDAsMCwwLDAsMCwxMjgsMjYsMCwwLDAsMCwwLDAsMCwwLDAsMCwwLDAsMCwwLDAsMCwwLDAsMCwwLDAsMCwwLDAsMCwwLDAsMCwwLDAsMCwwLDAsMCwwLDAsMCwwLDAsMCwwLDAsMCwwLDAsMCwwLDAsMCwwLDAsMCwwXSwibCI6MSwicSI6NiwiciI6N319AAAAAAAAAAAAAAAAAEABAAAAAAAABgAAADE5MjAuMAAALwEAAHsid2FzX2ZpcnN0X2V2ZW50Ijp0cnVlLCJpbWFnZV9pZCI6WzI5NDg2MzA3OTIsMjQ4MjEzNjcxMSwxNTEyNjE4NjkyLDMxOTcwODI0MTgsODIwOTYzODY4LDQ2MzI0MzAwNSwyODE1MTMwMDQ1LDM4MzUzNTQ2NTddLCJxZiI6eyJiIjpbMCw0LDAsMCwwLDAsMCwwLDAsNCwwLDAsMCwwLDAsMCwwLDAsMTI4LDI2LDAsMCwwLDAsMCwwLDAsMCwwLDAsMCwwLDAsMCwwLDAsMCwwLDAsMCwwLDAsMCwwLDAsMCwwLDAsMCwwLDAsMCwwLDAsMCwwLDAsMCwwLDAsMCwwLDAsMCwwLDAsMCwwLDAsMCwwLDAsMF0sImwiOjEsInEiOjYsInIiOjd9fQAAAAAAAAAAAAAAAAAAAAAAAAAAAAAAAAAAAAAAAAAAAA=='}}
prove_37;75;92;Mul;6900;81380;6900.0;841;0.06810683300136589;{'verificationValue': 6900.0, 'proof': {'imageId': [2948630792, 2482136711, 1512618692, 3197082418, 820963868, 463243005, 2815130045, 3835354657], 'receipt': 'AwAAAAAAAAAAAAAAxAciAPPsD8genbvcCN2DvDmorNgPyU2p6hAM/h+8IU0pSDuhAAAAAAAAAAAAAAAAAAAAAAAAAAAAAAAAAAAAAAAAAAAAAAAAAAAAAAAAAAAAAAAAAQAAAAAAAAAAAAAAAAAAAAAAAAAAAAAAAAAAAAAAAAAAAAAAAAAAAAEAAAAAQAEAAAAAAAAGAAAANjkwMC4wAAAvAQAAeyJ3YXNfZmlyc3RfZXZlbnQiOnRydWUsImltYWdlX2lkIjpbMjk0ODYzMDc5MiwyNDgyMTM2NzExLDE1MTI2MTg2OTIsMzE5NzA4MjQxOCw4MjA5NjM4NjgsNDYzMjQzMDA1LDI4MTUxMzAwNDUsMzgzNTM1NDY1N10sInFmIjp7ImIiOlswLDQsMCwwLDAsMCwwLDAsMCw0LDAsMCwwLDAsMCwwLDAsMCwxMjgsMjYsMCwwLDAsMCwwLDAsMCwwLDAsMCwwLDAsMCwwLDAsMCwwLDAsMCwwLDAsMCwwLDAsMCwwLDAsMCwwLDAsMCwwLDAsMCwwLDAsMCwwLDAsMCwwLDAsMCwwLDAsMCwwLDAsMCwwLDAsMCwwXSwibCI6MSwicSI6NiwiciI6N319AAAAAAAAAAAAAAAAAEABAAAAAAAABgAAADY5MDAuMAAALwEAAHsid2FzX2ZpcnN0X2V2ZW50Ijp0cnVlLCJpbWFnZV9pZCI6WzI5NDg2MzA3OTIsMjQ4MjEzNjcxMSwxNTEyNjE4NjkyLDMxOTcwODI0MTgsODIwOTYzODY4LDQ2MzI0MzAwNSwyODE1MTMwMDQ1LDM4MzUzNTQ2NTddLCJxZiI6eyJiIjpbMCw0LDAsMCwwLDAsMCwwLDAsNCwwLDAsMCwwLDAsMCwwLDAsMTI4LDI2LDAsMCwwLDAsMCwwLDAsMCwwLDAsMCwwLDAsMCwwLDAsMCwwLDAsMCwwLDAsMCwwLDAsMCwwLDAsMCwwLDAsMCwwLDAsMCwwLDAsMCwwLDAsMCwwLDAsMCwwLDAsMCwwLDAsMCwwLDAsMF0sImwiOjEsInEiOjYsInIiOjd9fQAAAAAAAAAAAAAAAAAAAAAAAAAAAAAAAAAAAAAAAAAAAA=='}}
prove_38;99;40;Mul;3960;85340;3960.0;841;0.06750220799949602;{'verificationValue': 3960.0, 'proof': {'imageId': [2948630792, 2482136711, 1512618692, 3197082418, 820963868, 463243005, 2815130045, 3835354657], 'receipt': 'AwAAAAAAAAAAAAAAxAciAPPsD8genbvcCN2DvDmorNgPyU2p6hAM/h+8IU0pSDuhAAAAAAAAAAAAAAAAAAAAAAAAAAAAAAAAAAAAAAAAAAAAAAAAAAAAAAAAAAAAAAAAAQAAAAAAAAAAAAAAAAAAAAAAAAAAAAAAAAAAAAAAAAAAAAAAAAAAAAEAAAAAQAEAAAAAAAAGAAAAMzk2MC4wAAAvAQAAeyJ3YXNfZmlyc3RfZXZlbnQiOnRydWUsImltYWdlX2lkIjpbMjk0ODYzMDc5MiwyNDgyMTM2NzExLDE1MTI2MTg2OTIsMzE5NzA4MjQxOCw4MjA5NjM4NjgsNDYzMjQzMDA1LDI4MTUxMzAwNDUsMzgzNTM1NDY1N10sInFmIjp7ImIiOlswLDQsMCwwLDAsMCwwLDAsMCw0LDAsMCwwLDAsMCwwLDAsMCwxMjgsMjYsMCwwLDAsMCwwLDAsMCwwLDAsMCwwLDAsMCwwLDAsMCwwLDAsMCwwLDAsMCwwLDAsMCwwLDAsMCwwLDAsMCwwLDAsMCwwLDAsMCwwLDAsMCwwLDAsMCwwLDAsMCwwLDAsMCwwLDAsMCwwXSwibCI6MSwicSI6NiwiciI6N319AAAAAAAAAAAAAAAAAEABAAAAAAAABgAAADM5NjAuMAAALwEAAHsid2FzX2ZpcnN0X2V2ZW50Ijp0cnVlLCJpbWFnZV9pZCI6WzI5NDg2MzA3OTIsMjQ4MjEzNjcxMSwxNTEyNjE4NjkyLDMxOTcwODI0MTgsODIwOTYzODY4LDQ2MzI0MzAwNSwyODE1MTMwMDQ1LDM4MzUzNTQ2NTddLCJxZiI6eyJiIjpbMCw0LDAsMCwwLDAsMCwwLDAsNCwwLDAsMCwwLDAsMCwwLDAsMTI4LDI2LDAsMCwwLDAsMCwwLDAsMCwwLDAsMCwwLDAsMCwwLDAsMCwwLDAsMCwwLDAsMCwwLDAsMCwwLDAsMCwwLDAsMCwwLDAsMCwwLDAsMCwwLDAsMCwwLDAsMCwwLDAsMCwwLDAsMCwwLDAsMF0sImwiOjEsInEiOjYsInIiOjd9fQAAAAAAAAAAAAAAAAAAAAAAAAAAAAAAAAAAAAAAAAAAAA=='}}
prove_39;66;75;Mul;4950;90290;4950.0;841;0.06813804200101004;{'verificationValue': 4950.0, 'proof': {'imageId': [2948630792, 2482136711, 1512618692, 3197082418, 820963868, 463243005, 2815130045, 3835354657], 'receipt': 'AwAAAAAAAAAAAAAAxAciAPPsD8genbvcCN2DvDmorNgPyU2p6hAM/h+8IU0pSDuhAAAAAAAAAAAAAAAAAAAAAAAAAAAAAAAAAAAAAAAAAAAAAAAAAAAAAAAAAAAAAAAAAQAAAAAAAAAAAAAAAAAAAAAAAAAAAAAAAAAAAAAAAAAAAAAAAAAAAAEAAAAAQAEAAAAAAAAGAAAANDk1MC4wAAAvAQAAeyJ3YXNfZmlyc3RfZXZlbnQiOnRydWUsImltYWdlX2lkIjpbMjk0ODYzMDc5MiwyNDgyMTM2NzExLDE1MTI2MTg2OTIsMzE5NzA4MjQxOCw4MjA5NjM4NjgsNDYzMjQzMDA1LDI4MTUxMzAwNDUsMzgzNTM1NDY1N10sInFmIjp7ImIiOlswLDQsMCwwLDAsMCwwLDAsMCw0LDAsMCwwLDAsMCwwLDAsMCwxMjgsMjYsMCwwLDAsMCwwLDAsMCwwLDAsMCwwLDAsMCwwLDAsMCwwLDAsMCwwLDAsMCwwLDAsMCwwLDAsMCwwLDAsMCwwLDAsMCwwLDAsMCwwLDAsMCwwLDAsMCwwLDAsMCwwLDAsMCwwLDAsMCwwXSwibCI6MSwicSI6NiwiciI6N319AAAAAAAAAAAAAAAAAEABAAAAAAAABgAAADQ5NTAuMAAALwEAAHsid2FzX2ZpcnN0X2V2ZW50Ijp0cnVlLCJpbWFnZV9pZCI6WzI5NDg2MzA3OTIsMjQ4MjEzNjcxMSwxNTEyNjE4NjkyLDMxOTcwODI0MTgsODIwOTYzODY4LDQ2MzI0MzAwNSwyODE1MTMwMDQ1LDM4MzUzNTQ2NTddLCJxZiI6eyJiIjpbMCw0LDAsMCwwLDAsMCwwLDAsNCwwLDAsMCwwLDAsMCwwLDAsMTI4LDI2LDAsMCwwLDAsMCwwLDAsMCwwLDAsMCwwLDAsMCwwLDAsMCwwLDAsMCwwLDAsMCwwLDAsMCwwLDAsMCwwLDAsMCwwLDAsMCwwLDAsMCwwLDAsMCwwLDAsMCwwLDAsMCwwLDAsMCwwLDAsMF0sImwiOjEsInEiOjYsInIiOjd9fQAAAAAAAAAAAAAAAAAAAAAAAAAAAAAAAAAAAAAAAAAAAA=='}}
prove_40;54;53;Mul;2862;93152;2862.0;841;0.0673875840002438;{'verificationValue': 2862.0, 'proof': {'imageId': [2948630792, 2482136711, 1512618692, 3197082418, 820963868, 463243005, 2815130045, 3835354657], 'receipt': 'AwAAAAAAAAAAAAAAxAciAPPsD8genbvcCN2DvDmorNgPyU2p6hAM/h+8IU0pSDuhAAAAAAAAAAAAAAAAAAAAAAAAAAAAAAAAAAAAAAAAAAAAAAAAAAAAAAAAAAAAAAAAAQAAAAAAAAAAAAAAAAAAAAAAAAAAAAAAAAAAAAAAAAAAAAAAAAAAAAEAAAAAQAEAAAAAAAAGAAAAMjg2Mi4wAAAvAQAAeyJ3YXNfZmlyc3RfZXZlbnQiOnRydWUsImltYWdlX2lkIjpbMjk0ODYzMDc5MiwyNDgyMTM2NzExLDE1MTI2MTg2OTIsMzE5NzA4MjQxOCw4MjA5NjM4NjgsNDYzMjQzMDA1LDI4MTUxMzAwNDUsMzgzNTM1NDY1N10sInFmIjp7ImIiOlswLDQsMCwwLDAsMCwwLDAsMCw0LDAsMCwwLDAsMCwwLDAsMCwxMjgsMjYsMCwwLDAsMCwwLDAsMCwwLDAsMCwwLDAsMCwwLDAsMCwwLDAsMCwwLDAsMCwwLDAsMCwwLDAsMCwwLDAsMCwwLDAsMCwwLDAsMCwwLDAsMCwwLDAsMCwwLDAsMCwwLDAsMCwwLDAsMCwwXSwibCI6MSwicSI6NiwiciI6N319AAAAAAAAAAAAAAAAAEABAAAAAAAABgAAADI4NjIuMAAALwEAAHsid2FzX2ZpcnN0X2V2ZW50Ijp0cnVlLCJpbWFnZV9pZCI6WzI5NDg2MzA3OTIsMjQ4MjEzNjcxMSwxNTEyNjE4NjkyLDMxOTcwODI0MTgsODIwOTYzODY4LDQ2MzI0MzAwNSwyODE1MTMwMDQ1LDM4MzUzNTQ2NTddLCJxZiI6eyJiIjpbMCw0LDAsMCwwLDAsMCwwLDAsNCwwLDAsMCwwLDAsMCwwLDAsMTI4LDI2LDAsMCwwLDAsMCwwLDAsMCwwLDAsMCwwLDAsMCwwLDAsMCwwLDAsMCwwLDAsMCwwLDAsMCwwLDAsMCwwLDAsMCwwLDAsMCwwLDAsMCwwLDAsMCwwLDAsMCwwLDAsMCwwLDAsMCwwLDAsMF0sImwiOjEsInEiOjYsInIiOjd9fQAAAAAAAAAAAAAAAAAAAAAAAAAAAAAAAAAAAAAAAAAAAA=='}}
prove_41;8;43;Mul;344;93496;344.0;841;0.06816008299938403;{'verificationValue': 344.0, 'proof': {'imageId': [2948630792, 2482136711, 1512618692, 3197082418, 820963868, 463243005, 2815130045, 3835354657], 'receipt': 'AwAAAAAAAAAAAAAAxAciAPPsD8genbvcCN2DvDmorNgPyU2p6hAM/h+8IU0pSDuhAAAAAAAAAAAAAAAAAAAAAAAAAAAAAAAAAAAAAAAAAAAAAAAAAAAAAAAAAAAAAAAAAQAAAAAAAAAAAAAAAAAAAAAAAAAAAAAAAAAAAAAAAAAAAAAAAAAAAAEAAAAAQAEAAAAAAAAFAAAAMzQ0LjAAAAAvAQAAeyJ3YXNfZmlyc3RfZXZlbnQiOnRydWUsImltYWdlX2lkIjpbMjk0ODYzMDc5MiwyNDgyMTM2NzExLDE1MTI2MTg2OTIsMzE5NzA4MjQxOCw4MjA5NjM4NjgsNDYzMjQzMDA1LDI4MTUxMzAwNDUsMzgzNTM1NDY1N10sInFmIjp7ImIiOlswLDQsMCwwLDAsMCwwLDAsMCw0LDAsMCwwLDAsMCwwLDAsMCwxMjgsMjYsMCwwLDAsMCwwLDAsMCwwLDAsMCwwLDAsMCwwLDAsMCwwLDAsMCwwLDAsMCwwLDAsMCwwLDAsMCwwLDAsMCwwLDAsMCwwLDAsMCwwLDAsMCwwLDAsMCwwLDAsMCwwLDAsMCwwLDAsMCwwXSwibCI6MSwicSI6NiwiciI6N319AAAAAAAAAAAAAAAAAEABAAAAAAAABQAAADM0NC4wAAAALwEAAHsid2FzX2ZpcnN0X2V2ZW50Ijp0cnVlLCJpbWFnZV9pZCI6WzI5NDg2MzA3OTIsMjQ4MjEzNjcxMSwxNTEyNjE4NjkyLDMxOTcwODI0MTgsODIwOTYzODY4LDQ2MzI0MzAwNSwyODE1MTMwMDQ1LDM4MzUzNTQ2NTddLCJxZiI6eyJiIjpbMCw0LDAsMCwwLDAsMCwwLDAsNCwwLDAsMCwwLDAsMCwwLDAsMTI4LDI2LDAsMCwwLDAsMCwwLDAsMCwwLDAsMCwwLDAsMCwwLDAsMCwwLDAsMCwwLDAsMCwwLDAsMCwwLDAsMCwwLDAsMCwwLDAsMCwwLDAsMCwwLDAsMCwwLDAsMCwwLDAsMCwwLDAsMCwwLDAsMF0sImwiOjEsInEiOjYsInIiOjd9fQAAAAAAAAAAAAAAAAAAAAAAAAAAAAAAAAAAAAAAAAAAAA=='}}
prove_42;83;49;Mul;4067;97563;4067.0;841;0.06813737499942363;{'verificationValue': 4067.0, 'proof': {'imageId': [2948630792, 2482136711, 1512618692, 3197082418, 820963868, 463243005, 2815130045, 3835354657], 'receipt': 'AwAAAAAAAAAAAAAAxAciAPPsD8genbvcCN2DvDmorNgPyU2p6hAM/h+8IU0pSDuhAAAAAAAAAAAAAAAAAAAAAAAAAAAAAAAAAAAAAAAAAAAAAAAAAAAAAAAAAAAAAAAAAQAAAAAAAAAAAAAAAAAAAAAAAAAAAAAAAAAAAAAAAAAAAAAAAAAAAAEAAAAAQAEAAAAAAAAGAAAANDA2Ny4wAAAvAQAAeyJ3YXNfZmlyc3RfZXZlbnQiOnRydWUsImltYWdlX2lkIjpbMjk0ODYzMDc5MiwyNDgyMTM2NzExLDE1MTI2MTg2OTIsMzE5NzA4MjQxOCw4MjA5NjM4NjgsNDYzMjQzMDA1LDI4MTUxMzAwNDUsMzgzNTM1NDY1N10sInFmIjp7ImIiOlswLDQsMCwwLDAsMCwwLDAsMCw0LDAsMCwwLDAsMCwwLDAsMCwxMjgsMjYsMCwwLDAsMCwwLDAsMCwwLDAsMCwwLDAsMCwwLDAsMCwwLDAsMCwwLDAsMCwwLDAsMCwwLDAsMCwwLDAsMCwwLDAsMCwwLDAsMCwwLDAsMCwwLDAsMCwwLDAsMCwwLDAsMCwwLDAsMCwwXSwibCI6MSwicSI6NiwiciI6N319AAAAAAAAAAAAAAAAAEABAAAAAAAABgAAADQwNjcuMAAALwEAAHsid2FzX2ZpcnN0X2V2ZW50Ijp0cnVlLCJpbWFnZV9pZCI6WzI5NDg2MzA3OTIsMjQ4MjEzNjcxMSwxNTEyNjE4NjkyLDMxOTcwODI0MTgsODIwOTYzODY4LDQ2MzI0MzAwNSwyODE1MTMwMDQ1LDM4MzUzNTQ2NTddLCJxZiI6eyJiIjpbMCw0LDAsMCwwLDAsMCwwLDAsNCwwLDAsMCwwLDAsMCwwLDAsMTI4LDI2LDAsMCwwLDAsMCwwLDAsMCwwLDAsMCwwLDAsMCwwLDAsMCwwLDAsMCwwLDAsMCwwLDAsMCwwLDAsMCwwLDAsMCwwLDAsMCwwLDAsMCwwLDAsMCwwLDAsMCwwLDAsMCwwLDAsMCwwLDAsMF0sImwiOjEsInEiOjYsInIiOjd9fQAAAAAAAAAAAAAAAAAAAAAAAAAAAAAAAAAAAAAAAAAAAA=='}}
prove_43;85;26;Mul;2210;99773;2210.0;841;0.06886829200084321;{'verificationValue': 2210.0, 'proof': {'imageId': [2948630792, 2482136711, 1512618692, 3197082418, 820963868, 463243005, 2815130045, 3835354657], 'receipt': 'AwAAAAAAAAAAAAAAxAciAPPsD8genbvcCN2DvDmorNgPyU2p6hAM/h+8IU0pSDuhAAAAAAAAAAAAAAAAAAAAAAAAAAAAAAAAAAAAAAAAAAAAAAAAAAAAAAAAAAAAAAAAAQAAAAAAAAAAAAAAAAAAAAAAAAAAAAAAAAAAAAAAAAAAAAAAAAAAAAEAAAAAQAEAAAAAAAAGAAAAMjIxMC4wAAAvAQAAeyJ3YXNfZmlyc3RfZXZlbnQiOnRydWUsImltYWdlX2lkIjpbMjk0ODYzMDc5MiwyNDgyMTM2NzExLDE1MTI2MTg2OTIsMzE5NzA4MjQxOCw4MjA5NjM4NjgsNDYzMjQzMDA1LDI4MTUxMzAwNDUsMzgzNTM1NDY1N10sInFmIjp7ImIiOlswLDQsMCwwLDAsMCwwLDAsMCw0LDAsMCwwLDAsMCwwLDAsMCwxMjgsMjYsMCwwLDAsMCwwLDAsMCwwLDAsMCwwLDAsMCwwLDAsMCwwLDAsMCwwLDAsMCwwLDAsMCwwLDAsMCwwLDAsMCwwLDAsMCwwLDAsMCwwLDAsMCwwLDAsMCwwLDAsMCwwLDAsMCwwLDAsMCwwXSwibCI6MSwicSI6NiwiciI6N319AAAAAAAAAAAAAAAAAEABAAAAAAAABgAAADIyMTAuMAAALwEAAHsid2FzX2ZpcnN0X2V2ZW50Ijp0cnVlLCJpbWFnZV9pZCI6WzI5NDg2MzA3OTIsMjQ4MjEzNjcxMSwxNTEyNjE4NjkyLDMxOTcwODI0MTgsODIwOTYzODY4LDQ2MzI0MzAwNSwyODE1MTMwMDQ1LDM4MzUzNTQ2NTddLCJxZiI6eyJiIjpbMCw0LDAsMCwwLDAsMCwwLDAsNCwwLDAsMCwwLDAsMCwwLDAsMTI4LDI2LDAsMCwwLDAsMCwwLDAsMCwwLDAsMCwwLDAsMCwwLDAsMCwwLDAsMCwwLDAsMCwwLDAsMCwwLDAsMCwwLDAsMCwwLDAsMCwwLDAsMCwwLDAsMCwwLDAsMCwwLDAsMCwwLDAsMCwwLDAsMF0sImwiOjEsInEiOjYsInIiOjd9fQAAAAAAAAAAAAAAAAAAAAAAAAAAAAAAAAAAAAAAAAAAAA=='}}
prove_44;66;94;Mul;6204;105977;6204.0;841;0.0681466249989171;{'verificationValue': 6204.0, 'proof': {'imageId': [2948630792, 2482136711, 1512618692, 3197082418, 820963868, 463243005, 2815130045, 3835354657], 'receipt': 'AwAAAAAAAAAAAAAAxAciAPPsD8genbvcCN2DvDmorNgPyU2p6hAM/h+8IU0pSDuhAAAAAAAAAAAAAAAAAAAAAAAAAAAAAAAAAAAAAAAAAAAAAAAAAAAAAAAAAAAAAAAAAQAAAAAAAAAAAAAAAAAAAAAAAAAAAAAAAAAAAAAAAAAAAAAAAAAAAAEAAAAAQAEAAAAAAAAGAAAANjIwNC4wAAAvAQAAeyJ3YXNfZmlyc3RfZXZlbnQiOnRydWUsImltYWdlX2lkIjpbMjk0ODYzMDc5MiwyNDgyMTM2NzExLDE1MTI2MTg2OTIsMzE5NzA4MjQxOCw4MjA5NjM4NjgsNDYzMjQzMDA1LDI4MTUxMzAwNDUsMzgzNTM1NDY1N10sInFmIjp7ImIiOlswLDQsMCwwLDAsMCwwLDAsMCw0LDAsMCwwLDAsMCwwLDAsMCwxMjgsMjYsMCwwLDAsMCwwLDAsMCwwLDAsMCwwLDAsMCwwLDAsMCwwLDAsMCwwLDAsMCwwLDAsMCwwLDAsMCwwLDAsMCwwLDAsMCwwLDAsMCwwLDAsMCwwLDAsMCwwLDAsMCwwLDAsMCwwLDAsMCwwXSwibCI6MSwicSI6NiwiciI6N319AAAAAAAAAAAAAAAAAEABAAAAAAAABgAAADYyMDQuMAAALwEAAHsid2FzX2ZpcnN0X2V2ZW50Ijp0cnVlLCJpbWFnZV9pZCI6WzI5NDg2MzA3OTIsMjQ4MjEzNjcxMSwxNTEyNjE4NjkyLDMxOTcwODI0MTgsODIwOTYzODY4LDQ2MzI0MzAwNSwyODE1MTMwMDQ1LDM4MzUzNTQ2NTddLCJxZiI6eyJiIjpbMCw0LDAsMCwwLDAsMCwwLDAsNCwwLDAsMCwwLDAsMCwwLDAsMTI4LDI2LDAsMCwwLDAsMCwwLDAsMCwwLDAsMCwwLDAsMCwwLDAsMCwwLDAsMCwwLDAsMCwwLDAsMCwwLDAsMCwwLDAsMCwwLDAsMCwwLDAsMCwwLDAsMCwwLDAsMCwwLDAsMCwwLDAsMCwwLDAsMF0sImwiOjEsInEiOjYsInIiOjd9fQAAAAAAAAAAAAAAAAAAAAAAAAAAAAAAAAAAAAAAAAAAAA=='}}
prove_45;61;49;Mul;2989;108966;2989.0;841;0.06864770799984399;{'verificationValue': 2989.0, 'proof': {'imageId': [2948630792, 2482136711, 1512618692, 3197082418, 820963868, 463243005, 2815130045, 3835354657], 'receipt': 'AwAAAAAAAAAAAAAAxAciAPPsD8genbvcCN2DvDmorNgPyU2p6hAM/h+8IU0pSDuhAAAAAAAAAAAAAAAAAAAAAAAAAAAAAAAAAAAAAAAAAAAAAAAAAAAAAAAAAAAAAAAAAQAAAAAAAAAAAAAAAAAAAAAAAAAAAAAAAAAAAAAAAAAAAAAAAAAAAAEAAAAAQAEAAAAAAAAGAAAAMjk4OS4wAAAvAQAAeyJ3YXNfZmlyc3RfZXZlbnQiOnRydWUsImltYWdlX2lkIjpbMjk0ODYzMDc5MiwyNDgyMTM2NzExLDE1MTI2MTg2OTIsMzE5NzA4MjQxOCw4MjA5NjM4NjgsNDYzMjQzMDA1LDI4MTUxMzAwNDUsMzgzNTM1NDY1N10sInFmIjp7ImIiOlswLDQsMCwwLDAsMCwwLDAsMCw0LDAsMCwwLDAsMCwwLDAsMCwxMjgsMjYsMCwwLDAsMCwwLDAsMCwwLDAsMCwwLDAsMCwwLDAsMCwwLDAsMCwwLDAsMCwwLDAsMCwwLDAsMCwwLDAsMCwwLDAsMCwwLDAsMCwwLDAsMCwwLDAsMCwwLDAsMCwwLDAsMCwwLDAsMCwwXSwibCI6MSwicSI6NiwiciI6N319AAAAAAAAAAAAAAAAAEABAAAAAAAABgAAADI5ODkuMAAALwEAAHsid2FzX2ZpcnN0X2V2ZW50Ijp0cnVlLCJpbWFnZV9pZCI6WzI5NDg2MzA3OTIsMjQ4MjEzNjcxMSwxNTEyNjE4NjkyLDMxOTcwODI0MTgsODIwOTYzODY4LDQ2MzI0MzAwNSwyODE1MTMwMDQ1LDM4MzUzNTQ2NTddLCJxZiI6eyJiIjpbMCw0LDAsMCwwLDAsMCwwLDAsNCwwLDAsMCwwLDAsMCwwLDAsMTI4LDI2LDAsMCwwLDAsMCwwLDAsMCwwLDAsMCwwLDAsMCwwLDAsMCwwLDAsMCwwLDAsMCwwLDAsMCwwLDAsMCwwLDAsMCwwLDAsMCwwLDAsMCwwLDAsMCwwLDAsMCwwLDAsMCwwLDAsMCwwLDAsMF0sImwiOjEsInEiOjYsInIiOjd9fQAAAAAAAAAAAAAAAAAAAAAAAAAAAAAAAAAAAAAAAAAAAA=='}}
prove_46;20;7;Mul;140;109106;140.0;841;0.06793308400119713;{'verificationValue': 140.0, 'proof': {'imageId': [2948630792, 2482136711, 1512618692, 3197082418, 820963868, 463243005, 2815130045, 3835354657], 'receipt': 'AwAAAAAAAAAAAAAAxAciAPPsD8genbvcCN2DvDmorNgPyU2p6hAM/h+8IU0pSDuhAAAAAAAAAAAAAAAAAAAAAAAAAAAAAAAAAAAAAAAAAAAAAAAAAAAAAAAAAAAAAAAAAQAAAAAAAAAAAAAAAAAAAAAAAAAAAAAAAAAAAAAAAAAAAAAAAAAAAAEAAAAAQAEAAAAAAAAFAAAAMTQwLjAAAAAvAQAAeyJ3YXNfZmlyc3RfZXZlbnQiOnRydWUsImltYWdlX2lkIjpbMjk0ODYzMDc5MiwyNDgyMTM2NzExLDE1MTI2MTg2OTIsMzE5NzA4MjQxOCw4MjA5NjM4NjgsNDYzMjQzMDA1LDI4MTUxMzAwNDUsMzgzNTM1NDY1N10sInFmIjp7ImIiOlswLDQsMCwwLDAsMCwwLDAsMCw0LDAsMCwwLDAsMCwwLDAsMCwxMjgsMjYsMCwwLDAsMCwwLDAsMCwwLDAsMCwwLDAsMCwwLDAsMCwwLDAsMCwwLDAsMCwwLDAsMCwwLDAsMCwwLDAsMCwwLDAsMCwwLDAsMCwwLDAsMCwwLDAsMCwwLDAsMCwwLDAsMCwwLDAsMCwwXSwibCI6MSwicSI6NiwiciI6N319AAAAAAAAAAAAAAAAAEABAAAAAAAABQAAADE0MC4wAAAALwEAAHsid2FzX2ZpcnN0X2V2ZW50Ijp0cnVlLCJpbWFnZV9pZCI6WzI5NDg2MzA3OTIsMjQ4MjEzNjcxMSwxNTEyNjE4NjkyLDMxOTcwODI0MTgsODIwOTYzODY4LDQ2MzI0MzAwNSwyODE1MTMwMDQ1LDM4MzUzNTQ2NTddLCJxZiI6eyJiIjpbMCw0LDAsMCwwLDAsMCwwLDAsNCwwLDAsMCwwLDAsMCwwLDAsMTI4LDI2LDAsMCwwLDAsMCwwLDAsMCwwLDAsMCwwLDAsMCwwLDAsMCwwLDAsMCwwLDAsMCwwLDAsMCwwLDAsMCwwLDAsMCwwLDAsMCwwLDAsMCwwLDAsMCwwLDAsMCwwLDAsMCwwLDAsMCwwLDAsMF0sImwiOjEsInEiOjYsInIiOjd9fQAAAAAAAAAAAAAAAAAAAAAAAAAAAAAAAAAAAAAAAAAAAA=='}}
prove_47;95;79;Mul;7505;116611;7505.0;841;0.06844479200117348;{'verificationValue': 7505.0, 'proof': {'imageId': [2948630792, 2482136711, 1512618692, 3197082418, 820963868, 463243005, 2815130045, 3835354657], 'receipt': 'AwAAAAAAAAAAAAAAxAciAPPsD8genbvcCN2DvDmorNgPyU2p6hAM/h+8IU0pSDuhAAAAAAAAAAAAAAAAAAAAAAAAAAAAAAAAAAAAAAAAAAAAAAAAAAAAAAAAAAAAAAAAAQAAAAAAAAAAAAAAAAAAAAAAAAAAAAAAAAAAAAAAAAAAAAAAAAAAAAEAAAAAQAEAAAAAAAAGAAAANzUwNS4wAAAvAQAAeyJ3YXNfZmlyc3RfZXZlbnQiOnRydWUsImltYWdlX2lkIjpbMjk0ODYzMDc5MiwyNDgyMTM2NzExLDE1MTI2MTg2OTIsMzE5NzA4MjQxOCw4MjA5NjM4NjgsNDYzMjQzMDA1LDI4MTUxMzAwNDUsMzgzNTM1NDY1N10sInFmIjp7ImIiOlswLDQsMCwwLDAsMCwwLDAsMCw0LDAsMCwwLDAsMCwwLDAsMCwxMjgsMjYsMCwwLDAsMCwwLDAsMCwwLDAsMCwwLDAsMCwwLDAsMCwwLDAsMCwwLDAsMCwwLDAsMCwwLDAsMCwwLDAsMCwwLDAsMCwwLDAsMCwwLDAsMCwwLDAsMCwwLDAsMCwwLDAsMCwwLDAsMCwwXSwibCI6MSwicSI6NiwiciI6N319AAAAAAAAAAAAAAAAAEABAAAAAAAABgAAADc1MDUuMAAALwEAAHsid2FzX2ZpcnN0X2V2ZW50Ijp0cnVlLCJpbWFnZV9pZCI6WzI5NDg2MzA3OTIsMjQ4MjEzNjcxMSwxNTEyNjE4NjkyLDMxOTcwODI0MTgsODIwOTYzODY4LDQ2MzI0MzAwNSwyODE1MTMwMDQ1LDM4MzUzNTQ2NTddLCJxZiI6eyJiIjpbMCw0LDAsMCwwLDAsMCwwLDAsNCwwLDAsMCwwLDAsMCwwLDAsMTI4LDI2LDAsMCwwLDAsMCwwLDAsMCwwLDAsMCwwLDAsMCwwLDAsMCwwLDAsMCwwLDAsMCwwLDAsMCwwLDAsMCwwLDAsMCwwLDAsMCwwLDAsMCwwLDAsMCwwLDAsMCwwLDAsMCwwLDAsMCwwLDAsMF0sImwiOjEsInEiOjYsInIiOjd9fQAAAAAAAAAAAAAAAAAAAAAAAAAAAAAAAAAAAAAAAAAAAA=='}}
prove_48;27;60;Mul;1620;118231;1620.0;841;0.06726512500063109;{'verificationValue': 1620.0, 'proof': {'imageId': [2948630792, 2482136711, 1512618692, 3197082418, 820963868, 463243005, 2815130045, 3835354657], 'receipt': 'AwAAAAAAAAAAAAAAxAciAPPsD8genbvcCN2DvDmorNgPyU2p6hAM/h+8IU0pSDuhAAAAAAAAAAAAAAAAAAAAAAAAAAAAAAAAAAAAAAAAAAAAAAAAAAAAAAAAAAAAAAAAAQAAAAAAAAAAAAAAAAAAAAAAAAAAAAAAAAAAAAAAAAAAAAAAAAAAAAEAAAAAQAEAAAAAAAAGAAAAMTYyMC4wAAAvAQAAeyJ3YXNfZmlyc3RfZXZlbnQiOnRydWUsImltYWdlX2lkIjpbMjk0ODYzMDc5MiwyNDgyMTM2NzExLDE1MTI2MTg2OTIsMzE5NzA4MjQxOCw4MjA5NjM4NjgsNDYzMjQzMDA1LDI4MTUxMzAwNDUsMzgzNTM1NDY1N10sInFmIjp7ImIiOlswLDQsMCwwLDAsMCwwLDAsMCw0LDAsMCwwLDAsMCwwLDAsMCwxMjgsMjYsMCwwLDAsMCwwLDAsMCwwLDAsMCwwLDAsMCwwLDAsMCwwLDAsMCwwLDAsMCwwLDAsMCwwLDAsMCwwLDAsMCwwLDAsMCwwLDAsMCwwLDAsMCwwLDAsMCwwLDAsMCwwLDAsMCwwLDAsMCwwXSwibCI6MSwicSI6NiwiciI6N319AAAAAAAAAAAAAAAAAEABAAAAAAAABgAAADE2MjAuMAAALwEAAHsid2FzX2ZpcnN0X2V2ZW50Ijp0cnVlLCJpbWFnZV9pZCI6WzI5NDg2MzA3OTIsMjQ4MjEzNjcxMSwxNTEyNjE4NjkyLDMxOTcwODI0MTgsODIwOTYzODY4LDQ2MzI0MzAwNSwyODE1MTMwMDQ1LDM4MzUzNTQ2NTddLCJxZiI6eyJiIjpbMCw0LDAsMCwwLDAsMCwwLDAsNCwwLDAsMCwwLDAsMCwwLDAsMTI4LDI2LDAsMCwwLDAsMCwwLDAsMCwwLDAsMCwwLDAsMCwwLDAsMCwwLDAsMCwwLDAsMCwwLDAsMCwwLDAsMCwwLDAsMCwwLDAsMCwwLDAsMCwwLDAsMCwwLDAsMCwwLDAsMCwwLDAsMCwwLDAsMF0sImwiOjEsInEiOjYsInIiOjd9fQAAAAAAAAAAAAAAAAAAAAAAAAAAAAAAAAAAAAAAAAAAAA=='}}
prove_49;91;61;Mul;5551;123782;5551.0;841;0.0682859999997163;{'verificationValue': 5551.0, 'proof': {'imageId': [2948630792, 2482136711, 1512618692, 3197082418, 820963868, 463243005, 2815130045, 3835354657], 'receipt': 'AwAAAAAAAAAAAAAAxAciAPPsD8genbvcCN2DvDmorNgPyU2p6hAM/h+8IU0pSDuhAAAAAAAAAAAAAAAAAAAAAAAAAAAAAAAAAAAAAAAAAAAAAAAAAAAAAAAAAAAAAAAAAQAAAAAAAAAAAAAAAAAAAAAAAAAAAAAAAAAAAAAAAAAAAAAAAAAAAAEAAAAAQAEAAAAAAAAGAAAANTU1MS4wAAAvAQAAeyJ3YXNfZmlyc3RfZXZlbnQiOnRydWUsImltYWdlX2lkIjpbMjk0ODYzMDc5MiwyNDgyMTM2NzExLDE1MTI2MTg2OTIsMzE5NzA4MjQxOCw4MjA5NjM4NjgsNDYzMjQzMDA1LDI4MTUxMzAwNDUsMzgzNTM1NDY1N10sInFmIjp7ImIiOlswLDQsMCwwLDAsMCwwLDAsMCw0LDAsMCwwLDAsMCwwLDAsMCwxMjgsMjYsMCwwLDAsMCwwLDAsMCwwLDAsMCwwLDAsMCwwLDAsMCwwLDAsMCwwLDAsMCwwLDAsMCwwLDAsMCwwLDAsMCwwLDAsMCwwLDAsMCwwLDAsMCwwLDAsMCwwLDAsMCwwLDAsMCwwLDAsMCwwXSwibCI6MSwicSI6NiwiciI6N319AAAAAAAAAAAAAAAAAEABAAAAAAAABgAAADU1NTEuMAAALwEAAHsid2FzX2ZpcnN0X2V2ZW50Ijp0cnVlLCJpbWFnZV9pZCI6WzI5NDg2MzA3OTIsMjQ4MjEzNjcxMSwxNTEyNjE4NjkyLDMxOTcwODI0MTgsODIwOTYzODY4LDQ2MzI0MzAwNSwyODE1MTMwMDQ1LDM4MzUzNTQ2NTddLCJxZiI6eyJiIjpbMCw0LDAsMCwwLDAsMCwwLDAsNCwwLDAsMCwwLDAsMCwwLDAsMTI4LDI2LDAsMCwwLDAsMCwwLDAsMCwwLDAsMCwwLDAsMCwwLDAsMCwwLDAsMCwwLDAsMCwwLDAsMCwwLDAsMCwwLDAsMCwwLDAsMCwwLDAsMCwwLDAsMCwwLDAsMCwwLDAsMCwwLDAsMCwwLDAsMF0sImwiOjEsInEiOjYsInIiOjd9fQAAAAAAAAAAAAAAAAAAAAAAAAAAAAAAAAAAAAAAAAAAAA=='}}
prove_50;28;57;Mul;1596;125378;1596.0;841;0.0677214589995856;{'verificationValue': 1596.0, 'proof': {'imageId': [2948630792, 2482136711, 1512618692, 3197082418, 820963868, 463243005, 2815130045, 3835354657], 'receipt': 'AwAAAAAAAAAAAAAAxAciAPPsD8genbvcCN2DvDmorNgPyU2p6hAM/h+8IU0pSDuhAAAAAAAAAAAAAAAAAAAAAAAAAAAAAAAAAAAAAAAAAAAAAAAAAAAAAAAAAAAAAAAAAQAAAAAAAAAAAAAAAAAAAAAAAAAAAAAAAAAAAAAAAAAAAAAAAAAAAAEAAAAAQAEAAAAAAAAGAAAAMTU5Ni4wAAAvAQAAeyJ3YXNfZmlyc3RfZXZlbnQiOnRydWUsImltYWdlX2lkIjpbMjk0ODYzMDc5MiwyNDgyMTM2NzExLDE1MTI2MTg2OTIsMzE5NzA4MjQxOCw4MjA5NjM4NjgsNDYzMjQzMDA1LDI4MTUxMzAwNDUsMzgzNTM1NDY1N10sInFmIjp7ImIiOlswLDQsMCwwLDAsMCwwLDAsMCw0LDAsMCwwLDAsMCwwLDAsMCwxMjgsMjYsMCwwLDAsMCwwLDAsMCwwLDAsMCwwLDAsMCwwLDAsMCwwLDAsMCwwLDAsMCwwLDAsMCwwLDAsMCwwLDAsMCwwLDAsMCwwLDAsMCwwLDAsMCwwLDAsMCwwLDAsMCwwLDAsMCwwLDAsMCwwXSwibCI6MSwicSI6NiwiciI6N319AAAAAAAAAAAAAAAAAEABAAAAAAAABgAAADE1OTYuMAAALwEAAHsid2FzX2ZpcnN0X2V2ZW50Ijp0cnVlLCJpbWFnZV9pZCI6WzI5NDg2MzA3OTIsMjQ4MjEzNjcxMSwxNTEyNjE4NjkyLDMxOTcwODI0MTgsODIwOTYzODY4LDQ2MzI0MzAwNSwyODE1MTMwMDQ1LDM4MzUzNTQ2NTddLCJxZiI6eyJiIjpbMCw0LDAsMCwwLDAsMCwwLDAsNCwwLDAsMCwwLDAsMCwwLDAsMTI4LDI2LDAsMCwwLDAsMCwwLDAsMCwwLDAsMCwwLDAsMCwwLDAsMCwwLDAsMCwwLDAsMCwwLDAsMCwwLDAsMCwwLDAsMCwwLDAsMCwwLDAsMCwwLDAsMCwwLDAsMCwwLDAsMCwwLDAsMCwwLDAsMF0sImwiOjEsInEiOjYsInIiOjd9fQAAAAAAAAAAAAAAAAAAAAAAAAAAAAAAAAAAAAAAAAAAAA=='}}
prove_51;11;17;Mul;187;125565;187.0;841;0.06776366699887149;{'verificationValue': 187.0, 'proof': {'imageId': [2948630792, 2482136711, 1512618692, 3197082418, 820963868, 463243005, 2815130045, 3835354657], 'receipt': 'AwAAAAAAAAAAAAAAxAciAPPsD8genbvcCN2DvDmorNgPyU2p6hAM/h+8IU0pSDuhAAAAAAAAAAAAAAAAAAAAAAAAAAAAAAAAAAAAAAAAAAAAAAAAAAAAAAAAAAAAAAAAAQAAAAAAAAAAAAAAAAAAAAAAAAAAAAAAAAAAAAAAAAAAAAAAAAAAAAEAAAAAQAEAAAAAAAAFAAAAMTg3LjAAAAAvAQAAeyJ3YXNfZmlyc3RfZXZlbnQiOnRydWUsImltYWdlX2lkIjpbMjk0ODYzMDc5MiwyNDgyMTM2NzExLDE1MTI2MTg2OTIsMzE5NzA4MjQxOCw4MjA5NjM4NjgsNDYzMjQzMDA1LDI4MTUxMzAwNDUsMzgzNTM1NDY1N10sInFmIjp7ImIiOlswLDQsMCwwLDAsMCwwLDAsMCw0LDAsMCwwLDAsMCwwLDAsMCwxMjgsMjYsMCwwLDAsMCwwLDAsMCwwLDAsMCwwLDAsMCwwLDAsMCwwLDAsMCwwLDAsMCwwLDAsMCwwLDAsMCwwLDAsMCwwLDAsMCwwLDAsMCwwLDAsMCwwLDAsMCwwLDAsMCwwLDAsMCwwLDAsMCwwXSwibCI6MSwicSI6NiwiciI6N319AAAAAAAAAAAAAAAAAEABAAAAAAAABQAAADE4Ny4wAAAALwEAAHsid2FzX2ZpcnN0X2V2ZW50Ijp0cnVlLCJpbWFnZV9pZCI6WzI5NDg2MzA3OTIsMjQ4MjEzNjcxMSwxNTEyNjE4NjkyLDMxOTcwODI0MTgsODIwOTYzODY4LDQ2MzI0MzAwNSwyODE1MTMwMDQ1LDM4MzUzNTQ2NTddLCJxZiI6eyJiIjpbMCw0LDAsMCwwLDAsMCwwLDAsNCwwLDAsMCwwLDAsMCwwLDAsMTI4LDI2LDAsMCwwLDAsMCwwLDAsMCwwLDAsMCwwLDAsMCwwLDAsMCwwLDAsMCwwLDAsMCwwLDAsMCwwLDAsMCwwLDAsMCwwLDAsMCwwLDAsMCwwLDAsMCwwLDAsMCwwLDAsMCwwLDAsMCwwLDAsMF0sImwiOjEsInEiOjYsInIiOjd9fQAAAAAAAAAAAAAAAAAAAAAAAAAAAAAAAAAAAAAAAAAAAA=='}}
prove_52;88;71;Mul;6248;131813;6248.0;841;0.0674122090003948;{'verificationValue': 6248.0, 'proof': {'imageId': [2948630792, 2482136711, 1512618692, 3197082418, 820963868, 463243005, 2815130045, 3835354657], 'receipt': 'AwAAAAAAAAAAAAAAxAciAPPsD8genbvcCN2DvDmorNgPyU2p6hAM/h+8IU0pSDuhAAAAAAAAAAAAAAAAAAAAAAAAAAAAAAAAAAAAAAAAAAAAAAAAAAAAAAAAAAAAAAAAAQAAAAAAAAAAAAAAAAAAAAAAAAAAAAAAAAAAAAAAAAAAAAAAAAAAAAEAAAAAQAEAAAAAAAAGAAAANjI0OC4wAAAvAQAAeyJ3YXNfZmlyc3RfZXZlbnQiOnRydWUsImltYWdlX2lkIjpbMjk0ODYzMDc5MiwyNDgyMTM2NzExLDE1MTI2MTg2OTIsMzE5NzA4MjQxOCw4MjA5NjM4NjgsNDYzMjQzMDA1LDI4MTUxMzAwNDUsMzgzNTM1NDY1N10sInFmIjp7ImIiOlswLDQsMCwwLDAsMCwwLDAsMCw0LDAsMCwwLDAsMCwwLDAsMCwxMjgsMjYsMCwwLDAsMCwwLDAsMCwwLDAsMCwwLDAsMCwwLDAsMCwwLDAsMCwwLDAsMCwwLDAsMCwwLDAsMCwwLDAsMCwwLDAsMCwwLDAsMCwwLDAsMCwwLDAsMCwwLDAsMCwwLDAsMCwwLDAsMCwwXSwibCI6MSwicSI6NiwiciI6N319AAAAAAAAAAAAAAAAAEABAAAAAAAABgAAADYyNDguMAAALwEAAHsid2FzX2ZpcnN0X2V2ZW50Ijp0cnVlLCJpbWFnZV9pZCI6WzI5NDg2MzA3OTIsMjQ4MjEzNjcxMSwxNTEyNjE4NjkyLDMxOTcwODI0MTgsODIwOTYzODY4LDQ2MzI0MzAwNSwyODE1MTMwMDQ1LDM4MzUzNTQ2NTddLCJxZiI6eyJiIjpbMCw0LDAsMCwwLDAsMCwwLDAsNCwwLDAsMCwwLDAsMCwwLDAsMTI4LDI2LDAsMCwwLDAsMCwwLDAsMCwwLDAsMCwwLDAsMCwwLDAsMCwwLDAsMCwwLDAsMCwwLDAsMCwwLDAsMCwwLDAsMCwwLDAsMCwwLDAsMCwwLDAsMCwwLDAsMCwwLDAsMCwwLDAsMCwwLDAsMF0sImwiOjEsInEiOjYsInIiOjd9fQAAAAAAAAAAAAAAAAAAAAAAAAAAAAAAAAAAAAAAAAAAAA=='}}
prove_53;13;13;Mul;169;131982;169.0;841;0.06799004099957529;{'verificationValue': 169.0, 'proof': {'imageId': [2948630792, 2482136711, 1512618692, 3197082418, 820963868, 463243005, 2815130045, 3835354657], 'receipt': 'AwAAAAAAAAAAAAAAxAciAPPsD8genbvcCN2DvDmorNgPyU2p6hAM/h+8IU0pSDuhAAAAAAAAAAAAAAAAAAAAAAAAAAAAAAAAAAAAAAAAAAAAAAAAAAAAAAAAAAAAAAAAAQAAAAAAAAAAAAAAAAAAAAAAAAAAAAAAAAAAAAAAAAAAAAAAAAAAAAEAAAAAQAEAAAAAAAAFAAAAMTY5LjAAAAAvAQAAeyJ3YXNfZmlyc3RfZXZlbnQiOnRydWUsImltYWdlX2lkIjpbMjk0ODYzMDc5MiwyNDgyMTM2NzExLDE1MTI2MTg2OTIsMzE5NzA4MjQxOCw4MjA5NjM4NjgsNDYzMjQzMDA1LDI4MTUxMzAwNDUsMzgzNTM1NDY1N10sInFmIjp7ImIiOlswLDQsMCwwLDAsMCwwLDAsMCw0LDAsMCwwLDAsMCwwLDAsMCwxMjgsMjYsMCwwLDAsMCwwLDAsMCwwLDAsMCwwLDAsMCwwLDAsMCwwLDAsMCwwLDAsMCwwLDAsMCwwLDAsMCwwLDAsMCwwLDAsMCwwLDAsMCwwLDAsMCwwLDAsMCwwLDAsMCwwLDAsMCwwLDAsMCwwXSwibCI6MSwicSI6NiwiciI6N319AAAAAAAAAAAAAAAAAEABAAAAAAAABQAAADE2OS4wAAAALwEAAHsid2FzX2ZpcnN0X2V2ZW50Ijp0cnVlLCJpbWFnZV9pZCI6WzI5NDg2MzA3OTIsMjQ4MjEzNjcxMSwxNTEyNjE4NjkyLDMxOTcwODI0MTgsODIwOTYzODY4LDQ2MzI0MzAwNSwyODE1MTMwMDQ1LDM4MzUzNTQ2NTddLCJxZiI6eyJiIjpbMCw0LDAsMCwwLDAsMCwwLDAsNCwwLDAsMCwwLDAsMCwwLDAsMTI4LDI2LDAsMCwwLDAsMCwwLDAsMCwwLDAsMCwwLDAsMCwwLDAsMCwwLDAsMCwwLDAsMCwwLDAsMCwwLDAsMCwwLDAsMCwwLDAsMCwwLDAsMCwwLDAsMCwwLDAsMCwwLDAsMCwwLDAsMCwwLDAsMF0sImwiOjEsInEiOjYsInIiOjd9fQAAAAAAAAAAAAAAAAAAAAAAAAAAAAAAAAAAAAAAAAAAAA=='}}
prove_54;94;68;Mul;6392;138374;6392.0;841;0.06776058299874421;{'verificationValue': 6392.0, 'proof': {'imageId': [2948630792, 2482136711, 1512618692, 3197082418, 820963868, 463243005, 2815130045, 3835354657], 'receipt': 'AwAAAAAAAAAAAAAAxAciAPPsD8genbvcCN2DvDmorNgPyU2p6hAM/h+8IU0pSDuhAAAAAAAAAAAAAAAAAAAAAAAAAAAAAAAAAAAAAAAAAAAAAAAAAAAAAAAAAAAAAAAAAQAAAAAAAAAAAAAAAAAAAAAAAAAAAAAAAAAAAAAAAAAAAAAAAAAAAAEAAAAAQAEAAAAAAAAGAAAANjM5Mi4wAAAvAQAAeyJ3YXNfZmlyc3RfZXZlbnQiOnRydWUsImltYWdlX2lkIjpbMjk0ODYzMDc5MiwyNDgyMTM2NzExLDE1MTI2MTg2OTIsMzE5NzA4MjQxOCw4MjA5NjM4NjgsNDYzMjQzMDA1LDI4MTUxMzAwNDUsMzgzNTM1NDY1N10sInFmIjp7ImIiOlswLDQsMCwwLDAsMCwwLDAsMCw0LDAsMCwwLDAsMCwwLDAsMCwxMjgsMjYsMCwwLDAsMCwwLDAsMCwwLDAsMCwwLDAsMCwwLDAsMCwwLDAsMCwwLDAsMCwwLDAsMCwwLDAsMCwwLDAsMCwwLDAsMCwwLDAsMCwwLDAsMCwwLDAsMCwwLDAsMCwwLDAsMCwwLDAsMCwwXSwibCI6MSwicSI6NiwiciI6N319AAAAAAAAAAAAAAAAAEABAAAAAAAABgAAADYzOTIuMAAALwEAAHsid2FzX2ZpcnN0X2V2ZW50Ijp0cnVlLCJpbWFnZV9pZCI6WzI5NDg2MzA3OTIsMjQ4MjEzNjcxMSwxNTEyNjE4NjkyLDMxOTcwODI0MTgsODIwOTYzODY4LDQ2MzI0MzAwNSwyODE1MTMwMDQ1LDM4MzUzNTQ2NTddLCJxZiI6eyJiIjpbMCw0LDAsMCwwLDAsMCwwLDAsNCwwLDAsMCwwLDAsMCwwLDAsMTI4LDI2LDAsMCwwLDAsMCwwLDAsMCwwLDAsMCwwLDAsMCwwLDAsMCwwLDAsMCwwLDAsMCwwLDAsMCwwLDAsMCwwLDAsMCwwLDAsMCwwLDAsMCwwLDAsMCwwLDAsMCwwLDAsMCwwLDAsMCwwLDAsMF0sImwiOjEsInEiOjYsInIiOjd9fQAAAAAAAAAAAAAAAAAAAAAAAAAAAAAAAAAAAAAAAAAAAA=='}}
prove_55;68;52;Mul;3536;141910;3536.0;841;0.0682007089999388;{'verificationValue': 3536.0, 'proof': {'imageId': [2948630792, 2482136711, 1512618692, 3197082418, 820963868, 463243005, 2815130045, 3835354657], 'receipt': 'AwAAAAAAAAAAAAAAxAciAPPsD8genbvcCN2DvDmorNgPyU2p6hAM/h+8IU0pSDuhAAAAAAAAAAAAAAAAAAAAAAAAAAAAAAAAAAAAAAAAAAAAAAAAAAAAAAAAAAAAAAAAAQAAAAAAAAAAAAAAAAAAAAAAAAAAAAAAAAAAAAAAAAAAAAAAAAAAAAEAAAAAQAEAAAAAAAAGAAAAMzUzNi4wAAAvAQAAeyJ3YXNfZmlyc3RfZXZlbnQiOnRydWUsImltYWdlX2lkIjpbMjk0ODYzMDc5MiwyNDgyMTM2NzExLDE1MTI2MTg2OTIsMzE5NzA4MjQxOCw4MjA5NjM4NjgsNDYzMjQzMDA1LDI4MTUxMzAwNDUsMzgzNTM1NDY1N10sInFmIjp7ImIiOlswLDQsMCwwLDAsMCwwLDAsMCw0LDAsMCwwLDAsMCwwLDAsMCwxMjgsMjYsMCwwLDAsMCwwLDAsMCwwLDAsMCwwLDAsMCwwLDAsMCwwLDAsMCwwLDAsMCwwLDAsMCwwLDAsMCwwLDAsMCwwLDAsMCwwLDAsMCwwLDAsMCwwLDAsMCwwLDAsMCwwLDAsMCwwLDAsMCwwXSwibCI6MSwicSI6NiwiciI6N319AAAAAAAAAAAAAAAAAEABAAAAAAAABgAAADM1MzYuMAAALwEAAHsid2FzX2ZpcnN0X2V2ZW50Ijp0cnVlLCJpbWFnZV9pZCI6WzI5NDg2MzA3OTIsMjQ4MjEzNjcxMSwxNTEyNjE4NjkyLDMxOTcwODI0MTgsODIwOTYzODY4LDQ2MzI0MzAwNSwyODE1MTMwMDQ1LDM4MzUzNTQ2NTddLCJxZiI6eyJiIjpbMCw0LDAsMCwwLDAsMCwwLDAsNCwwLDAsMCwwLDAsMCwwLDAsMTI4LDI2LDAsMCwwLDAsMCwwLDAsMCwwLDAsMCwwLDAsMCwwLDAsMCwwLDAsMCwwLDAsMCwwLDAsMCwwLDAsMCwwLDAsMCwwLDAsMCwwLDAsMCwwLDAsMCwwLDAsMCwwLDAsMCwwLDAsMCwwLDAsMF0sImwiOjEsInEiOjYsInIiOjd9fQAAAAAAAAAAAAAAAAAAAAAAAAAAAAAAAAAAAAAAAAAAAA=='}}
prove_56;44;75;Mul;3300;145210;3300.0;841;0.06774575000054028;{'verificationValue': 3300.0, 'proof': {'imageId': [2948630792, 2482136711, 1512618692, 3197082418, 820963868, 463243005, 2815130045, 3835354657], 'receipt': 'AwAAAAAAAAAAAAAAxAciAPPsD8genbvcCN2DvDmorNgPyU2p6hAM/h+8IU0pSDuhAAAAAAAAAAAAAAAAAAAAAAAAAAAAAAAAAAAAAAAAAAAAAAAAAAAAAAAAAAAAAAAAAQAAAAAAAAAAAAAAAAAAAAAAAAAAAAAAAAAAAAAAAAAAAAAAAAAAAAEAAAAAQAEAAAAAAAAGAAAAMzMwMC4wAAAvAQAAeyJ3YXNfZmlyc3RfZXZlbnQiOnRydWUsImltYWdlX2lkIjpbMjk0ODYzMDc5MiwyNDgyMTM2NzExLDE1MTI2MTg2OTIsMzE5NzA4MjQxOCw4MjA5NjM4NjgsNDYzMjQzMDA1LDI4MTUxMzAwNDUsMzgzNTM1NDY1N10sInFmIjp7ImIiOlswLDQsMCwwLDAsMCwwLDAsMCw0LDAsMCwwLDAsMCwwLDAsMCwxMjgsMjYsMCwwLDAsMCwwLDAsMCwwLDAsMCwwLDAsMCwwLDAsMCwwLDAsMCwwLDAsMCwwLDAsMCwwLDAsMCwwLDAsMCwwLDAsMCwwLDAsMCwwLDAsMCwwLDAsMCwwLDAsMCwwLDAsMCwwLDAsMCwwXSwibCI6MSwicSI6NiwiciI6N319AAAAAAAAAAAAAAAAAEABAAAAAAAABgAAADMzMDAuMAAALwEAAHsid2FzX2ZpcnN0X2V2ZW50Ijp0cnVlLCJpbWFnZV9pZCI6WzI5NDg2MzA3OTIsMjQ4MjEzNjcxMSwxNTEyNjE4NjkyLDMxOTcwODI0MTgsODIwOTYzODY4LDQ2MzI0MzAwNSwyODE1MTMwMDQ1LDM4MzUzNTQ2NTddLCJxZiI6eyJiIjpbMCw0LDAsMCwwLDAsMCwwLDAsNCwwLDAsMCwwLDAsMCwwLDAsMTI4LDI2LDAsMCwwLDAsMCwwLDAsMCwwLDAsMCwwLDAsMCwwLDAsMCwwLDAsMCwwLDAsMCwwLDAsMCwwLDAsMCwwLDAsMCwwLDAsMCwwLDAsMCwwLDAsMCwwLDAsMCwwLDAsMCwwLDAsMCwwLDAsMF0sImwiOjEsInEiOjYsInIiOjd9fQAAAAAAAAAAAAAAAAAAAAAAAAAAAAAAAAAAAAAAAAAAAA=='}}
prove_57;57;47;Mul;2679;147889;2679.0;841;0.06900716599920997;{'verificationValue': 2679.0, 'proof': {'imageId': [2948630792, 2482136711, 1512618692, 3197082418, 820963868, 463243005, 2815130045, 3835354657], 'receipt': 'AwAAAAAAAAAAAAAAxAciAPPsD8genbvcCN2DvDmorNgPyU2p6hAM/h+8IU0pSDuhAAAAAAAAAAAAAAAAAAAAAAAAAAAAAAAAAAAAAAAAAAAAAAAAAAAAAAAAAAAAAAAAAQAAAAAAAAAAAAAAAAAAAAAAAAAAAAAAAAAAAAAAAAAAAAAAAAAAAAEAAAAAQAEAAAAAAAAGAAAAMjY3OS4wAAAvAQAAeyJ3YXNfZmlyc3RfZXZlbnQiOnRydWUsImltYWdlX2lkIjpbMjk0ODYzMDc5MiwyNDgyMTM2NzExLDE1MTI2MTg2OTIsMzE5NzA4MjQxOCw4MjA5NjM4NjgsNDYzMjQzMDA1LDI4MTUxMzAwNDUsMzgzNTM1NDY1N10sInFmIjp7ImIiOlswLDQsMCwwLDAsMCwwLDAsMCw0LDAsMCwwLDAsMCwwLDAsMCwxMjgsMjYsMCwwLDAsMCwwLDAsMCwwLDAsMCwwLDAsMCwwLDAsMCwwLDAsMCwwLDAsMCwwLDAsMCwwLDAsMCwwLDAsMCwwLDAsMCwwLDAsMCwwLDAsMCwwLDAsMCwwLDAsMCwwLDAsMCwwLDAsMCwwXSwibCI6MSwicSI6NiwiciI6N319AAAAAAAAAAAAAAAAAEABAAAAAAAABgAAADI2NzkuMAAALwEAAHsid2FzX2ZpcnN0X2V2ZW50Ijp0cnVlLCJpbWFnZV9pZCI6WzI5NDg2MzA3OTIsMjQ4MjEzNjcxMSwxNTEyNjE4NjkyLDMxOTcwODI0MTgsODIwOTYzODY4LDQ2MzI0MzAwNSwyODE1MTMwMDQ1LDM4MzUzNTQ2NTddLCJxZiI6eyJiIjpbMCw0LDAsMCwwLDAsMCwwLDAsNCwwLDAsMCwwLDAsMCwwLDAsMTI4LDI2LDAsMCwwLDAsMCwwLDAsMCwwLDAsMCwwLDAsMCwwLDAsMCwwLDAsMCwwLDAsMCwwLDAsMCwwLDAsMCwwLDAsMCwwLDAsMCwwLDAsMCwwLDAsMCwwLDAsMCwwLDAsMCwwLDAsMCwwLDAsMF0sImwiOjEsInEiOjYsInIiOjd9fQAAAAAAAAAAAAAAAAAAAAAAAAAAAAAAAAAAAAAAAAAAAA=='}}
prove_58;1;94;Mul;94;147983;94.0;833;0.06812162499954866;{'verificationValue': 94.0, 'proof': {'imageId': [2948630792, 2482136711, 1512618692, 3197082418, 820963868, 463243005, 2815130045, 3835354657], 'receipt': 'AwAAAAAAAAAAAAAAxAciAPPsD8genbvcCN2DvDmorNgPyU2p6hAM/h+8IU0pSDuhAAAAAAAAAAAAAAAAAAAAAAAAAAAAAAAAAAAAAAAAAAAAAAAAAAAAAAAAAAAAAAAAAQAAAAAAAAAAAAAAAAAAAAAAAAAAAAAAAAAAAAAAAAAAAAAAAAAAAAEAAAAAPAEAAAAAAAAEAAAAOTQuMC8BAAB7Indhc19maXJzdF9ldmVudCI6dHJ1ZSwiaW1hZ2VfaWQiOlsyOTQ4NjMwNzkyLDI0ODIxMzY3MTEsMTUxMjYxODY5MiwzMTk3MDgyNDE4LDgyMDk2Mzg2OCw0NjMyNDMwMDUsMjgxNTEzMDA0NSwzODM1MzU0NjU3XSwicWYiOnsiYiI6WzAsNCwwLDAsMCwwLDAsMCwwLDQsMCwwLDAsMCwwLDAsMCwwLDEyOCwyNiwwLDAsMCwwLDAsMCwwLDAsMCwwLDAsMCwwLDAsMCwwLDAsMCwwLDAsMCwwLDAsMCwwLDAsMCwwLDAsMCwwLDAsMCwwLDAsMCwwLDAsMCwwLDAsMCwwLDAsMCwwLDAsMCwwLDAsMCwwLDBdLCJsIjoxLCJxIjo2LCJyIjo3fX0AAAAAAAAAAAAAAAAAPAEAAAAAAAAEAAAAOTQuMC8BAAB7Indhc19maXJzdF9ldmVudCI6dHJ1ZSwiaW1hZ2VfaWQiOlsyOTQ4NjMwNzkyLDI0ODIxMzY3MTEsMTUxMjYxODY5MiwzMTk3MDgyNDE4LDgyMDk2Mzg2OCw0NjMyNDMwMDUsMjgxNTEzMDA0NSwzODM1MzU0NjU3XSwicWYiOnsiYiI6WzAsNCwwLDAsMCwwLDAsMCwwLDQsMCwwLDAsMCwwLDAsMCwwLDEyOCwyNiwwLDAsMCwwLDAsMCwwLDAsMCwwLDAsMCwwLDAsMCwwLDAsMCwwLDAsMCwwLDAsMCwwLDAsMCwwLDAsMCwwLDAsMCwwLDAsMCwwLDAsMCwwLDAsMCwwLDAsMCwwLDAsMCwwLDAsMCwwLDBdLCJsIjoxLCJxIjo2LCJyIjo3fX0AAAAAAAAAAAAAAAAAAAAAAAAAAAAAAAAAAAAAAAAAAAA='}}
prove_59;22;23;Mul;506;148489;506.0;841;0.06830050000098709;{'verificationValue': 506.0, 'proof': {'imageId': [2948630792, 2482136711, 1512618692, 3197082418, 820963868, 463243005, 2815130045, 3835354657], 'receipt': 'AwAAAAAAAAAAAAAAxAciAPPsD8genbvcCN2DvDmorNgPyU2p6hAM/h+8IU0pSDuhAAAAAAAAAAAAAAAAAAAAAAAAAAAAAAAAAAAAAAAAAAAAAAAAAAAAAAAAAAAAAAAAAQAAAAAAAAAAAAAAAAAAAAAAAAAAAAAAAAAAAAAAAAAAAAAAAAAAAAEAAAAAQAEAAAAAAAAFAAAANTA2LjAAAAAvAQAAeyJ3YXNfZmlyc3RfZXZlbnQiOnRydWUsImltYWdlX2lkIjpbMjk0ODYzMDc5MiwyNDgyMTM2NzExLDE1MTI2MTg2OTIsMzE5NzA4MjQxOCw4MjA5NjM4NjgsNDYzMjQzMDA1LDI4MTUxMzAwNDUsMzgzNTM1NDY1N10sInFmIjp7ImIiOlswLDQsMCwwLDAsMCwwLDAsMCw0LDAsMCwwLDAsMCwwLDAsMCwxMjgsMjYsMCwwLDAsMCwwLDAsMCwwLDAsMCwwLDAsMCwwLDAsMCwwLDAsMCwwLDAsMCwwLDAsMCwwLDAsMCwwLDAsMCwwLDAsMCwwLDAsMCwwLDAsMCwwLDAsMCwwLDAsMCwwLDAsMCwwLDAsMCwwXSwibCI6MSwicSI6NiwiciI6N319AAAAAAAAAAAAAAAAAEABAAAAAAAABQAAADUwNi4wAAAALwEAAHsid2FzX2ZpcnN0X2V2ZW50Ijp0cnVlLCJpbWFnZV9pZCI6WzI5NDg2MzA3OTIsMjQ4MjEzNjcxMSwxNTEyNjE4NjkyLDMxOTcwODI0MTgsODIwOTYzODY4LDQ2MzI0MzAwNSwyODE1MTMwMDQ1LDM4MzUzNTQ2NTddLCJxZiI6eyJiIjpbMCw0LDAsMCwwLDAsMCwwLDAsNCwwLDAsMCwwLDAsMCwwLDAsMTI4LDI2LDAsMCwwLDAsMCwwLDAsMCwwLDAsMCwwLDAsMCwwLDAsMCwwLDAsMCwwLDAsMCwwLDAsMCwwLDAsMCwwLDAsMCwwLDAsMCwwLDAsMCwwLDAsMCwwLDAsMCwwLDAsMCwwLDAsMCwwLDAsMF0sImwiOjEsInEiOjYsInIiOjd9fQAAAAAAAAAAAAAAAAAAAAAAAAAAAAAAAAAAAAAAAAAAAA=='}}
prove_60;7;42;Mul;294;148783;294.0;841;0.06959254200046416;{'verificationValue': 294.0, 'proof': {'imageId': [2948630792, 2482136711, 1512618692, 3197082418, 820963868, 463243005, 2815130045, 3835354657], 'receipt': 'AwAAAAAAAAAAAAAAxAciAPPsD8genbvcCN2DvDmorNgPyU2p6hAM/h+8IU0pSDuhAAAAAAAAAAAAAAAAAAAAAAAAAAAAAAAAAAAAAAAAAAAAAAAAAAAAAAAAAAAAAAAAAQAAAAAAAAAAAAAAAAAAAAAAAAAAAAAAAAAAAAAAAAAAAAAAAAAAAAEAAAAAQAEAAAAAAAAFAAAAMjk0LjAAAAAvAQAAeyJ3YXNfZmlyc3RfZXZlbnQiOnRydWUsImltYWdlX2lkIjpbMjk0ODYzMDc5MiwyNDgyMTM2NzExLDE1MTI2MTg2OTIsMzE5NzA4MjQxOCw4MjA5NjM4NjgsNDYzMjQzMDA1LDI4MTUxMzAwNDUsMzgzNTM1NDY1N10sInFmIjp7ImIiOlswLDQsMCwwLDAsMCwwLDAsMCw0LDAsMCwwLDAsMCwwLDAsMCwxMjgsMjYsMCwwLDAsMCwwLDAsMCwwLDAsMCwwLDAsMCwwLDAsMCwwLDAsMCwwLDAsMCwwLDAsMCwwLDAsMCwwLDAsMCwwLDAsMCwwLDAsMCwwLDAsMCwwLDAsMCwwLDAsMCwwLDAsMCwwLDAsMCwwXSwibCI6MSwicSI6NiwiciI6N319AAAAAAAAAAAAAAAAAEABAAAAAAAABQAAADI5NC4wAAAALwEAAHsid2FzX2ZpcnN0X2V2ZW50Ijp0cnVlLCJpbWFnZV9pZCI6WzI5NDg2MzA3OTIsMjQ4MjEzNjcxMSwxNTEyNjE4NjkyLDMxOTcwODI0MTgsODIwOTYzODY4LDQ2MzI0MzAwNSwyODE1MTMwMDQ1LDM4MzUzNTQ2NTddLCJxZiI6eyJiIjpbMCw0LDAsMCwwLDAsMCwwLDAsNCwwLDAsMCwwLDAsMCwwLDAsMTI4LDI2LDAsMCwwLDAsMCwwLDAsMCwwLDAsMCwwLDAsMCwwLDAsMCwwLDAsMCwwLDAsMCwwLDAsMCwwLDAsMCwwLDAsMCwwLDAsMCwwLDAsMCwwLDAsMCwwLDAsMCwwLDAsMCwwLDAsMCwwLDAsMF0sImwiOjEsInEiOjYsInIiOjd9fQAAAAAAAAAAAAAAAAAAAAAAAAAAAAAAAAAAAAAAAAAAAA=='}}
prove_61;29;18;Mul;522;149305;522.0;841;0.06842858399977558;{'verificationValue': 522.0, 'proof': {'imageId': [2948630792, 2482136711, 1512618692, 3197082418, 820963868, 463243005, 2815130045, 3835354657], 'receipt': 'AwAAAAAAAAAAAAAAxAciAPPsD8genbvcCN2DvDmorNgPyU2p6hAM/h+8IU0pSDuhAAAAAAAAAAAAAAAAAAAAAAAAAAAAAAAAAAAAAAAAAAAAAAAAAAAAAAAAAAAAAAAAAQAAAAAAAAAAAAAAAAAAAAAAAAAAAAAAAAAAAAAAAAAAAAAAAAAAAAEAAAAAQAEAAAAAAAAFAAAANTIyLjAAAAAvAQAAeyJ3YXNfZmlyc3RfZXZlbnQiOnRydWUsImltYWdlX2lkIjpbMjk0ODYzMDc5MiwyNDgyMTM2NzExLDE1MTI2MTg2OTIsMzE5NzA4MjQxOCw4MjA5NjM4NjgsNDYzMjQzMDA1LDI4MTUxMzAwNDUsMzgzNTM1NDY1N10sInFmIjp7ImIiOlswLDQsMCwwLDAsMCwwLDAsMCw0LDAsMCwwLDAsMCwwLDAsMCwxMjgsMjYsMCwwLDAsMCwwLDAsMCwwLDAsMCwwLDAsMCwwLDAsMCwwLDAsMCwwLDAsMCwwLDAsMCwwLDAsMCwwLDAsMCwwLDAsMCwwLDAsMCwwLDAsMCwwLDAsMCwwLDAsMCwwLDAsMCwwLDAsMCwwXSwibCI6MSwicSI6NiwiciI6N319AAAAAAAAAAAAAAAAAEABAAAAAAAABQAAADUyMi4wAAAALwEAAHsid2FzX2ZpcnN0X2V2ZW50Ijp0cnVlLCJpbWFnZV9pZCI6WzI5NDg2MzA3OTIsMjQ4MjEzNjcxMSwxNTEyNjE4NjkyLDMxOTcwODI0MTgsODIwOTYzODY4LDQ2MzI0MzAwNSwyODE1MTMwMDQ1LDM4MzUzNTQ2NTddLCJxZiI6eyJiIjpbMCw0LDAsMCwwLDAsMCwwLDAsNCwwLDAsMCwwLDAsMCwwLDAsMTI4LDI2LDAsMCwwLDAsMCwwLDAsMCwwLDAsMCwwLDAsMCwwLDAsMCwwLDAsMCwwLDAsMCwwLDAsMCwwLDAsMCwwLDAsMCwwLDAsMCwwLDAsMCwwLDAsMCwwLDAsMCwwLDAsMCwwLDAsMCwwLDAsMF0sImwiOjEsInEiOjYsInIiOjd9fQAAAAAAAAAAAAAAAAAAAAAAAAAAAAAAAAAAAAAAAAAAAA=='}}
prove_62;97;21;Mul;2037;151342;2037.0;841;0.06825637499969162;{'verificationValue': 2037.0, 'proof': {'imageId': [2948630792, 2482136711, 1512618692, 3197082418, 820963868, 463243005, 2815130045, 3835354657], 'receipt': 'AwAAAAAAAAAAAAAAxAciAPPsD8genbvcCN2DvDmorNgPyU2p6hAM/h+8IU0pSDuhAAAAAAAAAAAAAAAAAAAAAAAAAAAAAAAAAAAAAAAAAAAAAAAAAAAAAAAAAAAAAAAAAQAAAAAAAAAAAAAAAAAAAAAAAAAAAAAAAAAAAAAAAAAAAAAAAAAAAAEAAAAAQAEAAAAAAAAGAAAAMjAzNy4wAAAvAQAAeyJ3YXNfZmlyc3RfZXZlbnQiOnRydWUsImltYWdlX2lkIjpbMjk0ODYzMDc5MiwyNDgyMTM2NzExLDE1MTI2MTg2OTIsMzE5NzA4MjQxOCw4MjA5NjM4NjgsNDYzMjQzMDA1LDI4MTUxMzAwNDUsMzgzNTM1NDY1N10sInFmIjp7ImIiOlswLDQsMCwwLDAsMCwwLDAsMCw0LDAsMCwwLDAsMCwwLDAsMCwxMjgsMjYsMCwwLDAsMCwwLDAsMCwwLDAsMCwwLDAsMCwwLDAsMCwwLDAsMCwwLDAsMCwwLDAsMCwwLDAsMCwwLDAsMCwwLDAsMCwwLDAsMCwwLDAsMCwwLDAsMCwwLDAsMCwwLDAsMCwwLDAsMCwwXSwibCI6MSwicSI6NiwiciI6N319AAAAAAAAAAAAAAAAAEABAAAAAAAABgAAADIwMzcuMAAALwEAAHsid2FzX2ZpcnN0X2V2ZW50Ijp0cnVlLCJpbWFnZV9pZCI6WzI5NDg2MzA3OTIsMjQ4MjEzNjcxMSwxNTEyNjE4NjkyLDMxOTcwODI0MTgsODIwOTYzODY4LDQ2MzI0MzAwNSwyODE1MTMwMDQ1LDM4MzUzNTQ2NTddLCJxZiI6eyJiIjpbMCw0LDAsMCwwLDAsMCwwLDAsNCwwLDAsMCwwLDAsMCwwLDAsMTI4LDI2LDAsMCwwLDAsMCwwLDAsMCwwLDAsMCwwLDAsMCwwLDAsMCwwLDAsMCwwLDAsMCwwLDAsMCwwLDAsMCwwLDAsMCwwLDAsMCwwLDAsMCwwLDAsMCwwLDAsMCwwLDAsMCwwLDAsMCwwLDAsMF0sImwiOjEsInEiOjYsInIiOjd9fQAAAAAAAAAAAAAAAAAAAAAAAAAAAAAAAAAAAAAAAAAAAA=='}}
prove_63;50;76;Mul;3800;155142;3800.0;841;0.06821883300108311;{'verificationValue': 3800.0, 'proof': {'imageId': [2948630792, 2482136711, 1512618692, 3197082418, 820963868, 463243005, 2815130045, 3835354657], 'receipt': 'AwAAAAAAAAAAAAAAxAciAPPsD8genbvcCN2DvDmorNgPyU2p6hAM/h+8IU0pSDuhAAAAAAAAAAAAAAAAAAAAAAAAAAAAAAAAAAAAAAAAAAAAAAAAAAAAAAAAAAAAAAAAAQAAAAAAAAAAAAAAAAAAAAAAAAAAAAAAAAAAAAAAAAAAAAAAAAAAAAEAAAAAQAEAAAAAAAAGAAAAMzgwMC4wAAAvAQAAeyJ3YXNfZmlyc3RfZXZlbnQiOnRydWUsImltYWdlX2lkIjpbMjk0ODYzMDc5MiwyNDgyMTM2NzExLDE1MTI2MTg2OTIsMzE5NzA4MjQxOCw4MjA5NjM4NjgsNDYzMjQzMDA1LDI4MTUxMzAwNDUsMzgzNTM1NDY1N10sInFmIjp7ImIiOlswLDQsMCwwLDAsMCwwLDAsMCw0LDAsMCwwLDAsMCwwLDAsMCwxMjgsMjYsMCwwLDAsMCwwLDAsMCwwLDAsMCwwLDAsMCwwLDAsMCwwLDAsMCwwLDAsMCwwLDAsMCwwLDAsMCwwLDAsMCwwLDAsMCwwLDAsMCwwLDAsMCwwLDAsMCwwLDAsMCwwLDAsMCwwLDAsMCwwXSwibCI6MSwicSI6NiwiciI6N319AAAAAAAAAAAAAAAAAEABAAAAAAAABgAAADM4MDAuMAAALwEAAHsid2FzX2ZpcnN0X2V2ZW50Ijp0cnVlLCJpbWFnZV9pZCI6WzI5NDg2MzA3OTIsMjQ4MjEzNjcxMSwxNTEyNjE4NjkyLDMxOTcwODI0MTgsODIwOTYzODY4LDQ2MzI0MzAwNSwyODE1MTMwMDQ1LDM4MzUzNTQ2NTddLCJxZiI6eyJiIjpbMCw0LDAsMCwwLDAsMCwwLDAsNCwwLDAsMCwwLDAsMCwwLDAsMTI4LDI2LDAsMCwwLDAsMCwwLDAsMCwwLDAsMCwwLDAsMCwwLDAsMCwwLDAsMCwwLDAsMCwwLDAsMCwwLDAsMCwwLDAsMCwwLDAsMCwwLDAsMCwwLDAsMCwwLDAsMCwwLDAsMCwwLDAsMCwwLDAsMF0sImwiOjEsInEiOjYsInIiOjd9fQAAAAAAAAAAAAAAAAAAAAAAAAAAAAAAAAAAAAAAAAAAAA=='}}
prove_64;6;22;Mul;132;155274;132.0;841;0.06728616600048554;{'verificationValue': 132.0, 'proof': {'imageId': [2948630792, 2482136711, 1512618692, 3197082418, 820963868, 463243005, 2815130045, 3835354657], 'receipt': 'AwAAAAAAAAAAAAAAxAciAPPsD8genbvcCN2DvDmorNgPyU2p6hAM/h+8IU0pSDuhAAAAAAAAAAAAAAAAAAAAAAAAAAAAAAAAAAAAAAAAAAAAAAAAAAAAAAAAAAAAAAAAAQAAAAAAAAAAAAAAAAAAAAAAAAAAAAAAAAAAAAAAAAAAAAAAAAAAAAEAAAAAQAEAAAAAAAAFAAAAMTMyLjAAAAAvAQAAeyJ3YXNfZmlyc3RfZXZlbnQiOnRydWUsImltYWdlX2lkIjpbMjk0ODYzMDc5MiwyNDgyMTM2NzExLDE1MTI2MTg2OTIsMzE5NzA4MjQxOCw4MjA5NjM4NjgsNDYzMjQzMDA1LDI4MTUxMzAwNDUsMzgzNTM1NDY1N10sInFmIjp7ImIiOlswLDQsMCwwLDAsMCwwLDAsMCw0LDAsMCwwLDAsMCwwLDAsMCwxMjgsMjYsMCwwLDAsMCwwLDAsMCwwLDAsMCwwLDAsMCwwLDAsMCwwLDAsMCwwLDAsMCwwLDAsMCwwLDAsMCwwLDAsMCwwLDAsMCwwLDAsMCwwLDAsMCwwLDAsMCwwLDAsMCwwLDAsMCwwLDAsMCwwXSwibCI6MSwicSI6NiwiciI6N319AAAAAAAAAAAAAAAAAEABAAAAAAAABQAAADEzMi4wAAAALwEAAHsid2FzX2ZpcnN0X2V2ZW50Ijp0cnVlLCJpbWFnZV9pZCI6WzI5NDg2MzA3OTIsMjQ4MjEzNjcxMSwxNTEyNjE4NjkyLDMxOTcwODI0MTgsODIwOTYzODY4LDQ2MzI0MzAwNSwyODE1MTMwMDQ1LDM4MzUzNTQ2NTddLCJxZiI6eyJiIjpbMCw0LDAsMCwwLDAsMCwwLDAsNCwwLDAsMCwwLDAsMCwwLDAsMTI4LDI2LDAsMCwwLDAsMCwwLDAsMCwwLDAsMCwwLDAsMCwwLDAsMCwwLDAsMCwwLDAsMCwwLDAsMCwwLDAsMCwwLDAsMCwwLDAsMCwwLDAsMCwwLDAsMCwwLDAsMCwwLDAsMCwwLDAsMCwwLDAsMF0sImwiOjEsInEiOjYsInIiOjd9fQAAAAAAAAAAAAAAAAAAAAAAAAAAAAAAAAAAAAAAAAAAAA=='}}
prove_65;32;93;Mul;2976;158250;2976.0;841;0.06876287500017497;{'verificationValue': 2976.0, 'proof': {'imageId': [2948630792, 2482136711, 1512618692, 3197082418, 820963868, 463243005, 2815130045, 3835354657], 'receipt': 'AwAAAAAAAAAAAAAAxAciAPPsD8genbvcCN2DvDmorNgPyU2p6hAM/h+8IU0pSDuhAAAAAAAAAAAAAAAAAAAAAAAAAAAAAAAAAAAAAAAAAAAAAAAAAAAAAAAAAAAAAAAAAQAAAAAAAAAAAAAAAAAAAAAAAAAAAAAAAAAAAAAAAAAAAAAAAAAAAAEAAAAAQAEAAAAAAAAGAAAAMjk3Ni4wAAAvAQAAeyJ3YXNfZmlyc3RfZXZlbnQiOnRydWUsImltYWdlX2lkIjpbMjk0ODYzMDc5MiwyNDgyMTM2NzExLDE1MTI2MTg2OTIsMzE5NzA4MjQxOCw4MjA5NjM4NjgsNDYzMjQzMDA1LDI4MTUxMzAwNDUsMzgzNTM1NDY1N10sInFmIjp7ImIiOlswLDQsMCwwLDAsMCwwLDAsMCw0LDAsMCwwLDAsMCwwLDAsMCwxMjgsMjYsMCwwLDAsMCwwLDAsMCwwLDAsMCwwLDAsMCwwLDAsMCwwLDAsMCwwLDAsMCwwLDAsMCwwLDAsMCwwLDAsMCwwLDAsMCwwLDAsMCwwLDAsMCwwLDAsMCwwLDAsMCwwLDAsMCwwLDAsMCwwXSwibCI6MSwicSI6NiwiciI6N319AAAAAAAAAAAAAAAAAEABAAAAAAAABgAAADI5NzYuMAAALwEAAHsid2FzX2ZpcnN0X2V2ZW50Ijp0cnVlLCJpbWFnZV9pZCI6WzI5NDg2MzA3OTIsMjQ4MjEzNjcxMSwxNTEyNjE4NjkyLDMxOTcwODI0MTgsODIwOTYzODY4LDQ2MzI0MzAwNSwyODE1MTMwMDQ1LDM4MzUzNTQ2NTddLCJxZiI6eyJiIjpbMCw0LDAsMCwwLDAsMCwwLDAsNCwwLDAsMCwwLDAsMCwwLDAsMTI4LDI2LDAsMCwwLDAsMCwwLDAsMCwwLDAsMCwwLDAsMCwwLDAsMCwwLDAsMCwwLDAsMCwwLDAsMCwwLDAsMCwwLDAsMCwwLDAsMCwwLDAsMCwwLDAsMCwwLDAsMCwwLDAsMCwwLDAsMCwwLDAsMF0sImwiOjEsInEiOjYsInIiOjd9fQAAAAAAAAAAAAAAAAAAAAAAAAAAAAAAAAAAAAAAAAAAAA=='}}
prove_66;43;99;Mul;4257;162507;4257.0;841;0.06810858399876452;{'verificationValue': 4257.0, 'proof': {'imageId': [2948630792, 2482136711, 1512618692, 3197082418, 820963868, 463243005, 2815130045, 3835354657], 'receipt': 'AwAAAAAAAAAAAAAAxAciAPPsD8genbvcCN2DvDmorNgPyU2p6hAM/h+8IU0pSDuhAAAAAAAAAAAAAAAAAAAAAAAAAAAAAAAAAAAAAAAAAAAAAAAAAAAAAAAAAAAAAAAAAQAAAAAAAAAAAAAAAAAAAAAAAAAAAAAAAAAAAAAAAAAAAAAAAAAAAAEAAAAAQAEAAAAAAAAGAAAANDI1Ny4wAAAvAQAAeyJ3YXNfZmlyc3RfZXZlbnQiOnRydWUsImltYWdlX2lkIjpbMjk0ODYzMDc5MiwyNDgyMTM2NzExLDE1MTI2MTg2OTIsMzE5NzA4MjQxOCw4MjA5NjM4NjgsNDYzMjQzMDA1LDI4MTUxMzAwNDUsMzgzNTM1NDY1N10sInFmIjp7ImIiOlswLDQsMCwwLDAsMCwwLDAsMCw0LDAsMCwwLDAsMCwwLDAsMCwxMjgsMjYsMCwwLDAsMCwwLDAsMCwwLDAsMCwwLDAsMCwwLDAsMCwwLDAsMCwwLDAsMCwwLDAsMCwwLDAsMCwwLDAsMCwwLDAsMCwwLDAsMCwwLDAsMCwwLDAsMCwwLDAsMCwwLDAsMCwwLDAsMCwwXSwibCI6MSwicSI6NiwiciI6N319AAAAAAAAAAAAAAAAAEABAAAAAAAABgAAADQyNTcuMAAALwEAAHsid2FzX2ZpcnN0X2V2ZW50Ijp0cnVlLCJpbWFnZV9pZCI6WzI5NDg2MzA3OTIsMjQ4MjEzNjcxMSwxNTEyNjE4NjkyLDMxOTcwODI0MTgsODIwOTYzODY4LDQ2MzI0MzAwNSwyODE1MTMwMDQ1LDM4MzUzNTQ2NTddLCJxZiI6eyJiIjpbMCw0LDAsMCwwLDAsMCwwLDAsNCwwLDAsMCwwLDAsMCwwLDAsMTI4LDI2LDAsMCwwLDAsMCwwLDAsMCwwLDAsMCwwLDAsMCwwLDAsMCwwLDAsMCwwLDAsMCwwLDAsMCwwLDAsMCwwLDAsMCwwLDAsMCwwLDAsMCwwLDAsMCwwLDAsMCwwLDAsMCwwLDAsMCwwLDAsMF0sImwiOjEsInEiOjYsInIiOjd9fQAAAAAAAAAAAAAAAAAAAAAAAAAAAAAAAAAAAAAAAAAAAA=='}}
prove_67;34;79;Mul;2686;165193;2686.0;841;0.06927941600042686;{'verificationValue': 2686.0, 'proof': {'imageId': [2948630792, 2482136711, 1512618692, 3197082418, 820963868, 463243005, 2815130045, 3835354657], 'receipt': 'AwAAAAAAAAAAAAAAxAciAPPsD8genbvcCN2DvDmorNgPyU2p6hAM/h+8IU0pSDuhAAAAAAAAAAAAAAAAAAAAAAAAAAAAAAAAAAAAAAAAAAAAAAAAAAAAAAAAAAAAAAAAAQAAAAAAAAAAAAAAAAAAAAAAAAAAAAAAAAAAAAAAAAAAAAAAAAAAAAEAAAAAQAEAAAAAAAAGAAAAMjY4Ni4wAAAvAQAAeyJ3YXNfZmlyc3RfZXZlbnQiOnRydWUsImltYWdlX2lkIjpbMjk0ODYzMDc5MiwyNDgyMTM2NzExLDE1MTI2MTg2OTIsMzE5NzA4MjQxOCw4MjA5NjM4NjgsNDYzMjQzMDA1LDI4MTUxMzAwNDUsMzgzNTM1NDY1N10sInFmIjp7ImIiOlswLDQsMCwwLDAsMCwwLDAsMCw0LDAsMCwwLDAsMCwwLDAsMCwxMjgsMjYsMCwwLDAsMCwwLDAsMCwwLDAsMCwwLDAsMCwwLDAsMCwwLDAsMCwwLDAsMCwwLDAsMCwwLDAsMCwwLDAsMCwwLDAsMCwwLDAsMCwwLDAsMCwwLDAsMCwwLDAsMCwwLDAsMCwwLDAsMCwwXSwibCI6MSwicSI6NiwiciI6N319AAAAAAAAAAAAAAAAAEABAAAAAAAABgAAADI2ODYuMAAALwEAAHsid2FzX2ZpcnN0X2V2ZW50Ijp0cnVlLCJpbWFnZV9pZCI6WzI5NDg2MzA3OTIsMjQ4MjEzNjcxMSwxNTEyNjE4NjkyLDMxOTcwODI0MTgsODIwOTYzODY4LDQ2MzI0MzAwNSwyODE1MTMwMDQ1LDM4MzUzNTQ2NTddLCJxZiI6eyJiIjpbMCw0LDAsMCwwLDAsMCwwLDAsNCwwLDAsMCwwLDAsMCwwLDAsMTI4LDI2LDAsMCwwLDAsMCwwLDAsMCwwLDAsMCwwLDAsMCwwLDAsMCwwLDAsMCwwLDAsMCwwLDAsMCwwLDAsMCwwLDAsMCwwLDAsMCwwLDAsMCwwLDAsMCwwLDAsMCwwLDAsMCwwLDAsMCwwLDAsMF0sImwiOjEsInEiOjYsInIiOjd9fQAAAAAAAAAAAAAAAAAAAAAAAAAAAAAAAAAAAAAAAAAAAA=='}}
prove_68;71;32;Mul;2272;167465;2272.0;841;0.06897766700058128;{'verificationValue': 2272.0, 'proof': {'imageId': [2948630792, 2482136711, 1512618692, 3197082418, 820963868, 463243005, 2815130045, 3835354657], 'receipt': 'AwAAAAAAAAAAAAAAxAciAPPsD8genbvcCN2DvDmorNgPyU2p6hAM/h+8IU0pSDuhAAAAAAAAAAAAAAAAAAAAAAAAAAAAAAAAAAAAAAAAAAAAAAAAAAAAAAAAAAAAAAAAAQAAAAAAAAAAAAAAAAAAAAAAAAAAAAAAAAAAAAAAAAAAAAAAAAAAAAEAAAAAQAEAAAAAAAAGAAAAMjI3Mi4wAAAvAQAAeyJ3YXNfZmlyc3RfZXZlbnQiOnRydWUsImltYWdlX2lkIjpbMjk0ODYzMDc5MiwyNDgyMTM2NzExLDE1MTI2MTg2OTIsMzE5NzA4MjQxOCw4MjA5NjM4NjgsNDYzMjQzMDA1LDI4MTUxMzAwNDUsMzgzNTM1NDY1N10sInFmIjp7ImIiOlswLDQsMCwwLDAsMCwwLDAsMCw0LDAsMCwwLDAsMCwwLDAsMCwxMjgsMjYsMCwwLDAsMCwwLDAsMCwwLDAsMCwwLDAsMCwwLDAsMCwwLDAsMCwwLDAsMCwwLDAsMCwwLDAsMCwwLDAsMCwwLDAsMCwwLDAsMCwwLDAsMCwwLDAsMCwwLDAsMCwwLDAsMCwwLDAsMCwwXSwibCI6MSwicSI6NiwiciI6N319AAAAAAAAAAAAAAAAAEABAAAAAAAABgAAADIyNzIuMAAALwEAAHsid2FzX2ZpcnN0X2V2ZW50Ijp0cnVlLCJpbWFnZV9pZCI6WzI5NDg2MzA3OTIsMjQ4MjEzNjcxMSwxNTEyNjE4NjkyLDMxOTcwODI0MTgsODIwOTYzODY4LDQ2MzI0MzAwNSwyODE1MTMwMDQ1LDM4MzUzNTQ2NTddLCJxZiI6eyJiIjpbMCw0LDAsMCwwLDAsMCwwLDAsNCwwLDAsMCwwLDAsMCwwLDAsMTI4LDI2LDAsMCwwLDAsMCwwLDAsMCwwLDAsMCwwLDAsMCwwLDAsMCwwLDAsMCwwLDAsMCwwLDAsMCwwLDAsMCwwLDAsMCwwLDAsMCwwLDAsMCwwLDAsMCwwLDAsMCwwLDAsMCwwLDAsMCwwLDAsMF0sImwiOjEsInEiOjYsInIiOjd9fQAAAAAAAAAAAAAAAAAAAAAAAAAAAAAAAAAAAAAAAAAAAA=='}}
prove_69;94;15;Mul;1410;168875;1410.0;841;0.06954674999906274;{'verificationValue': 1410.0, 'proof': {'imageId': [2948630792, 2482136711, 1512618692, 3197082418, 820963868, 463243005, 2815130045, 3835354657], 'receipt': 'AwAAAAAAAAAAAAAAxAciAPPsD8genbvcCN2DvDmorNgPyU2p6hAM/h+8IU0pSDuhAAAAAAAAAAAAAAAAAAAAAAAAAAAAAAAAAAAAAAAAAAAAAAAAAAAAAAAAAAAAAAAAAQAAAAAAAAAAAAAAAAAAAAAAAAAAAAAAAAAAAAAAAAAAAAAAAAAAAAEAAAAAQAEAAAAAAAAGAAAAMTQxMC4wAAAvAQAAeyJ3YXNfZmlyc3RfZXZlbnQiOnRydWUsImltYWdlX2lkIjpbMjk0ODYzMDc5MiwyNDgyMTM2NzExLDE1MTI2MTg2OTIsMzE5NzA4MjQxOCw4MjA5NjM4NjgsNDYzMjQzMDA1LDI4MTUxMzAwNDUsMzgzNTM1NDY1N10sInFmIjp7ImIiOlswLDQsMCwwLDAsMCwwLDAsMCw0LDAsMCwwLDAsMCwwLDAsMCwxMjgsMjYsMCwwLDAsMCwwLDAsMCwwLDAsMCwwLDAsMCwwLDAsMCwwLDAsMCwwLDAsMCwwLDAsMCwwLDAsMCwwLDAsMCwwLDAsMCwwLDAsMCwwLDAsMCwwLDAsMCwwLDAsMCwwLDAsMCwwLDAsMCwwXSwibCI6MSwicSI6NiwiciI6N319AAAAAAAAAAAAAAAAAEABAAAAAAAABgAAADE0MTAuMAAALwEAAHsid2FzX2ZpcnN0X2V2ZW50Ijp0cnVlLCJpbWFnZV9pZCI6WzI5NDg2MzA3OTIsMjQ4MjEzNjcxMSwxNTEyNjE4NjkyLDMxOTcwODI0MTgsODIwOTYzODY4LDQ2MzI0MzAwNSwyODE1MTMwMDQ1LDM4MzUzNTQ2NTddLCJxZiI6eyJiIjpbMCw0LDAsMCwwLDAsMCwwLDAsNCwwLDAsMCwwLDAsMCwwLDAsMTI4LDI2LDAsMCwwLDAsMCwwLDAsMCwwLDAsMCwwLDAsMCwwLDAsMCwwLDAsMCwwLDAsMCwwLDAsMCwwLDAsMCwwLDAsMCwwLDAsMCwwLDAsMCwwLDAsMCwwLDAsMCwwLDAsMCwwLDAsMCwwLDAsMF0sImwiOjEsInEiOjYsInIiOjd9fQAAAAAAAAAAAAAAAAAAAAAAAAAAAAAAAAAAAAAAAAAAAA=='}}
prove_70;21;59;Mul;1239;170114;1239.0;841;0.06755662499926984;{'verificationValue': 1239.0, 'proof': {'imageId': [2948630792, 2482136711, 1512618692, 3197082418, 820963868, 463243005, 2815130045, 3835354657], 'receipt': 'AwAAAAAAAAAAAAAAxAciAPPsD8genbvcCN2DvDmorNgPyU2p6hAM/h+8IU0pSDuhAAAAAAAAAAAAAAAAAAAAAAAAAAAAAAAAAAAAAAAAAAAAAAAAAAAAAAAAAAAAAAAAAQAAAAAAAAAAAAAAAAAAAAAAAAAAAAAAAAAAAAAAAAAAAAAAAAAAAAEAAAAAQAEAAAAAAAAGAAAAMTIzOS4wAAAvAQAAeyJ3YXNfZmlyc3RfZXZlbnQiOnRydWUsImltYWdlX2lkIjpbMjk0ODYzMDc5MiwyNDgyMTM2NzExLDE1MTI2MTg2OTIsMzE5NzA4MjQxOCw4MjA5NjM4NjgsNDYzMjQzMDA1LDI4MTUxMzAwNDUsMzgzNTM1NDY1N10sInFmIjp7ImIiOlswLDQsMCwwLDAsMCwwLDAsMCw0LDAsMCwwLDAsMCwwLDAsMCwxMjgsMjYsMCwwLDAsMCwwLDAsMCwwLDAsMCwwLDAsMCwwLDAsMCwwLDAsMCwwLDAsMCwwLDAsMCwwLDAsMCwwLDAsMCwwLDAsMCwwLDAsMCwwLDAsMCwwLDAsMCwwLDAsMCwwLDAsMCwwLDAsMCwwXSwibCI6MSwicSI6NiwiciI6N319AAAAAAAAAAAAAAAAAEABAAAAAAAABgAAADEyMzkuMAAALwEAAHsid2FzX2ZpcnN0X2V2ZW50Ijp0cnVlLCJpbWFnZV9pZCI6WzI5NDg2MzA3OTIsMjQ4MjEzNjcxMSwxNTEyNjE4NjkyLDMxOTcwODI0MTgsODIwOTYzODY4LDQ2MzI0MzAwNSwyODE1MTMwMDQ1LDM4MzUzNTQ2NTddLCJxZiI6eyJiIjpbMCw0LDAsMCwwLDAsMCwwLDAsNCwwLDAsMCwwLDAsMCwwLDAsMTI4LDI2LDAsMCwwLDAsMCwwLDAsMCwwLDAsMCwwLDAsMCwwLDAsMCwwLDAsMCwwLDAsMCwwLDAsMCwwLDAsMCwwLDAsMCwwLDAsMCwwLDAsMCwwLDAsMCwwLDAsMCwwLDAsMCwwLDAsMCwwLDAsMF0sImwiOjEsInEiOjYsInIiOjd9fQAAAAAAAAAAAAAAAAAAAAAAAAAAAAAAAAAAAAAAAAAAAA=='}}
prove_71;99;52;Mul;5148;175262;5148.0;841;0.06855979099964316;{'verificationValue': 5148.0, 'proof': {'imageId': [2948630792, 2482136711, 1512618692, 3197082418, 820963868, 463243005, 2815130045, 3835354657], 'receipt': 'AwAAAAAAAAAAAAAAxAciAPPsD8genbvcCN2DvDmorNgPyU2p6hAM/h+8IU0pSDuhAAAAAAAAAAAAAAAAAAAAAAAAAAAAAAAAAAAAAAAAAAAAAAAAAAAAAAAAAAAAAAAAAQAAAAAAAAAAAAAAAAAAAAAAAAAAAAAAAAAAAAAAAAAAAAAAAAAAAAEAAAAAQAEAAAAAAAAGAAAANTE0OC4wAAAvAQAAeyJ3YXNfZmlyc3RfZXZlbnQiOnRydWUsImltYWdlX2lkIjpbMjk0ODYzMDc5MiwyNDgyMTM2NzExLDE1MTI2MTg2OTIsMzE5NzA4MjQxOCw4MjA5NjM4NjgsNDYzMjQzMDA1LDI4MTUxMzAwNDUsMzgzNTM1NDY1N10sInFmIjp7ImIiOlswLDQsMCwwLDAsMCwwLDAsMCw0LDAsMCwwLDAsMCwwLDAsMCwxMjgsMjYsMCwwLDAsMCwwLDAsMCwwLDAsMCwwLDAsMCwwLDAsMCwwLDAsMCwwLDAsMCwwLDAsMCwwLDAsMCwwLDAsMCwwLDAsMCwwLDAsMCwwLDAsMCwwLDAsMCwwLDAsMCwwLDAsMCwwLDAsMCwwXSwibCI6MSwicSI6NiwiciI6N319AAAAAAAAAAAAAAAAAEABAAAAAAAABgAAADUxNDguMAAALwEAAHsid2FzX2ZpcnN0X2V2ZW50Ijp0cnVlLCJpbWFnZV9pZCI6WzI5NDg2MzA3OTIsMjQ4MjEzNjcxMSwxNTEyNjE4NjkyLDMxOTcwODI0MTgsODIwOTYzODY4LDQ2MzI0MzAwNSwyODE1MTMwMDQ1LDM4MzUzNTQ2NTddLCJxZiI6eyJiIjpbMCw0LDAsMCwwLDAsMCwwLDAsNCwwLDAsMCwwLDAsMCwwLDAsMTI4LDI2LDAsMCwwLDAsMCwwLDAsMCwwLDAsMCwwLDAsMCwwLDAsMCwwLDAsMCwwLDAsMCwwLDAsMCwwLDAsMCwwLDAsMCwwLDAsMCwwLDAsMCwwLDAsMCwwLDAsMCwwLDAsMCwwLDAsMCwwLDAsMF0sImwiOjEsInEiOjYsInIiOjd9fQAAAAAAAAAAAAAAAAAAAAAAAAAAAAAAAAAAAAAAAAAAAA=='}}
prove_72;73;74;Mul;5402;180664;5402.0;841;0.06739841700073157;{'verificationValue': 5402.0, 'proof': {'imageId': [2948630792, 2482136711, 1512618692, 3197082418, 820963868, 463243005, 2815130045, 3835354657], 'receipt': 'AwAAAAAAAAAAAAAAxAciAPPsD8genbvcCN2DvDmorNgPyU2p6hAM/h+8IU0pSDuhAAAAAAAAAAAAAAAAAAAAAAAAAAAAAAAAAAAAAAAAAAAAAAAAAAAAAAAAAAAAAAAAAQAAAAAAAAAAAAAAAAAAAAAAAAAAAAAAAAAAAAAAAAAAAAAAAAAAAAEAAAAAQAEAAAAAAAAGAAAANTQwMi4wAAAvAQAAeyJ3YXNfZmlyc3RfZXZlbnQiOnRydWUsImltYWdlX2lkIjpbMjk0ODYzMDc5MiwyNDgyMTM2NzExLDE1MTI2MTg2OTIsMzE5NzA4MjQxOCw4MjA5NjM4NjgsNDYzMjQzMDA1LDI4MTUxMzAwNDUsMzgzNTM1NDY1N10sInFmIjp7ImIiOlswLDQsMCwwLDAsMCwwLDAsMCw0LDAsMCwwLDAsMCwwLDAsMCwxMjgsMjYsMCwwLDAsMCwwLDAsMCwwLDAsMCwwLDAsMCwwLDAsMCwwLDAsMCwwLDAsMCwwLDAsMCwwLDAsMCwwLDAsMCwwLDAsMCwwLDAsMCwwLDAsMCwwLDAsMCwwLDAsMCwwLDAsMCwwLDAsMCwwXSwibCI6MSwicSI6NiwiciI6N319AAAAAAAAAAAAAAAAAEABAAAAAAAABgAAADU0MDIuMAAALwEAAHsid2FzX2ZpcnN0X2V2ZW50Ijp0cnVlLCJpbWFnZV9pZCI6WzI5NDg2MzA3OTIsMjQ4MjEzNjcxMSwxNTEyNjE4NjkyLDMxOTcwODI0MTgsODIwOTYzODY4LDQ2MzI0MzAwNSwyODE1MTMwMDQ1LDM4MzUzNTQ2NTddLCJxZiI6eyJiIjpbMCw0LDAsMCwwLDAsMCwwLDAsNCwwLDAsMCwwLDAsMCwwLDAsMTI4LDI2LDAsMCwwLDAsMCwwLDAsMCwwLDAsMCwwLDAsMCwwLDAsMCwwLDAsMCwwLDAsMCwwLDAsMCwwLDAsMCwwLDAsMCwwLDAsMCwwLDAsMCwwLDAsMCwwLDAsMCwwLDAsMCwwLDAsMCwwLDAsMF0sImwiOjEsInEiOjYsInIiOjd9fQAAAAAAAAAAAAAAAAAAAAAAAAAAAAAAAAAAAAAAAAAAAA=='}}
prove_73;48;3;Mul;144;180808;144.0;841;0.06834129200069583;{'verificationValue': 144.0, 'proof': {'imageId': [2948630792, 2482136711, 1512618692, 3197082418, 820963868, 463243005, 2815130045, 3835354657], 'receipt': 'AwAAAAAAAAAAAAAAxAciAPPsD8genbvcCN2DvDmorNgPyU2p6hAM/h+8IU0pSDuhAAAAAAAAAAAAAAAAAAAAAAAAAAAAAAAAAAAAAAAAAAAAAAAAAAAAAAAAAAAAAAAAAQAAAAAAAAAAAAAAAAAAAAAAAAAAAAAAAAAAAAAAAAAAAAAAAAAAAAEAAAAAQAEAAAAAAAAFAAAAMTQ0LjAAAAAvAQAAeyJ3YXNfZmlyc3RfZXZlbnQiOnRydWUsImltYWdlX2lkIjpbMjk0ODYzMDc5MiwyNDgyMTM2NzExLDE1MTI2MTg2OTIsMzE5NzA4MjQxOCw4MjA5NjM4NjgsNDYzMjQzMDA1LDI4MTUxMzAwNDUsMzgzNTM1NDY1N10sInFmIjp7ImIiOlswLDQsMCwwLDAsMCwwLDAsMCw0LDAsMCwwLDAsMCwwLDAsMCwxMjgsMjYsMCwwLDAsMCwwLDAsMCwwLDAsMCwwLDAsMCwwLDAsMCwwLDAsMCwwLDAsMCwwLDAsMCwwLDAsMCwwLDAsMCwwLDAsMCwwLDAsMCwwLDAsMCwwLDAsMCwwLDAsMCwwLDAsMCwwLDAsMCwwXSwibCI6MSwicSI6NiwiciI6N319AAAAAAAAAAAAAAAAAEABAAAAAAAABQAAADE0NC4wAAAALwEAAHsid2FzX2ZpcnN0X2V2ZW50Ijp0cnVlLCJpbWFnZV9pZCI6WzI5NDg2MzA3OTIsMjQ4MjEzNjcxMSwxNTEyNjE4NjkyLDMxOTcwODI0MTgsODIwOTYzODY4LDQ2MzI0MzAwNSwyODE1MTMwMDQ1LDM4MzUzNTQ2NTddLCJxZiI6eyJiIjpbMCw0LDAsMCwwLDAsMCwwLDAsNCwwLDAsMCwwLDAsMCwwLDAsMTI4LDI2LDAsMCwwLDAsMCwwLDAsMCwwLDAsMCwwLDAsMCwwLDAsMCwwLDAsMCwwLDAsMCwwLDAsMCwwLDAsMCwwLDAsMCwwLDAsMCwwLDAsMCwwLDAsMCwwLDAsMCwwLDAsMCwwLDAsMCwwLDAsMF0sImwiOjEsInEiOjYsInIiOjd9fQAAAAAAAAAAAAAAAAAAAAAAAAAAAAAAAAAAAAAAAAAAAA=='}}
prove_74;8;29;Mul;232;181040;232.0;841;0.06789808400026232;{'verificationValue': 232.0, 'proof': {'imageId': [2948630792, 2482136711, 1512618692, 3197082418, 820963868, 463243005, 2815130045, 3835354657], 'receipt': 'AwAAAAAAAAAAAAAAxAciAPPsD8genbvcCN2DvDmorNgPyU2p6hAM/h+8IU0pSDuhAAAAAAAAAAAAAAAAAAAAAAAAAAAAAAAAAAAAAAAAAAAAAAAAAAAAAAAAAAAAAAAAAQAAAAAAAAAAAAAAAAAAAAAAAAAAAAAAAAAAAAAAAAAAAAAAAAAAAAEAAAAAQAEAAAAAAAAFAAAAMjMyLjAAAAAvAQAAeyJ3YXNfZmlyc3RfZXZlbnQiOnRydWUsImltYWdlX2lkIjpbMjk0ODYzMDc5MiwyNDgyMTM2NzExLDE1MTI2MTg2OTIsMzE5NzA4MjQxOCw4MjA5NjM4NjgsNDYzMjQzMDA1LDI4MTUxMzAwNDUsMzgzNTM1NDY1N10sInFmIjp7ImIiOlswLDQsMCwwLDAsMCwwLDAsMCw0LDAsMCwwLDAsMCwwLDAsMCwxMjgsMjYsMCwwLDAsMCwwLDAsMCwwLDAsMCwwLDAsMCwwLDAsMCwwLDAsMCwwLDAsMCwwLDAsMCwwLDAsMCwwLDAsMCwwLDAsMCwwLDAsMCwwLDAsMCwwLDAsMCwwLDAsMCwwLDAsMCwwLDAsMCwwXSwibCI6MSwicSI6NiwiciI6N319AAAAAAAAAAAAAAAAAEABAAAAAAAABQAAADIzMi4wAAAALwEAAHsid2FzX2ZpcnN0X2V2ZW50Ijp0cnVlLCJpbWFnZV9pZCI6WzI5NDg2MzA3OTIsMjQ4MjEzNjcxMSwxNTEyNjE4NjkyLDMxOTcwODI0MTgsODIwOTYzODY4LDQ2MzI0MzAwNSwyODE1MTMwMDQ1LDM4MzUzNTQ2NTddLCJxZiI6eyJiIjpbMCw0LDAsMCwwLDAsMCwwLDAsNCwwLDAsMCwwLDAsMCwwLDAsMTI4LDI2LDAsMCwwLDAsMCwwLDAsMCwwLDAsMCwwLDAsMCwwLDAsMCwwLDAsMCwwLDAsMCwwLDAsMCwwLDAsMCwwLDAsMCwwLDAsMCwwLDAsMCwwLDAsMCwwLDAsMCwwLDAsMCwwLDAsMCwwLDAsMF0sImwiOjEsInEiOjYsInIiOjd9fQAAAAAAAAAAAAAAAAAAAAAAAAAAAAAAAAAAAAAAAAAAAA=='}}
prove_75;15;77;Mul;1155;182195;1155.0;841;0.06794554199950653;{'verificationValue': 1155.0, 'proof': {'imageId': [2948630792, 2482136711, 1512618692, 3197082418, 820963868, 463243005, 2815130045, 3835354657], 'receipt': 'AwAAAAAAAAAAAAAAxAciAPPsD8genbvcCN2DvDmorNgPyU2p6hAM/h+8IU0pSDuhAAAAAAAAAAAAAAAAAAAAAAAAAAAAAAAAAAAAAAAAAAAAAAAAAAAAAAAAAAAAAAAAAQAAAAAAAAAAAAAAAAAAAAAAAAAAAAAAAAAAAAAAAAAAAAAAAAAAAAEAAAAAQAEAAAAAAAAGAAAAMTE1NS4wAAAvAQAAeyJ3YXNfZmlyc3RfZXZlbnQiOnRydWUsImltYWdlX2lkIjpbMjk0ODYzMDc5MiwyNDgyMTM2NzExLDE1MTI2MTg2OTIsMzE5NzA4MjQxOCw4MjA5NjM4NjgsNDYzMjQzMDA1LDI4MTUxMzAwNDUsMzgzNTM1NDY1N10sInFmIjp7ImIiOlswLDQsMCwwLDAsMCwwLDAsMCw0LDAsMCwwLDAsMCwwLDAsMCwxMjgsMjYsMCwwLDAsMCwwLDAsMCwwLDAsMCwwLDAsMCwwLDAsMCwwLDAsMCwwLDAsMCwwLDAsMCwwLDAsMCwwLDAsMCwwLDAsMCwwLDAsMCwwLDAsMCwwLDAsMCwwLDAsMCwwLDAsMCwwLDAsMCwwXSwibCI6MSwicSI6NiwiciI6N319AAAAAAAAAAAAAAAAAEABAAAAAAAABgAAADExNTUuMAAALwEAAHsid2FzX2ZpcnN0X2V2ZW50Ijp0cnVlLCJpbWFnZV9pZCI6WzI5NDg2MzA3OTIsMjQ4MjEzNjcxMSwxNTEyNjE4NjkyLDMxOTcwODI0MTgsODIwOTYzODY4LDQ2MzI0MzAwNSwyODE1MTMwMDQ1LDM4MzUzNTQ2NTddLCJxZiI6eyJiIjpbMCw0LDAsMCwwLDAsMCwwLDAsNCwwLDAsMCwwLDAsMCwwLDAsMTI4LDI2LDAsMCwwLDAsMCwwLDAsMCwwLDAsMCwwLDAsMCwwLDAsMCwwLDAsMCwwLDAsMCwwLDAsMCwwLDAsMCwwLDAsMCwwLDAsMCwwLDAsMCwwLDAsMCwwLDAsMCwwLDAsMCwwLDAsMCwwLDAsMF0sImwiOjEsInEiOjYsInIiOjd9fQAAAAAAAAAAAAAAAAAAAAAAAAAAAAAAAAAAAAAAAAAAAA=='}}
prove_76;62;68;Mul;4216;186411;4216.0;841;0.06837837499915622;{'verificationValue': 4216.0, 'proof': {'imageId': [2948630792, 2482136711, 1512618692, 3197082418, 820963868, 463243005, 2815130045, 3835354657], 'receipt': 'AwAAAAAAAAAAAAAAxAciAPPsD8genbvcCN2DvDmorNgPyU2p6hAM/h+8IU0pSDuhAAAAAAAAAAAAAAAAAAAAAAAAAAAAAAAAAAAAAAAAAAAAAAAAAAAAAAAAAAAAAAAAAQAAAAAAAAAAAAAAAAAAAAAAAAAAAAAAAAAAAAAAAAAAAAAAAAAAAAEAAAAAQAEAAAAAAAAGAAAANDIxNi4wAAAvAQAAeyJ3YXNfZmlyc3RfZXZlbnQiOnRydWUsImltYWdlX2lkIjpbMjk0ODYzMDc5MiwyNDgyMTM2NzExLDE1MTI2MTg2OTIsMzE5NzA4MjQxOCw4MjA5NjM4NjgsNDYzMjQzMDA1LDI4MTUxMzAwNDUsMzgzNTM1NDY1N10sInFmIjp7ImIiOlswLDQsMCwwLDAsMCwwLDAsMCw0LDAsMCwwLDAsMCwwLDAsMCwxMjgsMjYsMCwwLDAsMCwwLDAsMCwwLDAsMCwwLDAsMCwwLDAsMCwwLDAsMCwwLDAsMCwwLDAsMCwwLDAsMCwwLDAsMCwwLDAsMCwwLDAsMCwwLDAsMCwwLDAsMCwwLDAsMCwwLDAsMCwwLDAsMCwwXSwibCI6MSwicSI6NiwiciI6N319AAAAAAAAAAAAAAAAAEABAAAAAAAABgAAADQyMTYuMAAALwEAAHsid2FzX2ZpcnN0X2V2ZW50Ijp0cnVlLCJpbWFnZV9pZCI6WzI5NDg2MzA3OTIsMjQ4MjEzNjcxMSwxNTEyNjE4NjkyLDMxOTcwODI0MTgsODIwOTYzODY4LDQ2MzI0MzAwNSwyODE1MTMwMDQ1LDM4MzUzNTQ2NTddLCJxZiI6eyJiIjpbMCw0LDAsMCwwLDAsMCwwLDAsNCwwLDAsMCwwLDAsMCwwLDAsMTI4LDI2LDAsMCwwLDAsMCwwLDAsMCwwLDAsMCwwLDAsMCwwLDAsMCwwLDAsMCwwLDAsMCwwLDAsMCwwLDAsMCwwLDAsMCwwLDAsMCwwLDAsMCwwLDAsMCwwLDAsMCwwLDAsMCwwLDAsMCwwLDAsMF0sImwiOjEsInEiOjYsInIiOjd9fQAAAAAAAAAAAAAAAAAAAAAAAAAAAAAAAAAAAAAAAAAAAA=='}}
prove_77;50;68;Mul;3400;189811;3400.0;841;0.06903600000077859;{'verificationValue': 3400.0, 'proof': {'imageId': [2948630792, 2482136711, 1512618692, 3197082418, 820963868, 463243005, 2815130045, 3835354657], 'receipt': 'AwAAAAAAAAAAAAAAxAciAPPsD8genbvcCN2DvDmorNgPyU2p6hAM/h+8IU0pSDuhAAAAAAAAAAAAAAAAAAAAAAAAAAAAAAAAAAAAAAAAAAAAAAAAAAAAAAAAAAAAAAAAAQAAAAAAAAAAAAAAAAAAAAAAAAAAAAAAAAAAAAAAAAAAAAAAAAAAAAEAAAAAQAEAAAAAAAAGAAAAMzQwMC4wAAAvAQAAeyJ3YXNfZmlyc3RfZXZlbnQiOnRydWUsImltYWdlX2lkIjpbMjk0ODYzMDc5MiwyNDgyMTM2NzExLDE1MTI2MTg2OTIsMzE5NzA4MjQxOCw4MjA5NjM4NjgsNDYzMjQzMDA1LDI4MTUxMzAwNDUsMzgzNTM1NDY1N10sInFmIjp7ImIiOlswLDQsMCwwLDAsMCwwLDAsMCw0LDAsMCwwLDAsMCwwLDAsMCwxMjgsMjYsMCwwLDAsMCwwLDAsMCwwLDAsMCwwLDAsMCwwLDAsMCwwLDAsMCwwLDAsMCwwLDAsMCwwLDAsMCwwLDAsMCwwLDAsMCwwLDAsMCwwLDAsMCwwLDAsMCwwLDAsMCwwLDAsMCwwLDAsMCwwXSwibCI6MSwicSI6NiwiciI6N319AAAAAAAAAAAAAAAAAEABAAAAAAAABgAAADM0MDAuMAAALwEAAHsid2FzX2ZpcnN0X2V2ZW50Ijp0cnVlLCJpbWFnZV9pZCI6WzI5NDg2MzA3OTIsMjQ4MjEzNjcxMSwxNTEyNjE4NjkyLDMxOTcwODI0MTgsODIwOTYzODY4LDQ2MzI0MzAwNSwyODE1MTMwMDQ1LDM4MzUzNTQ2NTddLCJxZiI6eyJiIjpbMCw0LDAsMCwwLDAsMCwwLDAsNCwwLDAsMCwwLDAsMCwwLDAsMTI4LDI2LDAsMCwwLDAsMCwwLDAsMCwwLDAsMCwwLDAsMCwwLDAsMCwwLDAsMCwwLDAsMCwwLDAsMCwwLDAsMCwwLDAsMCwwLDAsMCwwLDAsMCwwLDAsMCwwLDAsMCwwLDAsMCwwLDAsMCwwLDAsMF0sImwiOjEsInEiOjYsInIiOjd9fQAAAAAAAAAAAAAAAAAAAAAAAAAAAAAAAAAAAAAAAAAAAA=='}}
prove_78;65;77;Mul;5005;194816;5005.0;841;0.08398612500059244;{'verificationValue': 5005.0, 'proof': {'imageId': [2948630792, 2482136711, 1512618692, 3197082418, 820963868, 463243005, 2815130045, 3835354657], 'receipt': 'AwAAAAAAAAAAAAAAxAciAPPsD8genbvcCN2DvDmorNgPyU2p6hAM/h+8IU0pSDuhAAAAAAAAAAAAAAAAAAAAAAAAAAAAAAAAAAAAAAAAAAAAAAAAAAAAAAAAAAAAAAAAAQAAAAAAAAAAAAAAAAAAAAAAAAAAAAAAAAAAAAAAAAAAAAAAAAAAAAEAAAAAQAEAAAAAAAAGAAAANTAwNS4wAAAvAQAAeyJ3YXNfZmlyc3RfZXZlbnQiOnRydWUsImltYWdlX2lkIjpbMjk0ODYzMDc5MiwyNDgyMTM2NzExLDE1MTI2MTg2OTIsMzE5NzA4MjQxOCw4MjA5NjM4NjgsNDYzMjQzMDA1LDI4MTUxMzAwNDUsMzgzNTM1NDY1N10sInFmIjp7ImIiOlswLDQsMCwwLDAsMCwwLDAsMCw0LDAsMCwwLDAsMCwwLDAsMCwxMjgsMjYsMCwwLDAsMCwwLDAsMCwwLDAsMCwwLDAsMCwwLDAsMCwwLDAsMCwwLDAsMCwwLDAsMCwwLDAsMCwwLDAsMCwwLDAsMCwwLDAsMCwwLDAsMCwwLDAsMCwwLDAsMCwwLDAsMCwwLDAsMCwwXSwibCI6MSwicSI6NiwiciI6N319AAAAAAAAAAAAAAAAAEABAAAAAAAABgAAADUwMDUuMAAALwEAAHsid2FzX2ZpcnN0X2V2ZW50Ijp0cnVlLCJpbWFnZV9pZCI6WzI5NDg2MzA3OTIsMjQ4MjEzNjcxMSwxNTEyNjE4NjkyLDMxOTcwODI0MTgsODIwOTYzODY4LDQ2MzI0MzAwNSwyODE1MTMwMDQ1LDM4MzUzNTQ2NTddLCJxZiI6eyJiIjpbMCw0LDAsMCwwLDAsMCwwLDAsNCwwLDAsMCwwLDAsMCwwLDAsMTI4LDI2LDAsMCwwLDAsMCwwLDAsMCwwLDAsMCwwLDAsMCwwLDAsMCwwLDAsMCwwLDAsMCwwLDAsMCwwLDAsMCwwLDAsMCwwLDAsMCwwLDAsMCwwLDAsMCwwLDAsMCwwLDAsMCwwLDAsMCwwLDAsMF0sImwiOjEsInEiOjYsInIiOjd9fQAAAAAAAAAAAAAAAAAAAAAAAAAAAAAAAAAAAAAAAAAAAA=='}}
prove_79;14;35;Mul;490;195306;490.0;841;0.06808379199901538;{'verificationValue': 490.0, 'proof': {'imageId': [2948630792, 2482136711, 1512618692, 3197082418, 820963868, 463243005, 2815130045, 3835354657], 'receipt': 'AwAAAAAAAAAAAAAAxAciAPPsD8genbvcCN2DvDmorNgPyU2p6hAM/h+8IU0pSDuhAAAAAAAAAAAAAAAAAAAAAAAAAAAAAAAAAAAAAAAAAAAAAAAAAAAAAAAAAAAAAAAAAQAAAAAAAAAAAAAAAAAAAAAAAAAAAAAAAAAAAAAAAAAAAAAAAAAAAAEAAAAAQAEAAAAAAAAFAAAANDkwLjAAAAAvAQAAeyJ3YXNfZmlyc3RfZXZlbnQiOnRydWUsImltYWdlX2lkIjpbMjk0ODYzMDc5MiwyNDgyMTM2NzExLDE1MTI2MTg2OTIsMzE5NzA4MjQxOCw4MjA5NjM4NjgsNDYzMjQzMDA1LDI4MTUxMzAwNDUsMzgzNTM1NDY1N10sInFmIjp7ImIiOlswLDQsMCwwLDAsMCwwLDAsMCw0LDAsMCwwLDAsMCwwLDAsMCwxMjgsMjYsMCwwLDAsMCwwLDAsMCwwLDAsMCwwLDAsMCwwLDAsMCwwLDAsMCwwLDAsMCwwLDAsMCwwLDAsMCwwLDAsMCwwLDAsMCwwLDAsMCwwLDAsMCwwLDAsMCwwLDAsMCwwLDAsMCwwLDAsMCwwXSwibCI6MSwicSI6NiwiciI6N319AAAAAAAAAAAAAAAAAEABAAAAAAAABQAAADQ5MC4wAAAALwEAAHsid2FzX2ZpcnN0X2V2ZW50Ijp0cnVlLCJpbWFnZV9pZCI6WzI5NDg2MzA3OTIsMjQ4MjEzNjcxMSwxNTEyNjE4NjkyLDMxOTcwODI0MTgsODIwOTYzODY4LDQ2MzI0MzAwNSwyODE1MTMwMDQ1LDM4MzUzNTQ2NTddLCJxZiI6eyJiIjpbMCw0LDAsMCwwLDAsMCwwLDAsNCwwLDAsMCwwLDAsMCwwLDAsMTI4LDI2LDAsMCwwLDAsMCwwLDAsMCwwLDAsMCwwLDAsMCwwLDAsMCwwLDAsMCwwLDAsMCwwLDAsMCwwLDAsMCwwLDAsMCwwLDAsMCwwLDAsMCwwLDAsMCwwLDAsMCwwLDAsMCwwLDAsMCwwLDAsMF0sImwiOjEsInEiOjYsInIiOjd9fQAAAAAAAAAAAAAAAAAAAAAAAAAAAAAAAAAAAAAAAAAAAA=='}}
prove_80;42;89;Mul;3738;199044;3738.0;841;0.0680737090006005;{'verificationValue': 3738.0, 'proof': {'imageId': [2948630792, 2482136711, 1512618692, 3197082418, 820963868, 463243005, 2815130045, 3835354657], 'receipt': 'AwAAAAAAAAAAAAAAxAciAPPsD8genbvcCN2DvDmorNgPyU2p6hAM/h+8IU0pSDuhAAAAAAAAAAAAAAAAAAAAAAAAAAAAAAAAAAAAAAAAAAAAAAAAAAAAAAAAAAAAAAAAAQAAAAAAAAAAAAAAAAAAAAAAAAAAAAAAAAAAAAAAAAAAAAAAAAAAAAEAAAAAQAEAAAAAAAAGAAAAMzczOC4wAAAvAQAAeyJ3YXNfZmlyc3RfZXZlbnQiOnRydWUsImltYWdlX2lkIjpbMjk0ODYzMDc5MiwyNDgyMTM2NzExLDE1MTI2MTg2OTIsMzE5NzA4MjQxOCw4MjA5NjM4NjgsNDYzMjQzMDA1LDI4MTUxMzAwNDUsMzgzNTM1NDY1N10sInFmIjp7ImIiOlswLDQsMCwwLDAsMCwwLDAsMCw0LDAsMCwwLDAsMCwwLDAsMCwxMjgsMjYsMCwwLDAsMCwwLDAsMCwwLDAsMCwwLDAsMCwwLDAsMCwwLDAsMCwwLDAsMCwwLDAsMCwwLDAsMCwwLDAsMCwwLDAsMCwwLDAsMCwwLDAsMCwwLDAsMCwwLDAsMCwwLDAsMCwwLDAsMCwwXSwibCI6MSwicSI6NiwiciI6N319AAAAAAAAAAAAAAAAAEABAAAAAAAABgAAADM3MzguMAAALwEAAHsid2FzX2ZpcnN0X2V2ZW50Ijp0cnVlLCJpbWFnZV9pZCI6WzI5NDg2MzA3OTIsMjQ4MjEzNjcxMSwxNTEyNjE4NjkyLDMxOTcwODI0MTgsODIwOTYzODY4LDQ2MzI0MzAwNSwyODE1MTMwMDQ1LDM4MzUzNTQ2NTddLCJxZiI6eyJiIjpbMCw0LDAsMCwwLDAsMCwwLDAsNCwwLDAsMCwwLDAsMCwwLDAsMTI4LDI2LDAsMCwwLDAsMCwwLDAsMCwwLDAsMCwwLDAsMCwwLDAsMCwwLDAsMCwwLDAsMCwwLDAsMCwwLDAsMCwwLDAsMCwwLDAsMCwwLDAsMCwwLDAsMCwwLDAsMCwwLDAsMCwwLDAsMCwwLDAsMF0sImwiOjEsInEiOjYsInIiOjd9fQAAAAAAAAAAAAAAAAAAAAAAAAAAAAAAAAAAAAAAAAAAAA=='}}
prove_81;65;25;Mul;1625;200669;1625.0;841;0.06830391599942232;{'verificationValue': 1625.0, 'proof': {'imageId': [2948630792, 2482136711, 1512618692, 3197082418, 820963868, 463243005, 2815130045, 3835354657], 'receipt': 'AwAAAAAAAAAAAAAAxAciAPPsD8genbvcCN2DvDmorNgPyU2p6hAM/h+8IU0pSDuhAAAAAAAAAAAAAAAAAAAAAAAAAAAAAAAAAAAAAAAAAAAAAAAAAAAAAAAAAAAAAAAAAQAAAAAAAAAAAAAAAAAAAAAAAAAAAAAAAAAAAAAAAAAAAAAAAAAAAAEAAAAAQAEAAAAAAAAGAAAAMTYyNS4wAAAvAQAAeyJ3YXNfZmlyc3RfZXZlbnQiOnRydWUsImltYWdlX2lkIjpbMjk0ODYzMDc5MiwyNDgyMTM2NzExLDE1MTI2MTg2OTIsMzE5NzA4MjQxOCw4MjA5NjM4NjgsNDYzMjQzMDA1LDI4MTUxMzAwNDUsMzgzNTM1NDY1N10sInFmIjp7ImIiOlswLDQsMCwwLDAsMCwwLDAsMCw0LDAsMCwwLDAsMCwwLDAsMCwxMjgsMjYsMCwwLDAsMCwwLDAsMCwwLDAsMCwwLDAsMCwwLDAsMCwwLDAsMCwwLDAsMCwwLDAsMCwwLDAsMCwwLDAsMCwwLDAsMCwwLDAsMCwwLDAsMCwwLDAsMCwwLDAsMCwwLDAsMCwwLDAsMCwwXSwibCI6MSwicSI6NiwiciI6N319AAAAAAAAAAAAAAAAAEABAAAAAAAABgAAADE2MjUuMAAALwEAAHsid2FzX2ZpcnN0X2V2ZW50Ijp0cnVlLCJpbWFnZV9pZCI6WzI5NDg2MzA3OTIsMjQ4MjEzNjcxMSwxNTEyNjE4NjkyLDMxOTcwODI0MTgsODIwOTYzODY4LDQ2MzI0MzAwNSwyODE1MTMwMDQ1LDM4MzUzNTQ2NTddLCJxZiI6eyJiIjpbMCw0LDAsMCwwLDAsMCwwLDAsNCwwLDAsMCwwLDAsMCwwLDAsMTI4LDI2LDAsMCwwLDAsMCwwLDAsMCwwLDAsMCwwLDAsMCwwLDAsMCwwLDAsMCwwLDAsMCwwLDAsMCwwLDAsMCwwLDAsMCwwLDAsMCwwLDAsMCwwLDAsMCwwLDAsMCwwLDAsMCwwLDAsMCwwLDAsMF0sImwiOjEsInEiOjYsInIiOjd9fQAAAAAAAAAAAAAAAAAAAAAAAAAAAAAAAAAAAAAAAAAAAA=='}}
prove_82;73;55;Mul;4015;204684;4015.0;841;0.06794991699825914;{'verificationValue': 4015.0, 'proof': {'imageId': [2948630792, 2482136711, 1512618692, 3197082418, 820963868, 463243005, 2815130045, 3835354657], 'receipt': 'AwAAAAAAAAAAAAAAxAciAPPsD8genbvcCN2DvDmorNgPyU2p6hAM/h+8IU0pSDuhAAAAAAAAAAAAAAAAAAAAAAAAAAAAAAAAAAAAAAAAAAAAAAAAAAAAAAAAAAAAAAAAAQAAAAAAAAAAAAAAAAAAAAAAAAAAAAAAAAAAAAAAAAAAAAAAAAAAAAEAAAAAQAEAAAAAAAAGAAAANDAxNS4wAAAvAQAAeyJ3YXNfZmlyc3RfZXZlbnQiOnRydWUsImltYWdlX2lkIjpbMjk0ODYzMDc5MiwyNDgyMTM2NzExLDE1MTI2MTg2OTIsMzE5NzA4MjQxOCw4MjA5NjM4NjgsNDYzMjQzMDA1LDI4MTUxMzAwNDUsMzgzNTM1NDY1N10sInFmIjp7ImIiOlswLDQsMCwwLDAsMCwwLDAsMCw0LDAsMCwwLDAsMCwwLDAsMCwxMjgsMjYsMCwwLDAsMCwwLDAsMCwwLDAsMCwwLDAsMCwwLDAsMCwwLDAsMCwwLDAsMCwwLDAsMCwwLDAsMCwwLDAsMCwwLDAsMCwwLDAsMCwwLDAsMCwwLDAsMCwwLDAsMCwwLDAsMCwwLDAsMCwwXSwibCI6MSwicSI6NiwiciI6N319AAAAAAAAAAAAAAAAAEABAAAAAAAABgAAADQwMTUuMAAALwEAAHsid2FzX2ZpcnN0X2V2ZW50Ijp0cnVlLCJpbWFnZV9pZCI6WzI5NDg2MzA3OTIsMjQ4MjEzNjcxMSwxNTEyNjE4NjkyLDMxOTcwODI0MTgsODIwOTYzODY4LDQ2MzI0MzAwNSwyODE1MTMwMDQ1LDM4MzUzNTQ2NTddLCJxZiI6eyJiIjpbMCw0LDAsMCwwLDAsMCwwLDAsNCwwLDAsMCwwLDAsMCwwLDAsMTI4LDI2LDAsMCwwLDAsMCwwLDAsMCwwLDAsMCwwLDAsMCwwLDAsMCwwLDAsMCwwLDAsMCwwLDAsMCwwLDAsMCwwLDAsMCwwLDAsMCwwLDAsMCwwLDAsMCwwLDAsMCwwLDAsMCwwLDAsMCwwLDAsMF0sImwiOjEsInEiOjYsInIiOjd9fQAAAAAAAAAAAAAAAAAAAAAAAAAAAAAAAAAAAAAAAAAAAA=='}}
prove_83;21;5;Mul;105;204789;105.0;841;0.06777516699912667;{'verificationValue': 105.0, 'proof': {'imageId': [2948630792, 2482136711, 1512618692, 3197082418, 820963868, 463243005, 2815130045, 3835354657], 'receipt': 'AwAAAAAAAAAAAAAAxAciAPPsD8genbvcCN2DvDmorNgPyU2p6hAM/h+8IU0pSDuhAAAAAAAAAAAAAAAAAAAAAAAAAAAAAAAAAAAAAAAAAAAAAAAAAAAAAAAAAAAAAAAAAQAAAAAAAAAAAAAAAAAAAAAAAAAAAAAAAAAAAAAAAAAAAAAAAAAAAAEAAAAAQAEAAAAAAAAFAAAAMTA1LjAAAAAvAQAAeyJ3YXNfZmlyc3RfZXZlbnQiOnRydWUsImltYWdlX2lkIjpbMjk0ODYzMDc5MiwyNDgyMTM2NzExLDE1MTI2MTg2OTIsMzE5NzA4MjQxOCw4MjA5NjM4NjgsNDYzMjQzMDA1LDI4MTUxMzAwNDUsMzgzNTM1NDY1N10sInFmIjp7ImIiOlswLDQsMCwwLDAsMCwwLDAsMCw0LDAsMCwwLDAsMCwwLDAsMCwxMjgsMjYsMCwwLDAsMCwwLDAsMCwwLDAsMCwwLDAsMCwwLDAsMCwwLDAsMCwwLDAsMCwwLDAsMCwwLDAsMCwwLDAsMCwwLDAsMCwwLDAsMCwwLDAsMCwwLDAsMCwwLDAsMCwwLDAsMCwwLDAsMCwwXSwibCI6MSwicSI6NiwiciI6N319AAAAAAAAAAAAAAAAAEABAAAAAAAABQAAADEwNS4wAAAALwEAAHsid2FzX2ZpcnN0X2V2ZW50Ijp0cnVlLCJpbWFnZV9pZCI6WzI5NDg2MzA3OTIsMjQ4MjEzNjcxMSwxNTEyNjE4NjkyLDMxOTcwODI0MTgsODIwOTYzODY4LDQ2MzI0MzAwNSwyODE1MTMwMDQ1LDM4MzUzNTQ2NTddLCJxZiI6eyJiIjpbMCw0LDAsMCwwLDAsMCwwLDAsNCwwLDAsMCwwLDAsMCwwLDAsMTI4LDI2LDAsMCwwLDAsMCwwLDAsMCwwLDAsMCwwLDAsMCwwLDAsMCwwLDAsMCwwLDAsMCwwLDAsMCwwLDAsMCwwLDAsMCwwLDAsMCwwLDAsMCwwLDAsMCwwLDAsMCwwLDAsMCwwLDAsMCwwLDAsMF0sImwiOjEsInEiOjYsInIiOjd9fQAAAAAAAAAAAAAAAAAAAAAAAAAAAAAAAAAAAAAAAAAAAA=='}}
prove_84;90;74;Mul;6660;211449;6660.0;841;0.06762829099898227;{'verificationValue': 6660.0, 'proof': {'imageId': [2948630792, 2482136711, 1512618692, 3197082418, 820963868, 463243005, 2815130045, 3835354657], 'receipt': 'AwAAAAAAAAAAAAAAxAciAPPsD8genbvcCN2DvDmorNgPyU2p6hAM/h+8IU0pSDuhAAAAAAAAAAAAAAAAAAAAAAAAAAAAAAAAAAAAAAAAAAAAAAAAAAAAAAAAAAAAAAAAAQAAAAAAAAAAAAAAAAAAAAAAAAAAAAAAAAAAAAAAAAAAAAAAAAAAAAEAAAAAQAEAAAAAAAAGAAAANjY2MC4wAAAvAQAAeyJ3YXNfZmlyc3RfZXZlbnQiOnRydWUsImltYWdlX2lkIjpbMjk0ODYzMDc5MiwyNDgyMTM2NzExLDE1MTI2MTg2OTIsMzE5NzA4MjQxOCw4MjA5NjM4NjgsNDYzMjQzMDA1LDI4MTUxMzAwNDUsMzgzNTM1NDY1N10sInFmIjp7ImIiOlswLDQsMCwwLDAsMCwwLDAsMCw0LDAsMCwwLDAsMCwwLDAsMCwxMjgsMjYsMCwwLDAsMCwwLDAsMCwwLDAsMCwwLDAsMCwwLDAsMCwwLDAsMCwwLDAsMCwwLDAsMCwwLDAsMCwwLDAsMCwwLDAsMCwwLDAsMCwwLDAsMCwwLDAsMCwwLDAsMCwwLDAsMCwwLDAsMCwwXSwibCI6MSwicSI6NiwiciI6N319AAAAAAAAAAAAAAAAAEABAAAAAAAABgAAADY2NjAuMAAALwEAAHsid2FzX2ZpcnN0X2V2ZW50Ijp0cnVlLCJpbWFnZV9pZCI6WzI5NDg2MzA3OTIsMjQ4MjEzNjcxMSwxNTEyNjE4NjkyLDMxOTcwODI0MTgsODIwOTYzODY4LDQ2MzI0MzAwNSwyODE1MTMwMDQ1LDM4MzUzNTQ2NTddLCJxZiI6eyJiIjpbMCw0LDAsMCwwLDAsMCwwLDAsNCwwLDAsMCwwLDAsMCwwLDAsMTI4LDI2LDAsMCwwLDAsMCwwLDAsMCwwLDAsMCwwLDAsMCwwLDAsMCwwLDAsMCwwLDAsMCwwLDAsMCwwLDAsMCwwLDAsMCwwLDAsMCwwLDAsMCwwLDAsMCwwLDAsMCwwLDAsMCwwLDAsMCwwLDAsMF0sImwiOjEsInEiOjYsInIiOjd9fQAAAAAAAAAAAAAAAAAAAAAAAAAAAAAAAAAAAAAAAAAAAA=='}}
prove_85;29;27;Mul;783;212232;783.0;841;0.06888879200050724;{'verificationValue': 783.0, 'proof': {'imageId': [2948630792, 2482136711, 1512618692, 3197082418, 820963868, 463243005, 2815130045, 3835354657], 'receipt': 'AwAAAAAAAAAAAAAAxAciAPPsD8genbvcCN2DvDmorNgPyU2p6hAM/h+8IU0pSDuhAAAAAAAAAAAAAAAAAAAAAAAAAAAAAAAAAAAAAAAAAAAAAAAAAAAAAAAAAAAAAAAAAQAAAAAAAAAAAAAAAAAAAAAAAAAAAAAAAAAAAAAAAAAAAAAAAAAAAAEAAAAAQAEAAAAAAAAFAAAANzgzLjAAAAAvAQAAeyJ3YXNfZmlyc3RfZXZlbnQiOnRydWUsImltYWdlX2lkIjpbMjk0ODYzMDc5MiwyNDgyMTM2NzExLDE1MTI2MTg2OTIsMzE5NzA4MjQxOCw4MjA5NjM4NjgsNDYzMjQzMDA1LDI4MTUxMzAwNDUsMzgzNTM1NDY1N10sInFmIjp7ImIiOlswLDQsMCwwLDAsMCwwLDAsMCw0LDAsMCwwLDAsMCwwLDAsMCwxMjgsMjYsMCwwLDAsMCwwLDAsMCwwLDAsMCwwLDAsMCwwLDAsMCwwLDAsMCwwLDAsMCwwLDAsMCwwLDAsMCwwLDAsMCwwLDAsMCwwLDAsMCwwLDAsMCwwLDAsMCwwLDAsMCwwLDAsMCwwLDAsMCwwXSwibCI6MSwicSI6NiwiciI6N319AAAAAAAAAAAAAAAAAEABAAAAAAAABQAAADc4My4wAAAALwEAAHsid2FzX2ZpcnN0X2V2ZW50Ijp0cnVlLCJpbWFnZV9pZCI6WzI5NDg2MzA3OTIsMjQ4MjEzNjcxMSwxNTEyNjE4NjkyLDMxOTcwODI0MTgsODIwOTYzODY4LDQ2MzI0MzAwNSwyODE1MTMwMDQ1LDM4MzUzNTQ2NTddLCJxZiI6eyJiIjpbMCw0LDAsMCwwLDAsMCwwLDAsNCwwLDAsMCwwLDAsMCwwLDAsMTI4LDI2LDAsMCwwLDAsMCwwLDAsMCwwLDAsMCwwLDAsMCwwLDAsMCwwLDAsMCwwLDAsMCwwLDAsMCwwLDAsMCwwLDAsMCwwLDAsMCwwLDAsMCwwLDAsMCwwLDAsMCwwLDAsMCwwLDAsMCwwLDAsMF0sImwiOjEsInEiOjYsInIiOjd9fQAAAAAAAAAAAAAAAAAAAAAAAAAAAAAAAAAAAAAAAAAAAA=='}}
prove_86;25;49;Mul;1225;213457;1225.0;841;0.0673870420014282;{'verificationValue': 1225.0, 'proof': {'imageId': [2948630792, 2482136711, 1512618692, 3197082418, 820963868, 463243005, 2815130045, 3835354657], 'receipt': 'AwAAAAAAAAAAAAAAxAciAPPsD8genbvcCN2DvDmorNgPyU2p6hAM/h+8IU0pSDuhAAAAAAAAAAAAAAAAAAAAAAAAAAAAAAAAAAAAAAAAAAAAAAAAAAAAAAAAAAAAAAAAAQAAAAAAAAAAAAAAAAAAAAAAAAAAAAAAAAAAAAAAAAAAAAAAAAAAAAEAAAAAQAEAAAAAAAAGAAAAMTIyNS4wAAAvAQAAeyJ3YXNfZmlyc3RfZXZlbnQiOnRydWUsImltYWdlX2lkIjpbMjk0ODYzMDc5MiwyNDgyMTM2NzExLDE1MTI2MTg2OTIsMzE5NzA4MjQxOCw4MjA5NjM4NjgsNDYzMjQzMDA1LDI4MTUxMzAwNDUsMzgzNTM1NDY1N10sInFmIjp7ImIiOlswLDQsMCwwLDAsMCwwLDAsMCw0LDAsMCwwLDAsMCwwLDAsMCwxMjgsMjYsMCwwLDAsMCwwLDAsMCwwLDAsMCwwLDAsMCwwLDAsMCwwLDAsMCwwLDAsMCwwLDAsMCwwLDAsMCwwLDAsMCwwLDAsMCwwLDAsMCwwLDAsMCwwLDAsMCwwLDAsMCwwLDAsMCwwLDAsMCwwXSwibCI6MSwicSI6NiwiciI6N319AAAAAAAAAAAAAAAAAEABAAAAAAAABgAAADEyMjUuMAAALwEAAHsid2FzX2ZpcnN0X2V2ZW50Ijp0cnVlLCJpbWFnZV9pZCI6WzI5NDg2MzA3OTIsMjQ4MjEzNjcxMSwxNTEyNjE4NjkyLDMxOTcwODI0MTgsODIwOTYzODY4LDQ2MzI0MzAwNSwyODE1MTMwMDQ1LDM4MzUzNTQ2NTddLCJxZiI6eyJiIjpbMCw0LDAsMCwwLDAsMCwwLDAsNCwwLDAsMCwwLDAsMCwwLDAsMTI4LDI2LDAsMCwwLDAsMCwwLDAsMCwwLDAsMCwwLDAsMCwwLDAsMCwwLDAsMCwwLDAsMCwwLDAsMCwwLDAsMCwwLDAsMCwwLDAsMCwwLDAsMCwwLDAsMCwwLDAsMCwwLDAsMCwwLDAsMCwwLDAsMF0sImwiOjEsInEiOjYsInIiOjd9fQAAAAAAAAAAAAAAAAAAAAAAAAAAAAAAAAAAAAAAAAAAAA=='}}
prove_87;67;67;Mul;4489;217946;4489.0;841;0.06811808299971744;{'verificationValue': 4489.0, 'proof': {'imageId': [2948630792, 2482136711, 1512618692, 3197082418, 820963868, 463243005, 2815130045, 3835354657], 'receipt': 'AwAAAAAAAAAAAAAAxAciAPPsD8genbvcCN2DvDmorNgPyU2p6hAM/h+8IU0pSDuhAAAAAAAAAAAAAAAAAAAAAAAAAAAAAAAAAAAAAAAAAAAAAAAAAAAAAAAAAAAAAAAAAQAAAAAAAAAAAAAAAAAAAAAAAAAAAAAAAAAAAAAAAAAAAAAAAAAAAAEAAAAAQAEAAAAAAAAGAAAANDQ4OS4wAAAvAQAAeyJ3YXNfZmlyc3RfZXZlbnQiOnRydWUsImltYWdlX2lkIjpbMjk0ODYzMDc5MiwyNDgyMTM2NzExLDE1MTI2MTg2OTIsMzE5NzA4MjQxOCw4MjA5NjM4NjgsNDYzMjQzMDA1LDI4MTUxMzAwNDUsMzgzNTM1NDY1N10sInFmIjp7ImIiOlswLDQsMCwwLDAsMCwwLDAsMCw0LDAsMCwwLDAsMCwwLDAsMCwxMjgsMjYsMCwwLDAsMCwwLDAsMCwwLDAsMCwwLDAsMCwwLDAsMCwwLDAsMCwwLDAsMCwwLDAsMCwwLDAsMCwwLDAsMCwwLDAsMCwwLDAsMCwwLDAsMCwwLDAsMCwwLDAsMCwwLDAsMCwwLDAsMCwwXSwibCI6MSwicSI6NiwiciI6N319AAAAAAAAAAAAAAAAAEABAAAAAAAABgAAADQ0ODkuMAAALwEAAHsid2FzX2ZpcnN0X2V2ZW50Ijp0cnVlLCJpbWFnZV9pZCI6WzI5NDg2MzA3OTIsMjQ4MjEzNjcxMSwxNTEyNjE4NjkyLDMxOTcwODI0MTgsODIwOTYzODY4LDQ2MzI0MzAwNSwyODE1MTMwMDQ1LDM4MzUzNTQ2NTddLCJxZiI6eyJiIjpbMCw0LDAsMCwwLDAsMCwwLDAsNCwwLDAsMCwwLDAsMCwwLDAsMTI4LDI2LDAsMCwwLDAsMCwwLDAsMCwwLDAsMCwwLDAsMCwwLDAsMCwwLDAsMCwwLDAsMCwwLDAsMCwwLDAsMCwwLDAsMCwwLDAsMCwwLDAsMCwwLDAsMCwwLDAsMCwwLDAsMCwwLDAsMCwwLDAsMF0sImwiOjEsInEiOjYsInIiOjd9fQAAAAAAAAAAAAAAAAAAAAAAAAAAAAAAAAAAAAAAAAAAAA=='}}
prove_88;38;38;Mul;1444;219390;1444.0;841;0.0674499159995321;{'verificationValue': 1444.0, 'proof': {'imageId': [2948630792, 2482136711, 1512618692, 3197082418, 820963868, 463243005, 2815130045, 3835354657], 'receipt': 'AwAAAAAAAAAAAAAAxAciAPPsD8genbvcCN2DvDmorNgPyU2p6hAM/h+8IU0pSDuhAAAAAAAAAAAAAAAAAAAAAAAAAAAAAAAAAAAAAAAAAAAAAAAAAAAAAAAAAAAAAAAAAQAAAAAAAAAAAAAAAAAAAAAAAAAAAAAAAAAAAAAAAAAAAAAAAAAAAAEAAAAAQAEAAAAAAAAGAAAAMTQ0NC4wAAAvAQAAeyJ3YXNfZmlyc3RfZXZlbnQiOnRydWUsImltYWdlX2lkIjpbMjk0ODYzMDc5MiwyNDgyMTM2NzExLDE1MTI2MTg2OTIsMzE5NzA4MjQxOCw4MjA5NjM4NjgsNDYzMjQzMDA1LDI4MTUxMzAwNDUsMzgzNTM1NDY1N10sInFmIjp7ImIiOlswLDQsMCwwLDAsMCwwLDAsMCw0LDAsMCwwLDAsMCwwLDAsMCwxMjgsMjYsMCwwLDAsMCwwLDAsMCwwLDAsMCwwLDAsMCwwLDAsMCwwLDAsMCwwLDAsMCwwLDAsMCwwLDAsMCwwLDAsMCwwLDAsMCwwLDAsMCwwLDAsMCwwLDAsMCwwLDAsMCwwLDAsMCwwLDAsMCwwXSwibCI6MSwicSI6NiwiciI6N319AAAAAAAAAAAAAAAAAEABAAAAAAAABgAAADE0NDQuMAAALwEAAHsid2FzX2ZpcnN0X2V2ZW50Ijp0cnVlLCJpbWFnZV9pZCI6WzI5NDg2MzA3OTIsMjQ4MjEzNjcxMSwxNTEyNjE4NjkyLDMxOTcwODI0MTgsODIwOTYzODY4LDQ2MzI0MzAwNSwyODE1MTMwMDQ1LDM4MzUzNTQ2NTddLCJxZiI6eyJiIjpbMCw0LDAsMCwwLDAsMCwwLDAsNCwwLDAsMCwwLDAsMCwwLDAsMTI4LDI2LDAsMCwwLDAsMCwwLDAsMCwwLDAsMCwwLDAsMCwwLDAsMCwwLDAsMCwwLDAsMCwwLDAsMCwwLDAsMCwwLDAsMCwwLDAsMCwwLDAsMCwwLDAsMCwwLDAsMCwwLDAsMCwwLDAsMCwwLDAsMF0sImwiOjEsInEiOjYsInIiOjd9fQAAAAAAAAAAAAAAAAAAAAAAAAAAAAAAAAAAAAAAAAAAAA=='}}
prove_89;62;20;Mul;1240;220630;1240.0;841;0.0682722500005184;{'verificationValue': 1240.0, 'proof': {'imageId': [2948630792, 2482136711, 1512618692, 3197082418, 820963868, 463243005, 2815130045, 3835354657], 'receipt': 'AwAAAAAAAAAAAAAAxAciAPPsD8genbvcCN2DvDmorNgPyU2p6hAM/h+8IU0pSDuhAAAAAAAAAAAAAAAAAAAAAAAAAAAAAAAAAAAAAAAAAAAAAAAAAAAAAAAAAAAAAAAAAQAAAAAAAAAAAAAAAAAAAAAAAAAAAAAAAAAAAAAAAAAAAAAAAAAAAAEAAAAAQAEAAAAAAAAGAAAAMTI0MC4wAAAvAQAAeyJ3YXNfZmlyc3RfZXZlbnQiOnRydWUsImltYWdlX2lkIjpbMjk0ODYzMDc5MiwyNDgyMTM2NzExLDE1MTI2MTg2OTIsMzE5NzA4MjQxOCw4MjA5NjM4NjgsNDYzMjQzMDA1LDI4MTUxMzAwNDUsMzgzNTM1NDY1N10sInFmIjp7ImIiOlswLDQsMCwwLDAsMCwwLDAsMCw0LDAsMCwwLDAsMCwwLDAsMCwxMjgsMjYsMCwwLDAsMCwwLDAsMCwwLDAsMCwwLDAsMCwwLDAsMCwwLDAsMCwwLDAsMCwwLDAsMCwwLDAsMCwwLDAsMCwwLDAsMCwwLDAsMCwwLDAsMCwwLDAsMCwwLDAsMCwwLDAsMCwwLDAsMCwwXSwibCI6MSwicSI6NiwiciI6N319AAAAAAAAAAAAAAAAAEABAAAAAAAABgAAADEyNDAuMAAALwEAAHsid2FzX2ZpcnN0X2V2ZW50Ijp0cnVlLCJpbWFnZV9pZCI6WzI5NDg2MzA3OTIsMjQ4MjEzNjcxMSwxNTEyNjE4NjkyLDMxOTcwODI0MTgsODIwOTYzODY4LDQ2MzI0MzAwNSwyODE1MTMwMDQ1LDM4MzUzNTQ2NTddLCJxZiI6eyJiIjpbMCw0LDAsMCwwLDAsMCwwLDAsNCwwLDAsMCwwLDAsMCwwLDAsMTI4LDI2LDAsMCwwLDAsMCwwLDAsMCwwLDAsMCwwLDAsMCwwLDAsMCwwLDAsMCwwLDAsMCwwLDAsMCwwLDAsMCwwLDAsMCwwLDAsMCwwLDAsMCwwLDAsMCwwLDAsMCwwLDAsMCwwLDAsMCwwLDAsMF0sImwiOjEsInEiOjYsInIiOjd9fQAAAAAAAAAAAAAAAAAAAAAAAAAAAAAAAAAAAAAAAAAAAA=='}}
prove_90;44;77;Mul;3388;224018;3388.0;841;0.06862266700045438;{'verificationValue': 3388.0, 'proof': {'imageId': [2948630792, 2482136711, 1512618692, 3197082418, 820963868, 463243005, 2815130045, 3835354657], 'receipt': 'AwAAAAAAAAAAAAAAxAciAPPsD8genbvcCN2DvDmorNgPyU2p6hAM/h+8IU0pSDuhAAAAAAAAAAAAAAAAAAAAAAAAAAAAAAAAAAAAAAAAAAAAAAAAAAAAAAAAAAAAAAAAAQAAAAAAAAAAAAAAAAAAAAAAAAAAAAAAAAAAAAAAAAAAAAAAAAAAAAEAAAAAQAEAAAAAAAAGAAAAMzM4OC4wAAAvAQAAeyJ3YXNfZmlyc3RfZXZlbnQiOnRydWUsImltYWdlX2lkIjpbMjk0ODYzMDc5MiwyNDgyMTM2NzExLDE1MTI2MTg2OTIsMzE5NzA4MjQxOCw4MjA5NjM4NjgsNDYzMjQzMDA1LDI4MTUxMzAwNDUsMzgzNTM1NDY1N10sInFmIjp7ImIiOlswLDQsMCwwLDAsMCwwLDAsMCw0LDAsMCwwLDAsMCwwLDAsMCwxMjgsMjYsMCwwLDAsMCwwLDAsMCwwLDAsMCwwLDAsMCwwLDAsMCwwLDAsMCwwLDAsMCwwLDAsMCwwLDAsMCwwLDAsMCwwLDAsMCwwLDAsMCwwLDAsMCwwLDAsMCwwLDAsMCwwLDAsMCwwLDAsMCwwXSwibCI6MSwicSI6NiwiciI6N319AAAAAAAAAAAAAAAAAEABAAAAAAAABgAAADMzODguMAAALwEAAHsid2FzX2ZpcnN0X2V2ZW50Ijp0cnVlLCJpbWFnZV9pZCI6WzI5NDg2MzA3OTIsMjQ4MjEzNjcxMSwxNTEyNjE4NjkyLDMxOTcwODI0MTgsODIwOTYzODY4LDQ2MzI0MzAwNSwyODE1MTMwMDQ1LDM4MzUzNTQ2NTddLCJxZiI6eyJiIjpbMCw0LDAsMCwwLDAsMCwwLDAsNCwwLDAsMCwwLDAsMCwwLDAsMTI4LDI2LDAsMCwwLDAsMCwwLDAsMCwwLDAsMCwwLDAsMCwwLDAsMCwwLDAsMCwwLDAsMCwwLDAsMCwwLDAsMCwwLDAsMCwwLDAsMCwwLDAsMCwwLDAsMCwwLDAsMCwwLDAsMCwwLDAsMCwwLDAsMF0sImwiOjEsInEiOjYsInIiOjd9fQAAAAAAAAAAAAAAAAAAAAAAAAAAAAAAAAAAAAAAAAAAAA=='}}
prove_91;88;89;Mul;7832;231850;7832.0;841;0.06887595799889823;{'verificationValue': 7832.0, 'proof': {'imageId': [2948630792, 2482136711, 1512618692, 3197082418, 820963868, 463243005, 2815130045, 3835354657], 'receipt': 'AwAAAAAAAAAAAAAAxAciAPPsD8genbvcCN2DvDmorNgPyU2p6hAM/h+8IU0pSDuhAAAAAAAAAAAAAAAAAAAAAAAAAAAAAAAAAAAAAAAAAAAAAAAAAAAAAAAAAAAAAAAAAQAAAAAAAAAAAAAAAAAAAAAAAAAAAAAAAAAAAAAAAAAAAAAAAAAAAAEAAAAAQAEAAAAAAAAGAAAANzgzMi4wAAAvAQAAeyJ3YXNfZmlyc3RfZXZlbnQiOnRydWUsImltYWdlX2lkIjpbMjk0ODYzMDc5MiwyNDgyMTM2NzExLDE1MTI2MTg2OTIsMzE5NzA4MjQxOCw4MjA5NjM4NjgsNDYzMjQzMDA1LDI4MTUxMzAwNDUsMzgzNTM1NDY1N10sInFmIjp7ImIiOlswLDQsMCwwLDAsMCwwLDAsMCw0LDAsMCwwLDAsMCwwLDAsMCwxMjgsMjYsMCwwLDAsMCwwLDAsMCwwLDAsMCwwLDAsMCwwLDAsMCwwLDAsMCwwLDAsMCwwLDAsMCwwLDAsMCwwLDAsMCwwLDAsMCwwLDAsMCwwLDAsMCwwLDAsMCwwLDAsMCwwLDAsMCwwLDAsMCwwXSwibCI6MSwicSI6NiwiciI6N319AAAAAAAAAAAAAAAAAEABAAAAAAAABgAAADc4MzIuMAAALwEAAHsid2FzX2ZpcnN0X2V2ZW50Ijp0cnVlLCJpbWFnZV9pZCI6WzI5NDg2MzA3OTIsMjQ4MjEzNjcxMSwxNTEyNjE4NjkyLDMxOTcwODI0MTgsODIwOTYzODY4LDQ2MzI0MzAwNSwyODE1MTMwMDQ1LDM4MzUzNTQ2NTddLCJxZiI6eyJiIjpbMCw0LDAsMCwwLDAsMCwwLDAsNCwwLDAsMCwwLDAsMCwwLDAsMTI4LDI2LDAsMCwwLDAsMCwwLDAsMCwwLDAsMCwwLDAsMCwwLDAsMCwwLDAsMCwwLDAsMCwwLDAsMCwwLDAsMCwwLDAsMCwwLDAsMCwwLDAsMCwwLDAsMCwwLDAsMCwwLDAsMCwwLDAsMCwwLDAsMF0sImwiOjEsInEiOjYsInIiOjd9fQAAAAAAAAAAAAAAAAAAAAAAAAAAAAAAAAAAAAAAAAAAAA=='}}
prove_92;68;74;Mul;5032;236882;5032.0;841;0.0681075000011333;{'verificationValue': 5032.0, 'proof': {'imageId': [2948630792, 2482136711, 1512618692, 3197082418, 820963868, 463243005, 2815130045, 3835354657], 'receipt': 'AwAAAAAAAAAAAAAAxAciAPPsD8genbvcCN2DvDmorNgPyU2p6hAM/h+8IU0pSDuhAAAAAAAAAAAAAAAAAAAAAAAAAAAAAAAAAAAAAAAAAAAAAAAAAAAAAAAAAAAAAAAAAQAAAAAAAAAAAAAAAAAAAAAAAAAAAAAAAAAAAAAAAAAAAAAAAAAAAAEAAAAAQAEAAAAAAAAGAAAANTAzMi4wAAAvAQAAeyJ3YXNfZmlyc3RfZXZlbnQiOnRydWUsImltYWdlX2lkIjpbMjk0ODYzMDc5MiwyNDgyMTM2NzExLDE1MTI2MTg2OTIsMzE5NzA4MjQxOCw4MjA5NjM4NjgsNDYzMjQzMDA1LDI4MTUxMzAwNDUsMzgzNTM1NDY1N10sInFmIjp7ImIiOlswLDQsMCwwLDAsMCwwLDAsMCw0LDAsMCwwLDAsMCwwLDAsMCwxMjgsMjYsMCwwLDAsMCwwLDAsMCwwLDAsMCwwLDAsMCwwLDAsMCwwLDAsMCwwLDAsMCwwLDAsMCwwLDAsMCwwLDAsMCwwLDAsMCwwLDAsMCwwLDAsMCwwLDAsMCwwLDAsMCwwLDAsMCwwLDAsMCwwXSwibCI6MSwicSI6NiwiciI6N319AAAAAAAAAAAAAAAAAEABAAAAAAAABgAAADUwMzIuMAAALwEAAHsid2FzX2ZpcnN0X2V2ZW50Ijp0cnVlLCJpbWFnZV9pZCI6WzI5NDg2MzA3OTIsMjQ4MjEzNjcxMSwxNTEyNjE4NjkyLDMxOTcwODI0MTgsODIwOTYzODY4LDQ2MzI0MzAwNSwyODE1MTMwMDQ1LDM4MzUzNTQ2NTddLCJxZiI6eyJiIjpbMCw0LDAsMCwwLDAsMCwwLDAsNCwwLDAsMCwwLDAsMCwwLDAsMTI4LDI2LDAsMCwwLDAsMCwwLDAsMCwwLDAsMCwwLDAsMCwwLDAsMCwwLDAsMCwwLDAsMCwwLDAsMCwwLDAsMCwwLDAsMCwwLDAsMCwwLDAsMCwwLDAsMCwwLDAsMCwwLDAsMCwwLDAsMCwwLDAsMF0sImwiOjEsInEiOjYsInIiOjd9fQAAAAAAAAAAAAAAAAAAAAAAAAAAAAAAAAAAAAAAAAAAAA=='}}
prove_93;96;33;Mul;3168;240050;3168.0;841;0.06849650000003749;{'verificationValue': 3168.0, 'proof': {'imageId': [2948630792, 2482136711, 1512618692, 3197082418, 820963868, 463243005, 2815130045, 3835354657], 'receipt': 'AwAAAAAAAAAAAAAAxAciAPPsD8genbvcCN2DvDmorNgPyU2p6hAM/h+8IU0pSDuhAAAAAAAAAAAAAAAAAAAAAAAAAAAAAAAAAAAAAAAAAAAAAAAAAAAAAAAAAAAAAAAAAQAAAAAAAAAAAAAAAAAAAAAAAAAAAAAAAAAAAAAAAAAAAAAAAAAAAAEAAAAAQAEAAAAAAAAGAAAAMzE2OC4wAAAvAQAAeyJ3YXNfZmlyc3RfZXZlbnQiOnRydWUsImltYWdlX2lkIjpbMjk0ODYzMDc5MiwyNDgyMTM2NzExLDE1MTI2MTg2OTIsMzE5NzA4MjQxOCw4MjA5NjM4NjgsNDYzMjQzMDA1LDI4MTUxMzAwNDUsMzgzNTM1NDY1N10sInFmIjp7ImIiOlswLDQsMCwwLDAsMCwwLDAsMCw0LDAsMCwwLDAsMCwwLDAsMCwxMjgsMjYsMCwwLDAsMCwwLDAsMCwwLDAsMCwwLDAsMCwwLDAsMCwwLDAsMCwwLDAsMCwwLDAsMCwwLDAsMCwwLDAsMCwwLDAsMCwwLDAsMCwwLDAsMCwwLDAsMCwwLDAsMCwwLDAsMCwwLDAsMCwwXSwibCI6MSwicSI6NiwiciI6N319AAAAAAAAAAAAAAAAAEABAAAAAAAABgAAADMxNjguMAAALwEAAHsid2FzX2ZpcnN0X2V2ZW50Ijp0cnVlLCJpbWFnZV9pZCI6WzI5NDg2MzA3OTIsMjQ4MjEzNjcxMSwxNTEyNjE4NjkyLDMxOTcwODI0MTgsODIwOTYzODY4LDQ2MzI0MzAwNSwyODE1MTMwMDQ1LDM4MzUzNTQ2NTddLCJxZiI6eyJiIjpbMCw0LDAsMCwwLDAsMCwwLDAsNCwwLDAsMCwwLDAsMCwwLDAsMTI4LDI2LDAsMCwwLDAsMCwwLDAsMCwwLDAsMCwwLDAsMCwwLDAsMCwwLDAsMCwwLDAsMCwwLDAsMCwwLDAsMCwwLDAsMCwwLDAsMCwwLDAsMCwwLDAsMCwwLDAsMCwwLDAsMCwwLDAsMCwwLDAsMF0sImwiOjEsInEiOjYsInIiOjd9fQAAAAAAAAAAAAAAAAAAAAAAAAAAAAAAAAAAAAAAAAAAAA=='}}
prove_94;72;12;Mul;864;240914;864.0;841;0.06785629200021503;{'verificationValue': 864.0, 'proof': {'imageId': [2948630792, 2482136711, 1512618692, 3197082418, 820963868, 463243005, 2815130045, 3835354657], 'receipt': 'AwAAAAAAAAAAAAAAxAciAPPsD8genbvcCN2DvDmorNgPyU2p6hAM/h+8IU0pSDuhAAAAAAAAAAAAAAAAAAAAAAAAAAAAAAAAAAAAAAAAAAAAAAAAAAAAAAAAAAAAAAAAAQAAAAAAAAAAAAAAAAAAAAAAAAAAAAAAAAAAAAAAAAAAAAAAAAAAAAEAAAAAQAEAAAAAAAAFAAAAODY0LjAAAAAvAQAAeyJ3YXNfZmlyc3RfZXZlbnQiOnRydWUsImltYWdlX2lkIjpbMjk0ODYzMDc5MiwyNDgyMTM2NzExLDE1MTI2MTg2OTIsMzE5NzA4MjQxOCw4MjA5NjM4NjgsNDYzMjQzMDA1LDI4MTUxMzAwNDUsMzgzNTM1NDY1N10sInFmIjp7ImIiOlswLDQsMCwwLDAsMCwwLDAsMCw0LDAsMCwwLDAsMCwwLDAsMCwxMjgsMjYsMCwwLDAsMCwwLDAsMCwwLDAsMCwwLDAsMCwwLDAsMCwwLDAsMCwwLDAsMCwwLDAsMCwwLDAsMCwwLDAsMCwwLDAsMCwwLDAsMCwwLDAsMCwwLDAsMCwwLDAsMCwwLDAsMCwwLDAsMCwwXSwibCI6MSwicSI6NiwiciI6N319AAAAAAAAAAAAAAAAAEABAAAAAAAABQAAADg2NC4wAAAALwEAAHsid2FzX2ZpcnN0X2V2ZW50Ijp0cnVlLCJpbWFnZV9pZCI6WzI5NDg2MzA3OTIsMjQ4MjEzNjcxMSwxNTEyNjE4NjkyLDMxOTcwODI0MTgsODIwOTYzODY4LDQ2MzI0MzAwNSwyODE1MTMwMDQ1LDM4MzUzNTQ2NTddLCJxZiI6eyJiIjpbMCw0LDAsMCwwLDAsMCwwLDAsNCwwLDAsMCwwLDAsMCwwLDAsMTI4LDI2LDAsMCwwLDAsMCwwLDAsMCwwLDAsMCwwLDAsMCwwLDAsMCwwLDAsMCwwLDAsMCwwLDAsMCwwLDAsMCwwLDAsMCwwLDAsMCwwLDAsMCwwLDAsMCwwLDAsMCwwLDAsMCwwLDAsMCwwLDAsMF0sImwiOjEsInEiOjYsInIiOjd9fQAAAAAAAAAAAAAAAAAAAAAAAAAAAAAAAAAAAAAAAAAAAA=='}}
prove_95;56;83;Mul;4648;245562;4648.0;841;0.06806841700017685;{'verificationValue': 4648.0, 'proof': {'imageId': [2948630792, 2482136711, 1512618692, 3197082418, 820963868, 463243005, 2815130045, 3835354657], 'receipt': 'AwAAAAAAAAAAAAAAxAciAPPsD8genbvcCN2DvDmorNgPyU2p6hAM/h+8IU0pSDuhAAAAAAAAAAAAAAAAAAAAAAAAAAAAAAAAAAAAAAAAAAAAAAAAAAAAAAAAAAAAAAAAAQAAAAAAAAAAAAAAAAAAAAAAAAAAAAAAAAAAAAAAAAAAAAAAAAAAAAEAAAAAQAEAAAAAAAAGAAAANDY0OC4wAAAvAQAAeyJ3YXNfZmlyc3RfZXZlbnQiOnRydWUsImltYWdlX2lkIjpbMjk0ODYzMDc5MiwyNDgyMTM2NzExLDE1MTI2MTg2OTIsMzE5NzA4MjQxOCw4MjA5NjM4NjgsNDYzMjQzMDA1LDI4MTUxMzAwNDUsMzgzNTM1NDY1N10sInFmIjp7ImIiOlswLDQsMCwwLDAsMCwwLDAsMCw0LDAsMCwwLDAsMCwwLDAsMCwxMjgsMjYsMCwwLDAsMCwwLDAsMCwwLDAsMCwwLDAsMCwwLDAsMCwwLDAsMCwwLDAsMCwwLDAsMCwwLDAsMCwwLDAsMCwwLDAsMCwwLDAsMCwwLDAsMCwwLDAsMCwwLDAsMCwwLDAsMCwwLDAsMCwwXSwibCI6MSwicSI6NiwiciI6N319AAAAAAAAAAAAAAAAAEABAAAAAAAABgAAADQ2NDguMAAALwEAAHsid2FzX2ZpcnN0X2V2ZW50Ijp0cnVlLCJpbWFnZV9pZCI6WzI5NDg2MzA3OTIsMjQ4MjEzNjcxMSwxNTEyNjE4NjkyLDMxOTcwODI0MTgsODIwOTYzODY4LDQ2MzI0MzAwNSwyODE1MTMwMDQ1LDM4MzUzNTQ2NTddLCJxZiI6eyJiIjpbMCw0LDAsMCwwLDAsMCwwLDAsNCwwLDAsMCwwLDAsMCwwLDAsMTI4LDI2LDAsMCwwLDAsMCwwLDAsMCwwLDAsMCwwLDAsMCwwLDAsMCwwLDAsMCwwLDAsMCwwLDAsMCwwLDAsMCwwLDAsMCwwLDAsMCwwLDAsMCwwLDAsMCwwLDAsMCwwLDAsMCwwLDAsMCwwLDAsMF0sImwiOjEsInEiOjYsInIiOjd9fQAAAAAAAAAAAAAAAAAAAAAAAAAAAAAAAAAAAAAAAAAAAA=='}}
prove_96;60;76;Mul;4560;250122;4560.0;841;0.0694190840004012;{'verificationValue': 4560.0, 'proof': {'imageId': [2948630792, 2482136711, 1512618692, 3197082418, 820963868, 463243005, 2815130045, 3835354657], 'receipt': 'AwAAAAAAAAAAAAAAxAciAPPsD8genbvcCN2DvDmorNgPyU2p6hAM/h+8IU0pSDuhAAAAAAAAAAAAAAAAAAAAAAAAAAAAAAAAAAAAAAAAAAAAAAAAAAAAAAAAAAAAAAAAAQAAAAAAAAAAAAAAAAAAAAAAAAAAAAAAAAAAAAAAAAAAAAAAAAAAAAEAAAAAQAEAAAAAAAAGAAAANDU2MC4wAAAvAQAAeyJ3YXNfZmlyc3RfZXZlbnQiOnRydWUsImltYWdlX2lkIjpbMjk0ODYzMDc5MiwyNDgyMTM2NzExLDE1MTI2MTg2OTIsMzE5NzA4MjQxOCw4MjA5NjM4NjgsNDYzMjQzMDA1LDI4MTUxMzAwNDUsMzgzNTM1NDY1N10sInFmIjp7ImIiOlswLDQsMCwwLDAsMCwwLDAsMCw0LDAsMCwwLDAsMCwwLDAsMCwxMjgsMjYsMCwwLDAsMCwwLDAsMCwwLDAsMCwwLDAsMCwwLDAsMCwwLDAsMCwwLDAsMCwwLDAsMCwwLDAsMCwwLDAsMCwwLDAsMCwwLDAsMCwwLDAsMCwwLDAsMCwwLDAsMCwwLDAsMCwwLDAsMCwwXSwibCI6MSwicSI6NiwiciI6N319AAAAAAAAAAAAAAAAAEABAAAAAAAABgAAADQ1NjAuMAAALwEAAHsid2FzX2ZpcnN0X2V2ZW50Ijp0cnVlLCJpbWFnZV9pZCI6WzI5NDg2MzA3OTIsMjQ4MjEzNjcxMSwxNTEyNjE4NjkyLDMxOTcwODI0MTgsODIwOTYzODY4LDQ2MzI0MzAwNSwyODE1MTMwMDQ1LDM4MzUzNTQ2NTddLCJxZiI6eyJiIjpbMCw0LDAsMCwwLDAsMCwwLDAsNCwwLDAsMCwwLDAsMCwwLDAsMTI4LDI2LDAsMCwwLDAsMCwwLDAsMCwwLDAsMCwwLDAsMCwwLDAsMCwwLDAsMCwwLDAsMCwwLDAsMCwwLDAsMCwwLDAsMCwwLDAsMCwwLDAsMCwwLDAsMCwwLDAsMCwwLDAsMCwwLDAsMCwwLDAsMF0sImwiOjEsInEiOjYsInIiOjd9fQAAAAAAAAAAAAAAAAAAAAAAAAAAAAAAAAAAAAAAAAAAAA=='}}
prove_97;61;26;Mul;1586;251708;1586.0;841;0.06881841699942015;{'verificationValue': 1586.0, 'proof': {'imageId': [2948630792, 2482136711, 1512618692, 3197082418, 820963868, 463243005, 2815130045, 3835354657], 'receipt': 'AwAAAAAAAAAAAAAAxAciAPPsD8genbvcCN2DvDmorNgPyU2p6hAM/h+8IU0pSDuhAAAAAAAAAAAAAAAAAAAAAAAAAAAAAAAAAAAAAAAAAAAAAAAAAAAAAAAAAAAAAAAAAQAAAAAAAAAAAAAAAAAAAAAAAAAAAAAAAAAAAAAAAAAAAAAAAAAAAAEAAAAAQAEAAAAAAAAGAAAAMTU4Ni4wAAAvAQAAeyJ3YXNfZmlyc3RfZXZlbnQiOnRydWUsImltYWdlX2lkIjpbMjk0ODYzMDc5MiwyNDgyMTM2NzExLDE1MTI2MTg2OTIsMzE5NzA4MjQxOCw4MjA5NjM4NjgsNDYzMjQzMDA1LDI4MTUxMzAwNDUsMzgzNTM1NDY1N10sInFmIjp7ImIiOlswLDQsMCwwLDAsMCwwLDAsMCw0LDAsMCwwLDAsMCwwLDAsMCwxMjgsMjYsMCwwLDAsMCwwLDAsMCwwLDAsMCwwLDAsMCwwLDAsMCwwLDAsMCwwLDAsMCwwLDAsMCwwLDAsMCwwLDAsMCwwLDAsMCwwLDAsMCwwLDAsMCwwLDAsMCwwLDAsMCwwLDAsMCwwLDAsMCwwXSwibCI6MSwicSI6NiwiciI6N319AAAAAAAAAAAAAAAAAEABAAAAAAAABgAAADE1ODYuMAAALwEAAHsid2FzX2ZpcnN0X2V2ZW50Ijp0cnVlLCJpbWFnZV9pZCI6WzI5NDg2MzA3OTIsMjQ4MjEzNjcxMSwxNTEyNjE4NjkyLDMxOTcwODI0MTgsODIwOTYzODY4LDQ2MzI0MzAwNSwyODE1MTMwMDQ1LDM4MzUzNTQ2NTddLCJxZiI6eyJiIjpbMCw0LDAsMCwwLDAsMCwwLDAsNCwwLDAsMCwwLDAsMCwwLDAsMTI4LDI2LDAsMCwwLDAsMCwwLDAsMCwwLDAsMCwwLDAsMCwwLDAsMCwwLDAsMCwwLDAsMCwwLDAsMCwwLDAsMCwwLDAsMCwwLDAsMCwwLDAsMCwwLDAsMCwwLDAsMCwwLDAsMCwwLDAsMCwwLDAsMF0sImwiOjEsInEiOjYsInIiOjd9fQAAAAAAAAAAAAAAAAAAAAAAAAAAAAAAAAAAAAAAAAAAAA=='}}
prove_98;50;72;Mul;3600;255308;3600.0;841;0.06711925000126939;{'verificationValue': 3600.0, 'proof': {'imageId': [2948630792, 2482136711, 1512618692, 3197082418, 820963868, 463243005, 2815130045, 3835354657], 'receipt': 'AwAAAAAAAAAAAAAAxAciAPPsD8genbvcCN2DvDmorNgPyU2p6hAM/h+8IU0pSDuhAAAAAAAAAAAAAAAAAAAAAAAAAAAAAAAAAAAAAAAAAAAAAAAAAAAAAAAAAAAAAAAAAQAAAAAAAAAAAAAAAAAAAAAAAAAAAAAAAAAAAAAAAAAAAAAAAAAAAAEAAAAAQAEAAAAAAAAGAAAAMzYwMC4wAAAvAQAAeyJ3YXNfZmlyc3RfZXZlbnQiOnRydWUsImltYWdlX2lkIjpbMjk0ODYzMDc5MiwyNDgyMTM2NzExLDE1MTI2MTg2OTIsMzE5NzA4MjQxOCw4MjA5NjM4NjgsNDYzMjQzMDA1LDI4MTUxMzAwNDUsMzgzNTM1NDY1N10sInFmIjp7ImIiOlswLDQsMCwwLDAsMCwwLDAsMCw0LDAsMCwwLDAsMCwwLDAsMCwxMjgsMjYsMCwwLDAsMCwwLDAsMCwwLDAsMCwwLDAsMCwwLDAsMCwwLDAsMCwwLDAsMCwwLDAsMCwwLDAsMCwwLDAsMCwwLDAsMCwwLDAsMCwwLDAsMCwwLDAsMCwwLDAsMCwwLDAsMCwwLDAsMCwwXSwibCI6MSwicSI6NiwiciI6N319AAAAAAAAAAAAAAAAAEABAAAAAAAABgAAADM2MDAuMAAALwEAAHsid2FzX2ZpcnN0X2V2ZW50Ijp0cnVlLCJpbWFnZV9pZCI6WzI5NDg2MzA3OTIsMjQ4MjEzNjcxMSwxNTEyNjE4NjkyLDMxOTcwODI0MTgsODIwOTYzODY4LDQ2MzI0MzAwNSwyODE1MTMwMDQ1LDM4MzUzNTQ2NTddLCJxZiI6eyJiIjpbMCw0LDAsMCwwLDAsMCwwLDAsNCwwLDAsMCwwLDAsMCwwLDAsMTI4LDI2LDAsMCwwLDAsMCwwLDAsMCwwLDAsMCwwLDAsMCwwLDAsMCwwLDAsMCwwLDAsMCwwLDAsMCwwLDAsMCwwLDAsMCwwLDAsMCwwLDAsMCwwLDAsMCwwLDAsMCwwLDAsMCwwLDAsMCwwLDAsMF0sImwiOjEsInEiOjYsInIiOjd9fQAAAAAAAAAAAAAAAAAAAAAAAAAAAAAAAAAAAAAAAAAAAA=='}}
prove_99;54;34;Mul;1836;257144;1836.0;841;0.06789779199971235;{'verificationValue': 1836.0, 'proof': {'imageId': [2948630792, 2482136711, 1512618692, 3197082418, 820963868, 463243005, 2815130045, 3835354657], 'receipt': 'AwAAAAAAAAAAAAAAxAciAPPsD8genbvcCN2DvDmorNgPyU2p6hAM/h+8IU0pSDuhAAAAAAAAAAAAAAAAAAAAAAAAAAAAAAAAAAAAAAAAAAAAAAAAAAAAAAAAAAAAAAAAAQAAAAAAAAAAAAAAAAAAAAAAAAAAAAAAAAAAAAAAAAAAAAAAAAAAAAEAAAAAQAEAAAAAAAAGAAAAMTgzNi4wAAAvAQAAeyJ3YXNfZmlyc3RfZXZlbnQiOnRydWUsImltYWdlX2lkIjpbMjk0ODYzMDc5MiwyNDgyMTM2NzExLDE1MTI2MTg2OTIsMzE5NzA4MjQxOCw4MjA5NjM4NjgsNDYzMjQzMDA1LDI4MTUxMzAwNDUsMzgzNTM1NDY1N10sInFmIjp7ImIiOlswLDQsMCwwLDAsMCwwLDAsMCw0LDAsMCwwLDAsMCwwLDAsMCwxMjgsMjYsMCwwLDAsMCwwLDAsMCwwLDAsMCwwLDAsMCwwLDAsMCwwLDAsMCwwLDAsMCwwLDAsMCwwLDAsMCwwLDAsMCwwLDAsMCwwLDAsMCwwLDAsMCwwLDAsMCwwLDAsMCwwLDAsMCwwLDAsMCwwXSwibCI6MSwicSI6NiwiciI6N319AAAAAAAAAAAAAAAAAEABAAAAAAAABgAAADE4MzYuMAAALwEAAHsid2FzX2ZpcnN0X2V2ZW50Ijp0cnVlLCJpbWFnZV9pZCI6WzI5NDg2MzA3OTIsMjQ4MjEzNjcxMSwxNTEyNjE4NjkyLDMxOTcwODI0MTgsODIwOTYzODY4LDQ2MzI0MzAwNSwyODE1MTMwMDQ1LDM4MzUzNTQ2NTddLCJxZiI6eyJiIjpbMCw0LDAsMCwwLDAsMCwwLDAsNCwwLDAsMCwwLDAsMCwwLDAsMTI4LDI2LDAsMCwwLDAsMCwwLDAsMCwwLDAsMCwwLDAsMCwwLDAsMCwwLDAsMCwwLDAsMCwwLDAsMCwwLDAsMCwwLDAsMCwwLDAsMCwwLDAsMCwwLDAsMCwwLDAsMCwwLDAsMCwwLDAsMCwwLDAsMF0sImwiOjEsInEiOjYsInIiOjd9fQAAAAAAAAAAAAAAAAAAAAAAAAAAAAAAAAAAAAAAAAAAAA=='}}
