;a;b;operation;calculated;cumulative;result;proof_size;seconds;response
prove_0;92;2;Mul;184;184;0.0;841;0.0010710839997045696;{'verificationValue': 0.0, 'proof': {'imageId': [1668793289, 846420925, 177576343, 3835873862, 66333553, 2894566030, 598275815, 2718278580], 'receipt': 'AwAAAAAAAAAAAAAAxAciAPPsD8genbvcCN2DvDmorNgPyU2p6hAM/h+8IU0pSDuhAAAAAAAAAAAAAAAAAAAAAAAAAAAAAAAAAAAAAAAAAAAAAAAAAAAAAAAAAAAAAAAAAQAAAAAAAAAAAAAAAAAAAAAAAAAAAAAAAAAAAAAAAAAAAAAAAAAAAAEAAAAAQAEAAAAAAAAFAAAAMTg0LjAAAAAvAQAAeyJ3YXNfZmlyc3RfZXZlbnQiOnRydWUsImltYWdlX2lkIjpbMjk0ODYzMDc5MiwyNDgyMTM2NzExLDE1MTI2MTg2OTIsMzE5NzA4MjQxOCw4MjA5NjM4NjgsNDYzMjQzMDA1LDI4MTUxMzAwNDUsMzgzNTM1NDY1N10sInFmIjp7ImIiOlswLDQsMCwwLDAsMCwwLDAsMCw0LDAsMCwwLDAsMCwwLDAsMCwxMjgsMjYsMCwwLDAsMCwwLDAsMCwwLDAsMCwwLDAsMCwwLDAsMCwwLDAsMCwwLDAsMCwwLDAsMCwwLDAsMCwwLDAsMCwwLDAsMCwwLDAsMCwwLDAsMCwwLDAsMCwwLDAsMCwwLDAsMCwwLDAsMCwwXSwibCI6MSwicSI6NiwiciI6N319AAAAAAAAAAAAAAAAAEABAAAAAAAABQAAADE4NC4wAAAALwEAAHsid2FzX2ZpcnN0X2V2ZW50Ijp0cnVlLCJpbWFnZV9pZCI6WzI5NDg2MzA3OTIsMjQ4MjEzNjcxMSwxNTEyNjE4NjkyLDMxOTcwODI0MTgsODIwOTYzODY4LDQ2MzI0MzAwNSwyODE1MTMwMDQ1LDM4MzUzNTQ2NTddLCJxZiI6eyJiIjpbMCw0LDAsMCwwLDAsMCwwLDAsNCwwLDAsMCwwLDAsMCwwLDAsMTI4LDI2LDAsMCwwLDAsMCwwLDAsMCwwLDAsMCwwLDAsMCwwLDAsMCwwLDAsMCwwLDAsMCwwLDAsMCwwLDAsMCwwLDAsMCwwLDAsMCwwLDAsMCwwLDAsMCwwLDAsMCwwLDAsMCwwLDAsMCwwLDAsMF0sImwiOjEsInEiOjYsInIiOjd9fQAAAAAAAAAAAAAAAAAAAAAAAAAAAAAAAAAAAAAAAAAAAA=='}}
prove_1;8;9;Mul;72;256;0.0;833;0.0734759999995731;{'verificationValue': 0.0, 'proof': {'imageId': [1668793289, 846420925, 177576343, 3835873862, 66333553, 2894566030, 598275815, 2718278580], 'receipt': 'AwAAAAAAAAAAAAAAFPIgAEBa/KxpnrWjLW5ZBdoVsH8Dr4kePkUNGJK+LwGcLUh4AAAAAAAAAAAAAAAAAAAAAAAAAAAAAAAAAAAAAAAAAAAAAAAAAAAAAAAAAAAAAAAAAQAAAAAAAAAAAAAAAAAAAAAAAAAAAAAAAAAAAAAAAAAAAAAAAAAAAAEAAAAAPAEAAAAAAAAFAAAAMjU2LjAAAAAqAQAAeyJ3YXNfZmlyc3RfZXZlbnQiOmZhbHNlLCJpbWFnZV9pZCI6WzE2Njg3OTMyODksODQ2NDIwOTI1LDE3NzU3NjM0MywzODM1ODczODYyLDY2MzMzNTUzLDI4OTQ1NjYwMzAsNTk4Mjc1ODE1LDI3MTgyNzg1ODBdLCJxZiI6eyJiIjpbMCwwLDAsMCwwLDAsMCwwLDAsMCwwLDAsMCwwLDAsMCwwLDAsMCwwLDAsMCwwLDAsMCwwLDAsMCwwLDAsMCwwLDAsMCwwLDAsMCwwLDAsMCwwLDAsMCwwLDAsMCwwLDAsMCwwLDAsMCwwLDAsMCwwLDAsMCwwLDAsMCwwLDAsMCwwLDAsMCwwLDAsMCwwLDAsMF0sImwiOjAsInEiOjYsInIiOjd9fQAAAAAAAAAAAAAAAAAAPAEAAAAAAAAFAAAAMjU2LjAAAAAqAQAAeyJ3YXNfZmlyc3RfZXZlbnQiOmZhbHNlLCJpbWFnZV9pZCI6WzE2Njg3OTMyODksODQ2NDIwOTI1LDE3NzU3NjM0MywzODM1ODczODYyLDY2MzMzNTUzLDI4OTQ1NjYwMzAsNTk4Mjc1ODE1LDI3MTgyNzg1ODBdLCJxZiI6eyJiIjpbMCwwLDAsMCwwLDAsMCwwLDAsMCwwLDAsMCwwLDAsMCwwLDAsMCwwLDAsMCwwLDAsMCwwLDAsMCwwLDAsMCwwLDAsMCwwLDAsMCwwLDAsMCwwLDAsMCwwLDAsMCwwLDAsMCwwLDAsMCwwLDAsMCwwLDAsMCwwLDAsMCwwLDAsMCwwLDAsMCwwLDAsMCwwLDAsMF0sImwiOjAsInEiOjYsInIiOjd9fQAAAAAAAAAAAAAAAAAAAAAAAAAAAAAAAAAAAAAAAAAAAAA='}}
prove_2;68;16;Mul;1088;1344;0.0;833;0.13144300000021758;{'verificationValue': 0.0, 'proof': {'imageId': [1668793289, 846420925, 177576343, 3835873862, 66333553, 2894566030, 598275815, 2718278580], 'receipt': 'AwAAAAAAAAAAAAAAFPIgAEBa/KxpnrWjLW5ZBdoVsH8Dr4kePkUNGJK+LwGcLUh4AAAAAAAAAAAAAAAAAAAAAAAAAAAAAAAAAAAAAAAAAAAAAAAAAAAAAAAAAAAAAAAAAQAAAAAAAAAAAAAAAAAAAAAAAAAAAAAAAAAAAAAAAAAAAAAAAAAAAAEAAAAAPAEAAAAAAAAGAAAAMTM0NC4wAAAqAQAAeyJ3YXNfZmlyc3RfZXZlbnQiOmZhbHNlLCJpbWFnZV9pZCI6WzE2Njg3OTMyODksODQ2NDIwOTI1LDE3NzU3NjM0MywzODM1ODczODYyLDY2MzMzNTUzLDI4OTQ1NjYwMzAsNTk4Mjc1ODE1LDI3MTgyNzg1ODBdLCJxZiI6eyJiIjpbMCwwLDAsMCwwLDAsMCwwLDAsMCwwLDAsMCwwLDAsMCwwLDAsMCwwLDAsMCwwLDAsMCwwLDAsMCwwLDAsMCwwLDAsMCwwLDAsMCwwLDAsMCwwLDAsMCwwLDAsMCwwLDAsMCwwLDAsMCwwLDAsMCwwLDAsMCwwLDAsMCwwLDAsMCwwLDAsMCwwLDAsMCwwLDAsMF0sImwiOjAsInEiOjYsInIiOjd9fQAAAAAAAAAAAAAAAAAAPAEAAAAAAAAGAAAAMTM0NC4wAAAqAQAAeyJ3YXNfZmlyc3RfZXZlbnQiOmZhbHNlLCJpbWFnZV9pZCI6WzE2Njg3OTMyODksODQ2NDIwOTI1LDE3NzU3NjM0MywzODM1ODczODYyLDY2MzMzNTUzLDI4OTQ1NjYwMzAsNTk4Mjc1ODE1LDI3MTgyNzg1ODBdLCJxZiI6eyJiIjpbMCwwLDAsMCwwLDAsMCwwLDAsMCwwLDAsMCwwLDAsMCwwLDAsMCwwLDAsMCwwLDAsMCwwLDAsMCwwLDAsMCwwLDAsMCwwLDAsMCwwLDAsMCwwLDAsMCwwLDAsMCwwLDAsMCwwLDAsMCwwLDAsMCwwLDAsMCwwLDAsMCwwLDAsMCwwLDAsMCwwLDAsMCwwLDAsMF0sImwiOjAsInEiOjYsInIiOjd9fQAAAAAAAAAAAAAAAAAAAAAAAAAAAAAAAAAAAAAAAAAAAAA='}}
prove_3;54;58;Mul;3132;4476;0.0;833;0.19511483299902466;{'verificationValue': 0.0, 'proof': {'imageId': [1668793289, 846420925, 177576343, 3835873862, 66333553, 2894566030, 598275815, 2718278580], 'receipt': 'AwAAAAAAAAAAAAAAFPIgAEBa/KxpnrWjLW5ZBdoVsH8Dr4kePkUNGJK+LwGcLUh4AAAAAAAAAAAAAAAAAAAAAAAAAAAAAAAAAAAAAAAAAAAAAAAAAAAAAAAAAAAAAAAAAQAAAAAAAAAAAAAAAAAAAAAAAAAAAAAAAAAAAAAAAAAAAAAAAAAAAAEAAAAAPAEAAAAAAAAGAAAANDQ3Ni4wAAAqAQAAeyJ3YXNfZmlyc3RfZXZlbnQiOmZhbHNlLCJpbWFnZV9pZCI6WzE2Njg3OTMyODksODQ2NDIwOTI1LDE3NzU3NjM0MywzODM1ODczODYyLDY2MzMzNTUzLDI4OTQ1NjYwMzAsNTk4Mjc1ODE1LDI3MTgyNzg1ODBdLCJxZiI6eyJiIjpbMCwwLDAsMCwwLDAsMCwwLDAsMCwwLDAsMCwwLDAsMCwwLDAsMCwwLDAsMCwwLDAsMCwwLDAsMCwwLDAsMCwwLDAsMCwwLDAsMCwwLDAsMCwwLDAsMCwwLDAsMCwwLDAsMCwwLDAsMCwwLDAsMCwwLDAsMCwwLDAsMCwwLDAsMCwwLDAsMCwwLDAsMCwwLDAsMF0sImwiOjAsInEiOjYsInIiOjd9fQAAAAAAAAAAAAAAAAAAPAEAAAAAAAAGAAAANDQ3Ni4wAAAqAQAAeyJ3YXNfZmlyc3RfZXZlbnQiOmZhbHNlLCJpbWFnZV9pZCI6WzE2Njg3OTMyODksODQ2NDIwOTI1LDE3NzU3NjM0MywzODM1ODczODYyLDY2MzMzNTUzLDI4OTQ1NjYwMzAsNTk4Mjc1ODE1LDI3MTgyNzg1ODBdLCJxZiI6eyJiIjpbMCwwLDAsMCwwLDAsMCwwLDAsMCwwLDAsMCwwLDAsMCwwLDAsMCwwLDAsMCwwLDAsMCwwLDAsMCwwLDAsMCwwLDAsMCwwLDAsMCwwLDAsMCwwLDAsMCwwLDAsMCwwLDAsMCwwLDAsMCwwLDAsMCwwLDAsMCwwLDAsMCwwLDAsMCwwLDAsMCwwLDAsMCwwLDAsMF0sImwiOjAsInEiOjYsInIiOjd9fQAAAAAAAAAAAAAAAAAAAAAAAAAAAAAAAAAAAAAAAAAAAAA='}}
prove_4;20;59;Mul;1180;5656;0.0;833;0.2601047500011191;{'verificationValue': 0.0, 'proof': {'imageId': [1668793289, 846420925, 177576343, 3835873862, 66333553, 2894566030, 598275815, 2718278580], 'receipt': 'AwAAAAAAAAAAAAAAFPIgAEBa/KxpnrWjLW5ZBdoVsH8Dr4kePkUNGJK+LwGcLUh4AAAAAAAAAAAAAAAAAAAAAAAAAAAAAAAAAAAAAAAAAAAAAAAAAAAAAAAAAAAAAAAAAQAAAAAAAAAAAAAAAAAAAAAAAAAAAAAAAAAAAAAAAAAAAAAAAAAAAAEAAAAAPAEAAAAAAAAGAAAANTY1Ni4wAAAqAQAAeyJ3YXNfZmlyc3RfZXZlbnQiOmZhbHNlLCJpbWFnZV9pZCI6WzE2Njg3OTMyODksODQ2NDIwOTI1LDE3NzU3NjM0MywzODM1ODczODYyLDY2MzMzNTUzLDI4OTQ1NjYwMzAsNTk4Mjc1ODE1LDI3MTgyNzg1ODBdLCJxZiI6eyJiIjpbMCwwLDAsMCwwLDAsMCwwLDAsMCwwLDAsMCwwLDAsMCwwLDAsMCwwLDAsMCwwLDAsMCwwLDAsMCwwLDAsMCwwLDAsMCwwLDAsMCwwLDAsMCwwLDAsMCwwLDAsMCwwLDAsMCwwLDAsMCwwLDAsMCwwLDAsMCwwLDAsMCwwLDAsMCwwLDAsMCwwLDAsMCwwLDAsMF0sImwiOjAsInEiOjYsInIiOjd9fQAAAAAAAAAAAAAAAAAAPAEAAAAAAAAGAAAANTY1Ni4wAAAqAQAAeyJ3YXNfZmlyc3RfZXZlbnQiOmZhbHNlLCJpbWFnZV9pZCI6WzE2Njg3OTMyODksODQ2NDIwOTI1LDE3NzU3NjM0MywzODM1ODczODYyLDY2MzMzNTUzLDI4OTQ1NjYwMzAsNTk4Mjc1ODE1LDI3MTgyNzg1ODBdLCJxZiI6eyJiIjpbMCwwLDAsMCwwLDAsMCwwLDAsMCwwLDAsMCwwLDAsMCwwLDAsMCwwLDAsMCwwLDAsMCwwLDAsMCwwLDAsMCwwLDAsMCwwLDAsMCwwLDAsMCwwLDAsMCwwLDAsMCwwLDAsMCwwLDAsMCwwLDAsMCwwLDAsMCwwLDAsMCwwLDAsMCwwLDAsMCwwLDAsMCwwLDAsMF0sImwiOjAsInEiOjYsInIiOjd9fQAAAAAAAAAAAAAAAAAAAAAAAAAAAAAAAAAAAAAAAAAAAAA='}}
prove_5;52;15;Mul;780;6436;0.0;833;0.3235632080013602;{'verificationValue': 0.0, 'proof': {'imageId': [1668793289, 846420925, 177576343, 3835873862, 66333553, 2894566030, 598275815, 2718278580], 'receipt': 'AwAAAAAAAAAAAAAAFPIgAEBa/KxpnrWjLW5ZBdoVsH8Dr4kePkUNGJK+LwGcLUh4AAAAAAAAAAAAAAAAAAAAAAAAAAAAAAAAAAAAAAAAAAAAAAAAAAAAAAAAAAAAAAAAAQAAAAAAAAAAAAAAAAAAAAAAAAAAAAAAAAAAAAAAAAAAAAAAAAAAAAEAAAAAPAEAAAAAAAAGAAAANjQzNi4wAAAqAQAAeyJ3YXNfZmlyc3RfZXZlbnQiOmZhbHNlLCJpbWFnZV9pZCI6WzE2Njg3OTMyODksODQ2NDIwOTI1LDE3NzU3NjM0MywzODM1ODczODYyLDY2MzMzNTUzLDI4OTQ1NjYwMzAsNTk4Mjc1ODE1LDI3MTgyNzg1ODBdLCJxZiI6eyJiIjpbMCwwLDAsMCwwLDAsMCwwLDAsMCwwLDAsMCwwLDAsMCwwLDAsMCwwLDAsMCwwLDAsMCwwLDAsMCwwLDAsMCwwLDAsMCwwLDAsMCwwLDAsMCwwLDAsMCwwLDAsMCwwLDAsMCwwLDAsMCwwLDAsMCwwLDAsMCwwLDAsMCwwLDAsMCwwLDAsMCwwLDAsMCwwLDAsMF0sImwiOjAsInEiOjYsInIiOjd9fQAAAAAAAAAAAAAAAAAAPAEAAAAAAAAGAAAANjQzNi4wAAAqAQAAeyJ3YXNfZmlyc3RfZXZlbnQiOmZhbHNlLCJpbWFnZV9pZCI6WzE2Njg3OTMyODksODQ2NDIwOTI1LDE3NzU3NjM0MywzODM1ODczODYyLDY2MzMzNTUzLDI4OTQ1NjYwMzAsNTk4Mjc1ODE1LDI3MTgyNzg1ODBdLCJxZiI6eyJiIjpbMCwwLDAsMCwwLDAsMCwwLDAsMCwwLDAsMCwwLDAsMCwwLDAsMCwwLDAsMCwwLDAsMCwwLDAsMCwwLDAsMCwwLDAsMCwwLDAsMCwwLDAsMCwwLDAsMCwwLDAsMCwwLDAsMCwwLDAsMCwwLDAsMCwwLDAsMCwwLDAsMCwwLDAsMCwwLDAsMCwwLDAsMCwwLDAsMF0sImwiOjAsInEiOjYsInIiOjd9fQAAAAAAAAAAAAAAAAAAAAAAAAAAAAAAAAAAAAAAAAAAAAA='}}
prove_6;88;38;Mul;3344;9780;0.0;833;0.387582207999003;{'verificationValue': 0.0, 'proof': {'imageId': [1668793289, 846420925, 177576343, 3835873862, 66333553, 2894566030, 598275815, 2718278580], 'receipt': 'AwAAAAAAAAAAAAAAFPIgAEBa/KxpnrWjLW5ZBdoVsH8Dr4kePkUNGJK+LwGcLUh4AAAAAAAAAAAAAAAAAAAAAAAAAAAAAAAAAAAAAAAAAAAAAAAAAAAAAAAAAAAAAAAAAQAAAAAAAAAAAAAAAAAAAAAAAAAAAAAAAAAAAAAAAAAAAAAAAAAAAAEAAAAAPAEAAAAAAAAGAAAAOTc4MC4wAAAqAQAAeyJ3YXNfZmlyc3RfZXZlbnQiOmZhbHNlLCJpbWFnZV9pZCI6WzE2Njg3OTMyODksODQ2NDIwOTI1LDE3NzU3NjM0MywzODM1ODczODYyLDY2MzMzNTUzLDI4OTQ1NjYwMzAsNTk4Mjc1ODE1LDI3MTgyNzg1ODBdLCJxZiI6eyJiIjpbMCwwLDAsMCwwLDAsMCwwLDAsMCwwLDAsMCwwLDAsMCwwLDAsMCwwLDAsMCwwLDAsMCwwLDAsMCwwLDAsMCwwLDAsMCwwLDAsMCwwLDAsMCwwLDAsMCwwLDAsMCwwLDAsMCwwLDAsMCwwLDAsMCwwLDAsMCwwLDAsMCwwLDAsMCwwLDAsMCwwLDAsMCwwLDAsMF0sImwiOjAsInEiOjYsInIiOjd9fQAAAAAAAAAAAAAAAAAAPAEAAAAAAAAGAAAAOTc4MC4wAAAqAQAAeyJ3YXNfZmlyc3RfZXZlbnQiOmZhbHNlLCJpbWFnZV9pZCI6WzE2Njg3OTMyODksODQ2NDIwOTI1LDE3NzU3NjM0MywzODM1ODczODYyLDY2MzMzNTUzLDI4OTQ1NjYwMzAsNTk4Mjc1ODE1LDI3MTgyNzg1ODBdLCJxZiI6eyJiIjpbMCwwLDAsMCwwLDAsMCwwLDAsMCwwLDAsMCwwLDAsMCwwLDAsMCwwLDAsMCwwLDAsMCwwLDAsMCwwLDAsMCwwLDAsMCwwLDAsMCwwLDAsMCwwLDAsMCwwLDAsMCwwLDAsMCwwLDAsMCwwLDAsMCwwLDAsMCwwLDAsMCwwLDAsMCwwLDAsMCwwLDAsMCwwLDAsMF0sImwiOjAsInEiOjYsInIiOjd9fQAAAAAAAAAAAAAAAAAAAAAAAAAAAAAAAAAAAAAAAAAAAAA='}}
prove_7;89;61;Mul;5429;15209;0.0;833;0.45335125000019616;{'verificationValue': 0.0, 'proof': {'imageId': [1668793289, 846420925, 177576343, 3835873862, 66333553, 2894566030, 598275815, 2718278580], 'receipt': 'AwAAAAAAAAAAAAAAFPIgAEBa/KxpnrWjLW5ZBdoVsH8Dr4kePkUNGJK+LwGcLUh4AAAAAAAAAAAAAAAAAAAAAAAAAAAAAAAAAAAAAAAAAAAAAAAAAAAAAAAAAAAAAAAAAQAAAAAAAAAAAAAAAAAAAAAAAAAAAAAAAAAAAAAAAAAAAAAAAAAAAAEAAAAAPAEAAAAAAAAHAAAAMTUyMDkuMAAqAQAAeyJ3YXNfZmlyc3RfZXZlbnQiOmZhbHNlLCJpbWFnZV9pZCI6WzE2Njg3OTMyODksODQ2NDIwOTI1LDE3NzU3NjM0MywzODM1ODczODYyLDY2MzMzNTUzLDI4OTQ1NjYwMzAsNTk4Mjc1ODE1LDI3MTgyNzg1ODBdLCJxZiI6eyJiIjpbMCwwLDAsMCwwLDAsMCwwLDAsMCwwLDAsMCwwLDAsMCwwLDAsMCwwLDAsMCwwLDAsMCwwLDAsMCwwLDAsMCwwLDAsMCwwLDAsMCwwLDAsMCwwLDAsMCwwLDAsMCwwLDAsMCwwLDAsMCwwLDAsMCwwLDAsMCwwLDAsMCwwLDAsMCwwLDAsMCwwLDAsMCwwLDAsMF0sImwiOjAsInEiOjYsInIiOjd9fQAAAAAAAAAAAAAAAAAAPAEAAAAAAAAHAAAAMTUyMDkuMAAqAQAAeyJ3YXNfZmlyc3RfZXZlbnQiOmZhbHNlLCJpbWFnZV9pZCI6WzE2Njg3OTMyODksODQ2NDIwOTI1LDE3NzU3NjM0MywzODM1ODczODYyLDY2MzMzNTUzLDI4OTQ1NjYwMzAsNTk4Mjc1ODE1LDI3MTgyNzg1ODBdLCJxZiI6eyJiIjpbMCwwLDAsMCwwLDAsMCwwLDAsMCwwLDAsMCwwLDAsMCwwLDAsMCwwLDAsMCwwLDAsMCwwLDAsMCwwLDAsMCwwLDAsMCwwLDAsMCwwLDAsMCwwLDAsMCwwLDAsMCwwLDAsMCwwLDAsMCwwLDAsMCwwLDAsMCwwLDAsMCwwLDAsMCwwLDAsMCwwLDAsMCwwLDAsMF0sImwiOjAsInEiOjYsInIiOjd9fQAAAAAAAAAAAAAAAAAAAAAAAAAAAAAAAAAAAAAAAAAAAAA='}}
prove_8;3;72;Mul;216;15425;0.0;833;0.5163716249990102;{'verificationValue': 0.0, 'proof': {'imageId': [1668793289, 846420925, 177576343, 3835873862, 66333553, 2894566030, 598275815, 2718278580], 'receipt': 'AwAAAAAAAAAAAAAAFPIgAEBa/KxpnrWjLW5ZBdoVsH8Dr4kePkUNGJK+LwGcLUh4AAAAAAAAAAAAAAAAAAAAAAAAAAAAAAAAAAAAAAAAAAAAAAAAAAAAAAAAAAAAAAAAAQAAAAAAAAAAAAAAAAAAAAAAAAAAAAAAAAAAAAAAAAAAAAAAAAAAAAEAAAAAPAEAAAAAAAAHAAAAMTU0MjUuMAAqAQAAeyJ3YXNfZmlyc3RfZXZlbnQiOmZhbHNlLCJpbWFnZV9pZCI6WzE2Njg3OTMyODksODQ2NDIwOTI1LDE3NzU3NjM0MywzODM1ODczODYyLDY2MzMzNTUzLDI4OTQ1NjYwMzAsNTk4Mjc1ODE1LDI3MTgyNzg1ODBdLCJxZiI6eyJiIjpbMCwwLDAsMCwwLDAsMCwwLDAsMCwwLDAsMCwwLDAsMCwwLDAsMCwwLDAsMCwwLDAsMCwwLDAsMCwwLDAsMCwwLDAsMCwwLDAsMCwwLDAsMCwwLDAsMCwwLDAsMCwwLDAsMCwwLDAsMCwwLDAsMCwwLDAsMCwwLDAsMCwwLDAsMCwwLDAsMCwwLDAsMCwwLDAsMF0sImwiOjAsInEiOjYsInIiOjd9fQAAAAAAAAAAAAAAAAAAPAEAAAAAAAAHAAAAMTU0MjUuMAAqAQAAeyJ3YXNfZmlyc3RfZXZlbnQiOmZhbHNlLCJpbWFnZV9pZCI6WzE2Njg3OTMyODksODQ2NDIwOTI1LDE3NzU3NjM0MywzODM1ODczODYyLDY2MzMzNTUzLDI4OTQ1NjYwMzAsNTk4Mjc1ODE1LDI3MTgyNzg1ODBdLCJxZiI6eyJiIjpbMCwwLDAsMCwwLDAsMCwwLDAsMCwwLDAsMCwwLDAsMCwwLDAsMCwwLDAsMCwwLDAsMCwwLDAsMCwwLDAsMCwwLDAsMCwwLDAsMCwwLDAsMCwwLDAsMCwwLDAsMCwwLDAsMCwwLDAsMCwwLDAsMCwwLDAsMCwwLDAsMCwwLDAsMCwwLDAsMCwwLDAsMCwwLDAsMF0sImwiOjAsInEiOjYsInIiOjd9fQAAAAAAAAAAAAAAAAAAAAAAAAAAAAAAAAAAAAAAAAAAAAA='}}
prove_9;2;77;Mul;154;15579;0.0;833;0.5812837089997629;{'verificationValue': 0.0, 'proof': {'imageId': [1668793289, 846420925, 177576343, 3835873862, 66333553, 2894566030, 598275815, 2718278580], 'receipt': 'AwAAAAAAAAAAAAAAFPIgAEBa/KxpnrWjLW5ZBdoVsH8Dr4kePkUNGJK+LwGcLUh4AAAAAAAAAAAAAAAAAAAAAAAAAAAAAAAAAAAAAAAAAAAAAAAAAAAAAAAAAAAAAAAAAQAAAAAAAAAAAAAAAAAAAAAAAAAAAAAAAAAAAAAAAAAAAAAAAAAAAAEAAAAAPAEAAAAAAAAHAAAAMTU1NzkuMAAqAQAAeyJ3YXNfZmlyc3RfZXZlbnQiOmZhbHNlLCJpbWFnZV9pZCI6WzE2Njg3OTMyODksODQ2NDIwOTI1LDE3NzU3NjM0MywzODM1ODczODYyLDY2MzMzNTUzLDI4OTQ1NjYwMzAsNTk4Mjc1ODE1LDI3MTgyNzg1ODBdLCJxZiI6eyJiIjpbMCwwLDAsMCwwLDAsMCwwLDAsMCwwLDAsMCwwLDAsMCwwLDAsMCwwLDAsMCwwLDAsMCwwLDAsMCwwLDAsMCwwLDAsMCwwLDAsMCwwLDAsMCwwLDAsMCwwLDAsMCwwLDAsMCwwLDAsMCwwLDAsMCwwLDAsMCwwLDAsMCwwLDAsMCwwLDAsMCwwLDAsMCwwLDAsMF0sImwiOjAsInEiOjYsInIiOjd9fQAAAAAAAAAAAAAAAAAAPAEAAAAAAAAHAAAAMTU1NzkuMAAqAQAAeyJ3YXNfZmlyc3RfZXZlbnQiOmZhbHNlLCJpbWFnZV9pZCI6WzE2Njg3OTMyODksODQ2NDIwOTI1LDE3NzU3NjM0MywzODM1ODczODYyLDY2MzMzNTUzLDI4OTQ1NjYwMzAsNTk4Mjc1ODE1LDI3MTgyNzg1ODBdLCJxZiI6eyJiIjpbMCwwLDAsMCwwLDAsMCwwLDAsMCwwLDAsMCwwLDAsMCwwLDAsMCwwLDAsMCwwLDAsMCwwLDAsMCwwLDAsMCwwLDAsMCwwLDAsMCwwLDAsMCwwLDAsMCwwLDAsMCwwLDAsMCwwLDAsMCwwLDAsMCwwLDAsMCwwLDAsMCwwLDAsMCwwLDAsMCwwLDAsMCwwLDAsMF0sImwiOjAsInEiOjYsInIiOjd9fQAAAAAAAAAAAAAAAAAAAAAAAAAAAAAAAAAAAAAAAAAAAAA='}}
prove_10;91;38;Mul;3458;19037;0.0;833;0.6439528339997196;{'verificationValue': 0.0, 'proof': {'imageId': [1668793289, 846420925, 177576343, 3835873862, 66333553, 2894566030, 598275815, 2718278580], 'receipt': 'AwAAAAAAAAAAAAAAFPIgAEBa/KxpnrWjLW5ZBdoVsH8Dr4kePkUNGJK+LwGcLUh4AAAAAAAAAAAAAAAAAAAAAAAAAAAAAAAAAAAAAAAAAAAAAAAAAAAAAAAAAAAAAAAAAQAAAAAAAAAAAAAAAAAAAAAAAAAAAAAAAAAAAAAAAAAAAAAAAAAAAAEAAAAAPAEAAAAAAAAHAAAAMTkwMzcuMAAqAQAAeyJ3YXNfZmlyc3RfZXZlbnQiOmZhbHNlLCJpbWFnZV9pZCI6WzE2Njg3OTMyODksODQ2NDIwOTI1LDE3NzU3NjM0MywzODM1ODczODYyLDY2MzMzNTUzLDI4OTQ1NjYwMzAsNTk4Mjc1ODE1LDI3MTgyNzg1ODBdLCJxZiI6eyJiIjpbMCwwLDAsMCwwLDAsMCwwLDAsMCwwLDAsMCwwLDAsMCwwLDAsMCwwLDAsMCwwLDAsMCwwLDAsMCwwLDAsMCwwLDAsMCwwLDAsMCwwLDAsMCwwLDAsMCwwLDAsMCwwLDAsMCwwLDAsMCwwLDAsMCwwLDAsMCwwLDAsMCwwLDAsMCwwLDAsMCwwLDAsMCwwLDAsMF0sImwiOjAsInEiOjYsInIiOjd9fQAAAAAAAAAAAAAAAAAAPAEAAAAAAAAHAAAAMTkwMzcuMAAqAQAAeyJ3YXNfZmlyc3RfZXZlbnQiOmZhbHNlLCJpbWFnZV9pZCI6WzE2Njg3OTMyODksODQ2NDIwOTI1LDE3NzU3NjM0MywzODM1ODczODYyLDY2MzMzNTUzLDI4OTQ1NjYwMzAsNTk4Mjc1ODE1LDI3MTgyNzg1ODBdLCJxZiI6eyJiIjpbMCwwLDAsMCwwLDAsMCwwLDAsMCwwLDAsMCwwLDAsMCwwLDAsMCwwLDAsMCwwLDAsMCwwLDAsMCwwLDAsMCwwLDAsMCwwLDAsMCwwLDAsMCwwLDAsMCwwLDAsMCwwLDAsMCwwLDAsMCwwLDAsMCwwLDAsMCwwLDAsMCwwLDAsMCwwLDAsMCwwLDAsMCwwLDAsMF0sImwiOjAsInEiOjYsInIiOjd9fQAAAAAAAAAAAAAAAAAAAAAAAAAAAAAAAAAAAAAAAAAAAAA='}}
prove_11;30;19;Mul;570;19607;0.0;833;0.7232018750000861;{'verificationValue': 0.0, 'proof': {'imageId': [1668793289, 846420925, 177576343, 3835873862, 66333553, 2894566030, 598275815, 2718278580], 'receipt': 'AwAAAAAAAAAAAAAAFPIgAEBa/KxpnrWjLW5ZBdoVsH8Dr4kePkUNGJK+LwGcLUh4AAAAAAAAAAAAAAAAAAAAAAAAAAAAAAAAAAAAAAAAAAAAAAAAAAAAAAAAAAAAAAAAAQAAAAAAAAAAAAAAAAAAAAAAAAAAAAAAAAAAAAAAAAAAAAAAAAAAAAEAAAAAPAEAAAAAAAAHAAAAMTk2MDcuMAAqAQAAeyJ3YXNfZmlyc3RfZXZlbnQiOmZhbHNlLCJpbWFnZV9pZCI6WzE2Njg3OTMyODksODQ2NDIwOTI1LDE3NzU3NjM0MywzODM1ODczODYyLDY2MzMzNTUzLDI4OTQ1NjYwMzAsNTk4Mjc1ODE1LDI3MTgyNzg1ODBdLCJxZiI6eyJiIjpbMCwwLDAsMCwwLDAsMCwwLDAsMCwwLDAsMCwwLDAsMCwwLDAsMCwwLDAsMCwwLDAsMCwwLDAsMCwwLDAsMCwwLDAsMCwwLDAsMCwwLDAsMCwwLDAsMCwwLDAsMCwwLDAsMCwwLDAsMCwwLDAsMCwwLDAsMCwwLDAsMCwwLDAsMCwwLDAsMCwwLDAsMCwwLDAsMF0sImwiOjAsInEiOjYsInIiOjd9fQAAAAAAAAAAAAAAAAAAPAEAAAAAAAAHAAAAMTk2MDcuMAAqAQAAeyJ3YXNfZmlyc3RfZXZlbnQiOmZhbHNlLCJpbWFnZV9pZCI6WzE2Njg3OTMyODksODQ2NDIwOTI1LDE3NzU3NjM0MywzODM1ODczODYyLDY2MzMzNTUzLDI4OTQ1NjYwMzAsNTk4Mjc1ODE1LDI3MTgyNzg1ODBdLCJxZiI6eyJiIjpbMCwwLDAsMCwwLDAsMCwwLDAsMCwwLDAsMCwwLDAsMCwwLDAsMCwwLDAsMCwwLDAsMCwwLDAsMCwwLDAsMCwwLDAsMCwwLDAsMCwwLDAsMCwwLDAsMCwwLDAsMCwwLDAsMCwwLDAsMCwwLDAsMCwwLDAsMCwwLDAsMCwwLDAsMCwwLDAsMCwwLDAsMCwwLDAsMF0sImwiOjAsInEiOjYsInIiOjd9fQAAAAAAAAAAAAAAAAAAAAAAAAAAAAAAAAAAAAAAAAAAAAA='}}
prove_12;6;75;Mul;450;20057;0.0;833;0.7728450419999717;{'verificationValue': 0.0, 'proof': {'imageId': [1668793289, 846420925, 177576343, 3835873862, 66333553, 2894566030, 598275815, 2718278580], 'receipt': 'AwAAAAAAAAAAAAAAFPIgAEBa/KxpnrWjLW5ZBdoVsH8Dr4kePkUNGJK+LwGcLUh4AAAAAAAAAAAAAAAAAAAAAAAAAAAAAAAAAAAAAAAAAAAAAAAAAAAAAAAAAAAAAAAAAQAAAAAAAAAAAAAAAAAAAAAAAAAAAAAAAAAAAAAAAAAAAAAAAAAAAAEAAAAAPAEAAAAAAAAHAAAAMjAwNTcuMAAqAQAAeyJ3YXNfZmlyc3RfZXZlbnQiOmZhbHNlLCJpbWFnZV9pZCI6WzE2Njg3OTMyODksODQ2NDIwOTI1LDE3NzU3NjM0MywzODM1ODczODYyLDY2MzMzNTUzLDI4OTQ1NjYwMzAsNTk4Mjc1ODE1LDI3MTgyNzg1ODBdLCJxZiI6eyJiIjpbMCwwLDAsMCwwLDAsMCwwLDAsMCwwLDAsMCwwLDAsMCwwLDAsMCwwLDAsMCwwLDAsMCwwLDAsMCwwLDAsMCwwLDAsMCwwLDAsMCwwLDAsMCwwLDAsMCwwLDAsMCwwLDAsMCwwLDAsMCwwLDAsMCwwLDAsMCwwLDAsMCwwLDAsMCwwLDAsMCwwLDAsMCwwLDAsMF0sImwiOjAsInEiOjYsInIiOjd9fQAAAAAAAAAAAAAAAAAAPAEAAAAAAAAHAAAAMjAwNTcuMAAqAQAAeyJ3YXNfZmlyc3RfZXZlbnQiOmZhbHNlLCJpbWFnZV9pZCI6WzE2Njg3OTMyODksODQ2NDIwOTI1LDE3NzU3NjM0MywzODM1ODczODYyLDY2MzMzNTUzLDI4OTQ1NjYwMzAsNTk4Mjc1ODE1LDI3MTgyNzg1ODBdLCJxZiI6eyJiIjpbMCwwLDAsMCwwLDAsMCwwLDAsMCwwLDAsMCwwLDAsMCwwLDAsMCwwLDAsMCwwLDAsMCwwLDAsMCwwLDAsMCwwLDAsMCwwLDAsMCwwLDAsMCwwLDAsMCwwLDAsMCwwLDAsMCwwLDAsMCwwLDAsMCwwLDAsMCwwLDAsMCwwLDAsMCwwLDAsMCwwLDAsMCwwLDAsMF0sImwiOjAsInEiOjYsInIiOjd9fQAAAAAAAAAAAAAAAAAAAAAAAAAAAAAAAAAAAAAAAAAAAAA='}}
prove_13;40;8;Mul;320;20377;0.0;833;0.8386852080002427;{'verificationValue': 0.0, 'proof': {'imageId': [1668793289, 846420925, 177576343, 3835873862, 66333553, 2894566030, 598275815, 2718278580], 'receipt': 'AwAAAAAAAAAAAAAAFPIgAEBa/KxpnrWjLW5ZBdoVsH8Dr4kePkUNGJK+LwGcLUh4AAAAAAAAAAAAAAAAAAAAAAAAAAAAAAAAAAAAAAAAAAAAAAAAAAAAAAAAAAAAAAAAAQAAAAAAAAAAAAAAAAAAAAAAAAAAAAAAAAAAAAAAAAAAAAAAAAAAAAEAAAAAPAEAAAAAAAAHAAAAMjAzNzcuMAAqAQAAeyJ3YXNfZmlyc3RfZXZlbnQiOmZhbHNlLCJpbWFnZV9pZCI6WzE2Njg3OTMyODksODQ2NDIwOTI1LDE3NzU3NjM0MywzODM1ODczODYyLDY2MzMzNTUzLDI4OTQ1NjYwMzAsNTk4Mjc1ODE1LDI3MTgyNzg1ODBdLCJxZiI6eyJiIjpbMCwwLDAsMCwwLDAsMCwwLDAsMCwwLDAsMCwwLDAsMCwwLDAsMCwwLDAsMCwwLDAsMCwwLDAsMCwwLDAsMCwwLDAsMCwwLDAsMCwwLDAsMCwwLDAsMCwwLDAsMCwwLDAsMCwwLDAsMCwwLDAsMCwwLDAsMCwwLDAsMCwwLDAsMCwwLDAsMCwwLDAsMCwwLDAsMF0sImwiOjAsInEiOjYsInIiOjd9fQAAAAAAAAAAAAAAAAAAPAEAAAAAAAAHAAAAMjAzNzcuMAAqAQAAeyJ3YXNfZmlyc3RfZXZlbnQiOmZhbHNlLCJpbWFnZV9pZCI6WzE2Njg3OTMyODksODQ2NDIwOTI1LDE3NzU3NjM0MywzODM1ODczODYyLDY2MzMzNTUzLDI4OTQ1NjYwMzAsNTk4Mjc1ODE1LDI3MTgyNzg1ODBdLCJxZiI6eyJiIjpbMCwwLDAsMCwwLDAsMCwwLDAsMCwwLDAsMCwwLDAsMCwwLDAsMCwwLDAsMCwwLDAsMCwwLDAsMCwwLDAsMCwwLDAsMCwwLDAsMCwwLDAsMCwwLDAsMCwwLDAsMCwwLDAsMCwwLDAsMCwwLDAsMCwwLDAsMCwwLDAsMCwwLDAsMCwwLDAsMCwwLDAsMCwwLDAsMF0sImwiOjAsInEiOjYsInIiOjd9fQAAAAAAAAAAAAAAAAAAAAAAAAAAAAAAAAAAAAAAAAAAAAA='}}
prove_14;79;5;Mul;395;20772;0.0;833;0.9024326670005394;{'verificationValue': 0.0, 'proof': {'imageId': [1668793289, 846420925, 177576343, 3835873862, 66333553, 2894566030, 598275815, 2718278580], 'receipt': 'AwAAAAAAAAAAAAAAFPIgAEBa/KxpnrWjLW5ZBdoVsH8Dr4kePkUNGJK+LwGcLUh4AAAAAAAAAAAAAAAAAAAAAAAAAAAAAAAAAAAAAAAAAAAAAAAAAAAAAAAAAAAAAAAAAQAAAAAAAAAAAAAAAAAAAAAAAAAAAAAAAAAAAAAAAAAAAAAAAAAAAAEAAAAAPAEAAAAAAAAHAAAAMjA3NzIuMAAqAQAAeyJ3YXNfZmlyc3RfZXZlbnQiOmZhbHNlLCJpbWFnZV9pZCI6WzE2Njg3OTMyODksODQ2NDIwOTI1LDE3NzU3NjM0MywzODM1ODczODYyLDY2MzMzNTUzLDI4OTQ1NjYwMzAsNTk4Mjc1ODE1LDI3MTgyNzg1ODBdLCJxZiI6eyJiIjpbMCwwLDAsMCwwLDAsMCwwLDAsMCwwLDAsMCwwLDAsMCwwLDAsMCwwLDAsMCwwLDAsMCwwLDAsMCwwLDAsMCwwLDAsMCwwLDAsMCwwLDAsMCwwLDAsMCwwLDAsMCwwLDAsMCwwLDAsMCwwLDAsMCwwLDAsMCwwLDAsMCwwLDAsMCwwLDAsMCwwLDAsMCwwLDAsMF0sImwiOjAsInEiOjYsInIiOjd9fQAAAAAAAAAAAAAAAAAAPAEAAAAAAAAHAAAAMjA3NzIuMAAqAQAAeyJ3YXNfZmlyc3RfZXZlbnQiOmZhbHNlLCJpbWFnZV9pZCI6WzE2Njg3OTMyODksODQ2NDIwOTI1LDE3NzU3NjM0MywzODM1ODczODYyLDY2MzMzNTUzLDI4OTQ1NjYwMzAsNTk4Mjc1ODE1LDI3MTgyNzg1ODBdLCJxZiI6eyJiIjpbMCwwLDAsMCwwLDAsMCwwLDAsMCwwLDAsMCwwLDAsMCwwLDAsMCwwLDAsMCwwLDAsMCwwLDAsMCwwLDAsMCwwLDAsMCwwLDAsMCwwLDAsMCwwLDAsMCwwLDAsMCwwLDAsMCwwLDAsMCwwLDAsMCwwLDAsMCwwLDAsMCwwLDAsMCwwLDAsMCwwLDAsMCwwLDAsMF0sImwiOjAsInEiOjYsInIiOjd9fQAAAAAAAAAAAAAAAAAAAAAAAAAAAAAAAAAAAAAAAAAAAAA='}}
prove_15;17;73;Mul;1241;22013;0.0;833;0.9684360840001318;{'verificationValue': 0.0, 'proof': {'imageId': [1668793289, 846420925, 177576343, 3835873862, 66333553, 2894566030, 598275815, 2718278580], 'receipt': 'AwAAAAAAAAAAAAAAFPIgAEBa/KxpnrWjLW5ZBdoVsH8Dr4kePkUNGJK+LwGcLUh4AAAAAAAAAAAAAAAAAAAAAAAAAAAAAAAAAAAAAAAAAAAAAAAAAAAAAAAAAAAAAAAAAQAAAAAAAAAAAAAAAAAAAAAAAAAAAAAAAAAAAAAAAAAAAAAAAAAAAAEAAAAAPAEAAAAAAAAHAAAAMjIwMTMuMAAqAQAAeyJ3YXNfZmlyc3RfZXZlbnQiOmZhbHNlLCJpbWFnZV9pZCI6WzE2Njg3OTMyODksODQ2NDIwOTI1LDE3NzU3NjM0MywzODM1ODczODYyLDY2MzMzNTUzLDI4OTQ1NjYwMzAsNTk4Mjc1ODE1LDI3MTgyNzg1ODBdLCJxZiI6eyJiIjpbMCwwLDAsMCwwLDAsMCwwLDAsMCwwLDAsMCwwLDAsMCwwLDAsMCwwLDAsMCwwLDAsMCwwLDAsMCwwLDAsMCwwLDAsMCwwLDAsMCwwLDAsMCwwLDAsMCwwLDAsMCwwLDAsMCwwLDAsMCwwLDAsMCwwLDAsMCwwLDAsMCwwLDAsMCwwLDAsMCwwLDAsMCwwLDAsMF0sImwiOjAsInEiOjYsInIiOjd9fQAAAAAAAAAAAAAAAAAAPAEAAAAAAAAHAAAAMjIwMTMuMAAqAQAAeyJ3YXNfZmlyc3RfZXZlbnQiOmZhbHNlLCJpbWFnZV9pZCI6WzE2Njg3OTMyODksODQ2NDIwOTI1LDE3NzU3NjM0MywzODM1ODczODYyLDY2MzMzNTUzLDI4OTQ1NjYwMzAsNTk4Mjc1ODE1LDI3MTgyNzg1ODBdLCJxZiI6eyJiIjpbMCwwLDAsMCwwLDAsMCwwLDAsMCwwLDAsMCwwLDAsMCwwLDAsMCwwLDAsMCwwLDAsMCwwLDAsMCwwLDAsMCwwLDAsMCwwLDAsMCwwLDAsMCwwLDAsMCwwLDAsMCwwLDAsMCwwLDAsMCwwLDAsMCwwLDAsMCwwLDAsMCwwLDAsMCwwLDAsMCwwLDAsMCwwLDAsMF0sImwiOjAsInEiOjYsInIiOjd9fQAAAAAAAAAAAAAAAAAAAAAAAAAAAAAAAAAAAAAAAAAAAAA='}}
prove_16;19;9;Mul;171;22184;0.0;833;1.0453105830001732;{'verificationValue': 0.0, 'proof': {'imageId': [1668793289, 846420925, 177576343, 3835873862, 66333553, 2894566030, 598275815, 2718278580], 'receipt': 'AwAAAAAAAAAAAAAAFPIgAEBa/KxpnrWjLW5ZBdoVsH8Dr4kePkUNGJK+LwGcLUh4AAAAAAAAAAAAAAAAAAAAAAAAAAAAAAAAAAAAAAAAAAAAAAAAAAAAAAAAAAAAAAAAAQAAAAAAAAAAAAAAAAAAAAAAAAAAAAAAAAAAAAAAAAAAAAAAAAAAAAEAAAAAPAEAAAAAAAAHAAAAMjIxODQuMAAqAQAAeyJ3YXNfZmlyc3RfZXZlbnQiOmZhbHNlLCJpbWFnZV9pZCI6WzE2Njg3OTMyODksODQ2NDIwOTI1LDE3NzU3NjM0MywzODM1ODczODYyLDY2MzMzNTUzLDI4OTQ1NjYwMzAsNTk4Mjc1ODE1LDI3MTgyNzg1ODBdLCJxZiI6eyJiIjpbMCwwLDAsMCwwLDAsMCwwLDAsMCwwLDAsMCwwLDAsMCwwLDAsMCwwLDAsMCwwLDAsMCwwLDAsMCwwLDAsMCwwLDAsMCwwLDAsMCwwLDAsMCwwLDAsMCwwLDAsMCwwLDAsMCwwLDAsMCwwLDAsMCwwLDAsMCwwLDAsMCwwLDAsMCwwLDAsMCwwLDAsMCwwLDAsMF0sImwiOjAsInEiOjYsInIiOjd9fQAAAAAAAAAAAAAAAAAAPAEAAAAAAAAHAAAAMjIxODQuMAAqAQAAeyJ3YXNfZmlyc3RfZXZlbnQiOmZhbHNlLCJpbWFnZV9pZCI6WzE2Njg3OTMyODksODQ2NDIwOTI1LDE3NzU3NjM0MywzODM1ODczODYyLDY2MzMzNTUzLDI4OTQ1NjYwMzAsNTk4Mjc1ODE1LDI3MTgyNzg1ODBdLCJxZiI6eyJiIjpbMCwwLDAsMCwwLDAsMCwwLDAsMCwwLDAsMCwwLDAsMCwwLDAsMCwwLDAsMCwwLDAsMCwwLDAsMCwwLDAsMCwwLDAsMCwwLDAsMCwwLDAsMCwwLDAsMCwwLDAsMCwwLDAsMCwwLDAsMCwwLDAsMCwwLDAsMCwwLDAsMCwwLDAsMCwwLDAsMCwwLDAsMCwwLDAsMF0sImwiOjAsInEiOjYsInIiOjd9fQAAAAAAAAAAAAAAAAAAAAAAAAAAAAAAAAAAAAAAAAAAAAA='}}
prove_17;73;5;Mul;365;22549;0.0;833;1.125663542001348;{'verificationValue': 0.0, 'proof': {'imageId': [1668793289, 846420925, 177576343, 3835873862, 66333553, 2894566030, 598275815, 2718278580], 'receipt': 'AwAAAAAAAAAAAAAAFPIgAEBa/KxpnrWjLW5ZBdoVsH8Dr4kePkUNGJK+LwGcLUh4AAAAAAAAAAAAAAAAAAAAAAAAAAAAAAAAAAAAAAAAAAAAAAAAAAAAAAAAAAAAAAAAAQAAAAAAAAAAAAAAAAAAAAAAAAAAAAAAAAAAAAAAAAAAAAAAAAAAAAEAAAAAPAEAAAAAAAAHAAAAMjI1NDkuMAAqAQAAeyJ3YXNfZmlyc3RfZXZlbnQiOmZhbHNlLCJpbWFnZV9pZCI6WzE2Njg3OTMyODksODQ2NDIwOTI1LDE3NzU3NjM0MywzODM1ODczODYyLDY2MzMzNTUzLDI4OTQ1NjYwMzAsNTk4Mjc1ODE1LDI3MTgyNzg1ODBdLCJxZiI6eyJiIjpbMCwwLDAsMCwwLDAsMCwwLDAsMCwwLDAsMCwwLDAsMCwwLDAsMCwwLDAsMCwwLDAsMCwwLDAsMCwwLDAsMCwwLDAsMCwwLDAsMCwwLDAsMCwwLDAsMCwwLDAsMCwwLDAsMCwwLDAsMCwwLDAsMCwwLDAsMCwwLDAsMCwwLDAsMCwwLDAsMCwwLDAsMCwwLDAsMF0sImwiOjAsInEiOjYsInIiOjd9fQAAAAAAAAAAAAAAAAAAPAEAAAAAAAAHAAAAMjI1NDkuMAAqAQAAeyJ3YXNfZmlyc3RfZXZlbnQiOmZhbHNlLCJpbWFnZV9pZCI6WzE2Njg3OTMyODksODQ2NDIwOTI1LDE3NzU3NjM0MywzODM1ODczODYyLDY2MzMzNTUzLDI4OTQ1NjYwMzAsNTk4Mjc1ODE1LDI3MTgyNzg1ODBdLCJxZiI6eyJiIjpbMCwwLDAsMCwwLDAsMCwwLDAsMCwwLDAsMCwwLDAsMCwwLDAsMCwwLDAsMCwwLDAsMCwwLDAsMCwwLDAsMCwwLDAsMCwwLDAsMCwwLDAsMCwwLDAsMCwwLDAsMCwwLDAsMCwwLDAsMCwwLDAsMCwwLDAsMCwwLDAsMCwwLDAsMCwwLDAsMCwwLDAsMCwwLDAsMF0sImwiOjAsInEiOjYsInIiOjd9fQAAAAAAAAAAAAAAAAAAAAAAAAAAAAAAAAAAAAAAAAAAAAA='}}
prove_18;93;14;Mul;1302;23851;0.0;833;1.1618524170007731;{'verificationValue': 0.0, 'proof': {'imageId': [1668793289, 846420925, 177576343, 3835873862, 66333553, 2894566030, 598275815, 2718278580], 'receipt': 'AwAAAAAAAAAAAAAAFPIgAEBa/KxpnrWjLW5ZBdoVsH8Dr4kePkUNGJK+LwGcLUh4AAAAAAAAAAAAAAAAAAAAAAAAAAAAAAAAAAAAAAAAAAAAAAAAAAAAAAAAAAAAAAAAAQAAAAAAAAAAAAAAAAAAAAAAAAAAAAAAAAAAAAAAAAAAAAAAAAAAAAEAAAAAPAEAAAAAAAAHAAAAMjM4NTEuMAAqAQAAeyJ3YXNfZmlyc3RfZXZlbnQiOmZhbHNlLCJpbWFnZV9pZCI6WzE2Njg3OTMyODksODQ2NDIwOTI1LDE3NzU3NjM0MywzODM1ODczODYyLDY2MzMzNTUzLDI4OTQ1NjYwMzAsNTk4Mjc1ODE1LDI3MTgyNzg1ODBdLCJxZiI6eyJiIjpbMCwwLDAsMCwwLDAsMCwwLDAsMCwwLDAsMCwwLDAsMCwwLDAsMCwwLDAsMCwwLDAsMCwwLDAsMCwwLDAsMCwwLDAsMCwwLDAsMCwwLDAsMCwwLDAsMCwwLDAsMCwwLDAsMCwwLDAsMCwwLDAsMCwwLDAsMCwwLDAsMCwwLDAsMCwwLDAsMCwwLDAsMCwwLDAsMF0sImwiOjAsInEiOjYsInIiOjd9fQAAAAAAAAAAAAAAAAAAPAEAAAAAAAAHAAAAMjM4NTEuMAAqAQAAeyJ3YXNfZmlyc3RfZXZlbnQiOmZhbHNlLCJpbWFnZV9pZCI6WzE2Njg3OTMyODksODQ2NDIwOTI1LDE3NzU3NjM0MywzODM1ODczODYyLDY2MzMzNTUzLDI4OTQ1NjYwMzAsNTk4Mjc1ODE1LDI3MTgyNzg1ODBdLCJxZiI6eyJiIjpbMCwwLDAsMCwwLDAsMCwwLDAsMCwwLDAsMCwwLDAsMCwwLDAsMCwwLDAsMCwwLDAsMCwwLDAsMCwwLDAsMCwwLDAsMCwwLDAsMCwwLDAsMCwwLDAsMCwwLDAsMCwwLDAsMCwwLDAsMCwwLDAsMCwwLDAsMCwwLDAsMCwwLDAsMCwwLDAsMCwwLDAsMCwwLDAsMF0sImwiOjAsInEiOjYsInIiOjd9fQAAAAAAAAAAAAAAAAAAAAAAAAAAAAAAAAAAAAAAAAAAAAA='}}
prove_19;90;100;Mul;9000;32851;0.0;833;1.2243154589996266;{'verificationValue': 0.0, 'proof': {'imageId': [1668793289, 846420925, 177576343, 3835873862, 66333553, 2894566030, 598275815, 2718278580], 'receipt': 'AwAAAAAAAAAAAAAAFPIgAEBa/KxpnrWjLW5ZBdoVsH8Dr4kePkUNGJK+LwGcLUh4AAAAAAAAAAAAAAAAAAAAAAAAAAAAAAAAAAAAAAAAAAAAAAAAAAAAAAAAAAAAAAAAAQAAAAAAAAAAAAAAAAAAAAAAAAAAAAAAAAAAAAAAAAAAAAAAAAAAAAEAAAAAPAEAAAAAAAAHAAAAMzI4NTEuMAAqAQAAeyJ3YXNfZmlyc3RfZXZlbnQiOmZhbHNlLCJpbWFnZV9pZCI6WzE2Njg3OTMyODksODQ2NDIwOTI1LDE3NzU3NjM0MywzODM1ODczODYyLDY2MzMzNTUzLDI4OTQ1NjYwMzAsNTk4Mjc1ODE1LDI3MTgyNzg1ODBdLCJxZiI6eyJiIjpbMCwwLDAsMCwwLDAsMCwwLDAsMCwwLDAsMCwwLDAsMCwwLDAsMCwwLDAsMCwwLDAsMCwwLDAsMCwwLDAsMCwwLDAsMCwwLDAsMCwwLDAsMCwwLDAsMCwwLDAsMCwwLDAsMCwwLDAsMCwwLDAsMCwwLDAsMCwwLDAsMCwwLDAsMCwwLDAsMCwwLDAsMCwwLDAsMF0sImwiOjAsInEiOjYsInIiOjd9fQAAAAAAAAAAAAAAAAAAPAEAAAAAAAAHAAAAMzI4NTEuMAAqAQAAeyJ3YXNfZmlyc3RfZXZlbnQiOmZhbHNlLCJpbWFnZV9pZCI6WzE2Njg3OTMyODksODQ2NDIwOTI1LDE3NzU3NjM0MywzODM1ODczODYyLDY2MzMzNTUzLDI4OTQ1NjYwMzAsNTk4Mjc1ODE1LDI3MTgyNzg1ODBdLCJxZiI6eyJiIjpbMCwwLDAsMCwwLDAsMCwwLDAsMCwwLDAsMCwwLDAsMCwwLDAsMCwwLDAsMCwwLDAsMCwwLDAsMCwwLDAsMCwwLDAsMCwwLDAsMCwwLDAsMCwwLDAsMCwwLDAsMCwwLDAsMCwwLDAsMCwwLDAsMCwwLDAsMCwwLDAsMCwwLDAsMCwwLDAsMCwwLDAsMCwwLDAsMF0sImwiOjAsInEiOjYsInIiOjd9fQAAAAAAAAAAAAAAAAAAAAAAAAAAAAAAAAAAAAAAAAAAAAA='}}
prove_20;70;90;Mul;6300;39151;0.0;833;1.306938124998851;{'verificationValue': 0.0, 'proof': {'imageId': [1668793289, 846420925, 177576343, 3835873862, 66333553, 2894566030, 598275815, 2718278580], 'receipt': 'AwAAAAAAAAAAAAAAFPIgAEBa/KxpnrWjLW5ZBdoVsH8Dr4kePkUNGJK+LwGcLUh4AAAAAAAAAAAAAAAAAAAAAAAAAAAAAAAAAAAAAAAAAAAAAAAAAAAAAAAAAAAAAAAAAQAAAAAAAAAAAAAAAAAAAAAAAAAAAAAAAAAAAAAAAAAAAAAAAAAAAAEAAAAAPAEAAAAAAAAHAAAAMzkxNTEuMAAqAQAAeyJ3YXNfZmlyc3RfZXZlbnQiOmZhbHNlLCJpbWFnZV9pZCI6WzE2Njg3OTMyODksODQ2NDIwOTI1LDE3NzU3NjM0MywzODM1ODczODYyLDY2MzMzNTUzLDI4OTQ1NjYwMzAsNTk4Mjc1ODE1LDI3MTgyNzg1ODBdLCJxZiI6eyJiIjpbMCwwLDAsMCwwLDAsMCwwLDAsMCwwLDAsMCwwLDAsMCwwLDAsMCwwLDAsMCwwLDAsMCwwLDAsMCwwLDAsMCwwLDAsMCwwLDAsMCwwLDAsMCwwLDAsMCwwLDAsMCwwLDAsMCwwLDAsMCwwLDAsMCwwLDAsMCwwLDAsMCwwLDAsMCwwLDAsMCwwLDAsMCwwLDAsMF0sImwiOjAsInEiOjYsInIiOjd9fQAAAAAAAAAAAAAAAAAAPAEAAAAAAAAHAAAAMzkxNTEuMAAqAQAAeyJ3YXNfZmlyc3RfZXZlbnQiOmZhbHNlLCJpbWFnZV9pZCI6WzE2Njg3OTMyODksODQ2NDIwOTI1LDE3NzU3NjM0MywzODM1ODczODYyLDY2MzMzNTUzLDI4OTQ1NjYwMzAsNTk4Mjc1ODE1LDI3MTgyNzg1ODBdLCJxZiI6eyJiIjpbMCwwLDAsMCwwLDAsMCwwLDAsMCwwLDAsMCwwLDAsMCwwLDAsMCwwLDAsMCwwLDAsMCwwLDAsMCwwLDAsMCwwLDAsMCwwLDAsMCwwLDAsMCwwLDAsMCwwLDAsMCwwLDAsMCwwLDAsMCwwLDAsMCwwLDAsMCwwLDAsMCwwLDAsMCwwLDAsMCwwLDAsMCwwLDAsMF0sImwiOjAsInEiOjYsInIiOjd9fQAAAAAAAAAAAAAAAAAAAAAAAAAAAAAAAAAAAAAAAAAAAAA='}}
prove_21;83;87;Mul;7221;46372;0.0;833;1.3543459169995913;{'verificationValue': 0.0, 'proof': {'imageId': [1668793289, 846420925, 177576343, 3835873862, 66333553, 2894566030, 598275815, 2718278580], 'receipt': 'AwAAAAAAAAAAAAAAFPIgAEBa/KxpnrWjLW5ZBdoVsH8Dr4kePkUNGJK+LwGcLUh4AAAAAAAAAAAAAAAAAAAAAAAAAAAAAAAAAAAAAAAAAAAAAAAAAAAAAAAAAAAAAAAAAQAAAAAAAAAAAAAAAAAAAAAAAAAAAAAAAAAAAAAAAAAAAAAAAAAAAAEAAAAAPAEAAAAAAAAHAAAANDYzNzIuMAAqAQAAeyJ3YXNfZmlyc3RfZXZlbnQiOmZhbHNlLCJpbWFnZV9pZCI6WzE2Njg3OTMyODksODQ2NDIwOTI1LDE3NzU3NjM0MywzODM1ODczODYyLDY2MzMzNTUzLDI4OTQ1NjYwMzAsNTk4Mjc1ODE1LDI3MTgyNzg1ODBdLCJxZiI6eyJiIjpbMCwwLDAsMCwwLDAsMCwwLDAsMCwwLDAsMCwwLDAsMCwwLDAsMCwwLDAsMCwwLDAsMCwwLDAsMCwwLDAsMCwwLDAsMCwwLDAsMCwwLDAsMCwwLDAsMCwwLDAsMCwwLDAsMCwwLDAsMCwwLDAsMCwwLDAsMCwwLDAsMCwwLDAsMCwwLDAsMCwwLDAsMCwwLDAsMF0sImwiOjAsInEiOjYsInIiOjd9fQAAAAAAAAAAAAAAAAAAPAEAAAAAAAAHAAAANDYzNzIuMAAqAQAAeyJ3YXNfZmlyc3RfZXZlbnQiOmZhbHNlLCJpbWFnZV9pZCI6WzE2Njg3OTMyODksODQ2NDIwOTI1LDE3NzU3NjM0MywzODM1ODczODYyLDY2MzMzNTUzLDI4OTQ1NjYwMzAsNTk4Mjc1ODE1LDI3MTgyNzg1ODBdLCJxZiI6eyJiIjpbMCwwLDAsMCwwLDAsMCwwLDAsMCwwLDAsMCwwLDAsMCwwLDAsMCwwLDAsMCwwLDAsMCwwLDAsMCwwLDAsMCwwLDAsMCwwLDAsMCwwLDAsMCwwLDAsMCwwLDAsMCwwLDAsMCwwLDAsMCwwLDAsMCwwLDAsMCwwLDAsMCwwLDAsMCwwLDAsMCwwLDAsMCwwLDAsMF0sImwiOjAsInEiOjYsInIiOjd9fQAAAAAAAAAAAAAAAAAAAAAAAAAAAAAAAAAAAAAAAAAAAAA='}}
prove_22;45;42;Mul;1890;48262;0.0;833;1.4189799589985341;{'verificationValue': 0.0, 'proof': {'imageId': [1668793289, 846420925, 177576343, 3835873862, 66333553, 2894566030, 598275815, 2718278580], 'receipt': 'AwAAAAAAAAAAAAAAFPIgAEBa/KxpnrWjLW5ZBdoVsH8Dr4kePkUNGJK+LwGcLUh4AAAAAAAAAAAAAAAAAAAAAAAAAAAAAAAAAAAAAAAAAAAAAAAAAAAAAAAAAAAAAAAAAQAAAAAAAAAAAAAAAAAAAAAAAAAAAAAAAAAAAAAAAAAAAAAAAAAAAAEAAAAAPAEAAAAAAAAHAAAANDgyNjIuMAAqAQAAeyJ3YXNfZmlyc3RfZXZlbnQiOmZhbHNlLCJpbWFnZV9pZCI6WzE2Njg3OTMyODksODQ2NDIwOTI1LDE3NzU3NjM0MywzODM1ODczODYyLDY2MzMzNTUzLDI4OTQ1NjYwMzAsNTk4Mjc1ODE1LDI3MTgyNzg1ODBdLCJxZiI6eyJiIjpbMCwwLDAsMCwwLDAsMCwwLDAsMCwwLDAsMCwwLDAsMCwwLDAsMCwwLDAsMCwwLDAsMCwwLDAsMCwwLDAsMCwwLDAsMCwwLDAsMCwwLDAsMCwwLDAsMCwwLDAsMCwwLDAsMCwwLDAsMCwwLDAsMCwwLDAsMCwwLDAsMCwwLDAsMCwwLDAsMCwwLDAsMCwwLDAsMF0sImwiOjAsInEiOjYsInIiOjd9fQAAAAAAAAAAAAAAAAAAPAEAAAAAAAAHAAAANDgyNjIuMAAqAQAAeyJ3YXNfZmlyc3RfZXZlbnQiOmZhbHNlLCJpbWFnZV9pZCI6WzE2Njg3OTMyODksODQ2NDIwOTI1LDE3NzU3NjM0MywzODM1ODczODYyLDY2MzMzNTUzLDI4OTQ1NjYwMzAsNTk4Mjc1ODE1LDI3MTgyNzg1ODBdLCJxZiI6eyJiIjpbMCwwLDAsMCwwLDAsMCwwLDAsMCwwLDAsMCwwLDAsMCwwLDAsMCwwLDAsMCwwLDAsMCwwLDAsMCwwLDAsMCwwLDAsMCwwLDAsMCwwLDAsMCwwLDAsMCwwLDAsMCwwLDAsMCwwLDAsMCwwLDAsMCwwLDAsMCwwLDAsMCwwLDAsMCwwLDAsMCwwLDAsMCwwLDAsMF0sImwiOjAsInEiOjYsInIiOjd9fQAAAAAAAAAAAAAAAAAAAAAAAAAAAAAAAAAAAAAAAAAAAAA='}}
prove_23;72;68;Mul;4896;53158;0.0;833;1.5017821670007834;{'verificationValue': 0.0, 'proof': {'imageId': [1668793289, 846420925, 177576343, 3835873862, 66333553, 2894566030, 598275815, 2718278580], 'receipt': 'AwAAAAAAAAAAAAAAFPIgAEBa/KxpnrWjLW5ZBdoVsH8Dr4kePkUNGJK+LwGcLUh4AAAAAAAAAAAAAAAAAAAAAAAAAAAAAAAAAAAAAAAAAAAAAAAAAAAAAAAAAAAAAAAAAQAAAAAAAAAAAAAAAAAAAAAAAAAAAAAAAAAAAAAAAAAAAAAAAAAAAAEAAAAAPAEAAAAAAAAHAAAANTMxNTguMAAqAQAAeyJ3YXNfZmlyc3RfZXZlbnQiOmZhbHNlLCJpbWFnZV9pZCI6WzE2Njg3OTMyODksODQ2NDIwOTI1LDE3NzU3NjM0MywzODM1ODczODYyLDY2MzMzNTUzLDI4OTQ1NjYwMzAsNTk4Mjc1ODE1LDI3MTgyNzg1ODBdLCJxZiI6eyJiIjpbMCwwLDAsMCwwLDAsMCwwLDAsMCwwLDAsMCwwLDAsMCwwLDAsMCwwLDAsMCwwLDAsMCwwLDAsMCwwLDAsMCwwLDAsMCwwLDAsMCwwLDAsMCwwLDAsMCwwLDAsMCwwLDAsMCwwLDAsMCwwLDAsMCwwLDAsMCwwLDAsMCwwLDAsMCwwLDAsMCwwLDAsMCwwLDAsMF0sImwiOjAsInEiOjYsInIiOjd9fQAAAAAAAAAAAAAAAAAAPAEAAAAAAAAHAAAANTMxNTguMAAqAQAAeyJ3YXNfZmlyc3RfZXZlbnQiOmZhbHNlLCJpbWFnZV9pZCI6WzE2Njg3OTMyODksODQ2NDIwOTI1LDE3NzU3NjM0MywzODM1ODczODYyLDY2MzMzNTUzLDI4OTQ1NjYwMzAsNTk4Mjc1ODE1LDI3MTgyNzg1ODBdLCJxZiI6eyJiIjpbMCwwLDAsMCwwLDAsMCwwLDAsMCwwLDAsMCwwLDAsMCwwLDAsMCwwLDAsMCwwLDAsMCwwLDAsMCwwLDAsMCwwLDAsMCwwLDAsMCwwLDAsMCwwLDAsMCwwLDAsMCwwLDAsMCwwLDAsMCwwLDAsMCwwLDAsMCwwLDAsMCwwLDAsMCwwLDAsMCwwLDAsMCwwLDAsMF0sImwiOjAsInEiOjYsInIiOjd9fQAAAAAAAAAAAAAAAAAAAAAAAAAAAAAAAAAAAAAAAAAAAAA='}}
prove_24;48;75;Mul;3600;56758;0.0;833;1.552468667001449;{'verificationValue': 0.0, 'proof': {'imageId': [1668793289, 846420925, 177576343, 3835873862, 66333553, 2894566030, 598275815, 2718278580], 'receipt': 'AwAAAAAAAAAAAAAAFPIgAEBa/KxpnrWjLW5ZBdoVsH8Dr4kePkUNGJK+LwGcLUh4AAAAAAAAAAAAAAAAAAAAAAAAAAAAAAAAAAAAAAAAAAAAAAAAAAAAAAAAAAAAAAAAAQAAAAAAAAAAAAAAAAAAAAAAAAAAAAAAAAAAAAAAAAAAAAAAAAAAAAEAAAAAPAEAAAAAAAAHAAAANTY3NTguMAAqAQAAeyJ3YXNfZmlyc3RfZXZlbnQiOmZhbHNlLCJpbWFnZV9pZCI6WzE2Njg3OTMyODksODQ2NDIwOTI1LDE3NzU3NjM0MywzODM1ODczODYyLDY2MzMzNTUzLDI4OTQ1NjYwMzAsNTk4Mjc1ODE1LDI3MTgyNzg1ODBdLCJxZiI6eyJiIjpbMCwwLDAsMCwwLDAsMCwwLDAsMCwwLDAsMCwwLDAsMCwwLDAsMCwwLDAsMCwwLDAsMCwwLDAsMCwwLDAsMCwwLDAsMCwwLDAsMCwwLDAsMCwwLDAsMCwwLDAsMCwwLDAsMCwwLDAsMCwwLDAsMCwwLDAsMCwwLDAsMCwwLDAsMCwwLDAsMCwwLDAsMCwwLDAsMF0sImwiOjAsInEiOjYsInIiOjd9fQAAAAAAAAAAAAAAAAAAPAEAAAAAAAAHAAAANTY3NTguMAAqAQAAeyJ3YXNfZmlyc3RfZXZlbnQiOmZhbHNlLCJpbWFnZV9pZCI6WzE2Njg3OTMyODksODQ2NDIwOTI1LDE3NzU3NjM0MywzODM1ODczODYyLDY2MzMzNTUzLDI4OTQ1NjYwMzAsNTk4Mjc1ODE1LDI3MTgyNzg1ODBdLCJxZiI6eyJiIjpbMCwwLDAsMCwwLDAsMCwwLDAsMCwwLDAsMCwwLDAsMCwwLDAsMCwwLDAsMCwwLDAsMCwwLDAsMCwwLDAsMCwwLDAsMCwwLDAsMCwwLDAsMCwwLDAsMCwwLDAsMCwwLDAsMCwwLDAsMCwwLDAsMCwwLDAsMCwwLDAsMCwwLDAsMCwwLDAsMCwwLDAsMCwwLDAsMF0sImwiOjAsInEiOjYsInIiOjd9fQAAAAAAAAAAAAAAAAAAAAAAAAAAAAAAAAAAAAAAAAAAAAA='}}
prove_25;23;45;Mul;1035;57793;0.0;833;1.618285915999877;{'verificationValue': 0.0, 'proof': {'imageId': [1668793289, 846420925, 177576343, 3835873862, 66333553, 2894566030, 598275815, 2718278580], 'receipt': 'AwAAAAAAAAAAAAAAFPIgAEBa/KxpnrWjLW5ZBdoVsH8Dr4kePkUNGJK+LwGcLUh4AAAAAAAAAAAAAAAAAAAAAAAAAAAAAAAAAAAAAAAAAAAAAAAAAAAAAAAAAAAAAAAAAQAAAAAAAAAAAAAAAAAAAAAAAAAAAAAAAAAAAAAAAAAAAAAAAAAAAAEAAAAAPAEAAAAAAAAHAAAANTc3OTMuMAAqAQAAeyJ3YXNfZmlyc3RfZXZlbnQiOmZhbHNlLCJpbWFnZV9pZCI6WzE2Njg3OTMyODksODQ2NDIwOTI1LDE3NzU3NjM0MywzODM1ODczODYyLDY2MzMzNTUzLDI4OTQ1NjYwMzAsNTk4Mjc1ODE1LDI3MTgyNzg1ODBdLCJxZiI6eyJiIjpbMCwwLDAsMCwwLDAsMCwwLDAsMCwwLDAsMCwwLDAsMCwwLDAsMCwwLDAsMCwwLDAsMCwwLDAsMCwwLDAsMCwwLDAsMCwwLDAsMCwwLDAsMCwwLDAsMCwwLDAsMCwwLDAsMCwwLDAsMCwwLDAsMCwwLDAsMCwwLDAsMCwwLDAsMCwwLDAsMCwwLDAsMCwwLDAsMF0sImwiOjAsInEiOjYsInIiOjd9fQAAAAAAAAAAAAAAAAAAPAEAAAAAAAAHAAAANTc3OTMuMAAqAQAAeyJ3YXNfZmlyc3RfZXZlbnQiOmZhbHNlLCJpbWFnZV9pZCI6WzE2Njg3OTMyODksODQ2NDIwOTI1LDE3NzU3NjM0MywzODM1ODczODYyLDY2MzMzNTUzLDI4OTQ1NjYwMzAsNTk4Mjc1ODE1LDI3MTgyNzg1ODBdLCJxZiI6eyJiIjpbMCwwLDAsMCwwLDAsMCwwLDAsMCwwLDAsMCwwLDAsMCwwLDAsMCwwLDAsMCwwLDAsMCwwLDAsMCwwLDAsMCwwLDAsMCwwLDAsMCwwLDAsMCwwLDAsMCwwLDAsMCwwLDAsMCwwLDAsMCwwLDAsMCwwLDAsMCwwLDAsMCwwLDAsMCwwLDAsMCwwLDAsMCwwLDAsMF0sImwiOjAsInEiOjYsInIiOjd9fQAAAAAAAAAAAAAAAAAAAAAAAAAAAAAAAAAAAAAAAAAAAAA='}}
prove_26;37;31;Mul;1147;58940;0.0;833;1.6958603749990289;{'verificationValue': 0.0, 'proof': {'imageId': [1668793289, 846420925, 177576343, 3835873862, 66333553, 2894566030, 598275815, 2718278580], 'receipt': 'AwAAAAAAAAAAAAAAFPIgAEBa/KxpnrWjLW5ZBdoVsH8Dr4kePkUNGJK+LwGcLUh4AAAAAAAAAAAAAAAAAAAAAAAAAAAAAAAAAAAAAAAAAAAAAAAAAAAAAAAAAAAAAAAAAQAAAAAAAAAAAAAAAAAAAAAAAAAAAAAAAAAAAAAAAAAAAAAAAAAAAAEAAAAAPAEAAAAAAAAHAAAANTg5NDAuMAAqAQAAeyJ3YXNfZmlyc3RfZXZlbnQiOmZhbHNlLCJpbWFnZV9pZCI6WzE2Njg3OTMyODksODQ2NDIwOTI1LDE3NzU3NjM0MywzODM1ODczODYyLDY2MzMzNTUzLDI4OTQ1NjYwMzAsNTk4Mjc1ODE1LDI3MTgyNzg1ODBdLCJxZiI6eyJiIjpbMCwwLDAsMCwwLDAsMCwwLDAsMCwwLDAsMCwwLDAsMCwwLDAsMCwwLDAsMCwwLDAsMCwwLDAsMCwwLDAsMCwwLDAsMCwwLDAsMCwwLDAsMCwwLDAsMCwwLDAsMCwwLDAsMCwwLDAsMCwwLDAsMCwwLDAsMCwwLDAsMCwwLDAsMCwwLDAsMCwwLDAsMCwwLDAsMF0sImwiOjAsInEiOjYsInIiOjd9fQAAAAAAAAAAAAAAAAAAPAEAAAAAAAAHAAAANTg5NDAuMAAqAQAAeyJ3YXNfZmlyc3RfZXZlbnQiOmZhbHNlLCJpbWFnZV9pZCI6WzE2Njg3OTMyODksODQ2NDIwOTI1LDE3NzU3NjM0MywzODM1ODczODYyLDY2MzMzNTUzLDI4OTQ1NjYwMzAsNTk4Mjc1ODE1LDI3MTgyNzg1ODBdLCJxZiI6eyJiIjpbMCwwLDAsMCwwLDAsMCwwLDAsMCwwLDAsMCwwLDAsMCwwLDAsMCwwLDAsMCwwLDAsMCwwLDAsMCwwLDAsMCwwLDAsMCwwLDAsMCwwLDAsMCwwLDAsMCwwLDAsMCwwLDAsMCwwLDAsMCwwLDAsMCwwLDAsMCwwLDAsMCwwLDAsMCwwLDAsMCwwLDAsMCwwLDAsMF0sImwiOjAsInEiOjYsInIiOjd9fQAAAAAAAAAAAAAAAAAAAAAAAAAAAAAAAAAAAAAAAAAAAAA='}}
prove_27;16;16;Mul;256;59196;0.0;833;1.7770331249994342;{'verificationValue': 0.0, 'proof': {'imageId': [1668793289, 846420925, 177576343, 3835873862, 66333553, 2894566030, 598275815, 2718278580], 'receipt': 'AwAAAAAAAAAAAAAAFPIgAEBa/KxpnrWjLW5ZBdoVsH8Dr4kePkUNGJK+LwGcLUh4AAAAAAAAAAAAAAAAAAAAAAAAAAAAAAAAAAAAAAAAAAAAAAAAAAAAAAAAAAAAAAAAAQAAAAAAAAAAAAAAAAAAAAAAAAAAAAAAAAAAAAAAAAAAAAAAAAAAAAEAAAAAPAEAAAAAAAAHAAAANTkxOTYuMAAqAQAAeyJ3YXNfZmlyc3RfZXZlbnQiOmZhbHNlLCJpbWFnZV9pZCI6WzE2Njg3OTMyODksODQ2NDIwOTI1LDE3NzU3NjM0MywzODM1ODczODYyLDY2MzMzNTUzLDI4OTQ1NjYwMzAsNTk4Mjc1ODE1LDI3MTgyNzg1ODBdLCJxZiI6eyJiIjpbMCwwLDAsMCwwLDAsMCwwLDAsMCwwLDAsMCwwLDAsMCwwLDAsMCwwLDAsMCwwLDAsMCwwLDAsMCwwLDAsMCwwLDAsMCwwLDAsMCwwLDAsMCwwLDAsMCwwLDAsMCwwLDAsMCwwLDAsMCwwLDAsMCwwLDAsMCwwLDAsMCwwLDAsMCwwLDAsMCwwLDAsMCwwLDAsMF0sImwiOjAsInEiOjYsInIiOjd9fQAAAAAAAAAAAAAAAAAAPAEAAAAAAAAHAAAANTkxOTYuMAAqAQAAeyJ3YXNfZmlyc3RfZXZlbnQiOmZhbHNlLCJpbWFnZV9pZCI6WzE2Njg3OTMyODksODQ2NDIwOTI1LDE3NzU3NjM0MywzODM1ODczODYyLDY2MzMzNTUzLDI4OTQ1NjYwMzAsNTk4Mjc1ODE1LDI3MTgyNzg1ODBdLCJxZiI6eyJiIjpbMCwwLDAsMCwwLDAsMCwwLDAsMCwwLDAsMCwwLDAsMCwwLDAsMCwwLDAsMCwwLDAsMCwwLDAsMCwwLDAsMCwwLDAsMCwwLDAsMCwwLDAsMCwwLDAsMCwwLDAsMCwwLDAsMCwwLDAsMCwwLDAsMCwwLDAsMCwwLDAsMCwwLDAsMCwwLDAsMCwwLDAsMCwwLDAsMF0sImwiOjAsInEiOjYsInIiOjd9fQAAAAAAAAAAAAAAAAAAAAAAAAAAAAAAAAAAAAAAAAAAAAA='}}
prove_28;39;37;Mul;1443;60639;0.0;833;1.8269124579983327;{'verificationValue': 0.0, 'proof': {'imageId': [1668793289, 846420925, 177576343, 3835873862, 66333553, 2894566030, 598275815, 2718278580], 'receipt': 'AwAAAAAAAAAAAAAAFPIgAEBa/KxpnrWjLW5ZBdoVsH8Dr4kePkUNGJK+LwGcLUh4AAAAAAAAAAAAAAAAAAAAAAAAAAAAAAAAAAAAAAAAAAAAAAAAAAAAAAAAAAAAAAAAAQAAAAAAAAAAAAAAAAAAAAAAAAAAAAAAAAAAAAAAAAAAAAAAAAAAAAEAAAAAPAEAAAAAAAAHAAAANjA2MzkuMAAqAQAAeyJ3YXNfZmlyc3RfZXZlbnQiOmZhbHNlLCJpbWFnZV9pZCI6WzE2Njg3OTMyODksODQ2NDIwOTI1LDE3NzU3NjM0MywzODM1ODczODYyLDY2MzMzNTUzLDI4OTQ1NjYwMzAsNTk4Mjc1ODE1LDI3MTgyNzg1ODBdLCJxZiI6eyJiIjpbMCwwLDAsMCwwLDAsMCwwLDAsMCwwLDAsMCwwLDAsMCwwLDAsMCwwLDAsMCwwLDAsMCwwLDAsMCwwLDAsMCwwLDAsMCwwLDAsMCwwLDAsMCwwLDAsMCwwLDAsMCwwLDAsMCwwLDAsMCwwLDAsMCwwLDAsMCwwLDAsMCwwLDAsMCwwLDAsMCwwLDAsMCwwLDAsMF0sImwiOjAsInEiOjYsInIiOjd9fQAAAAAAAAAAAAAAAAAAPAEAAAAAAAAHAAAANjA2MzkuMAAqAQAAeyJ3YXNfZmlyc3RfZXZlbnQiOmZhbHNlLCJpbWFnZV9pZCI6WzE2Njg3OTMyODksODQ2NDIwOTI1LDE3NzU3NjM0MywzODM1ODczODYyLDY2MzMzNTUzLDI4OTQ1NjYwMzAsNTk4Mjc1ODE1LDI3MTgyNzg1ODBdLCJxZiI6eyJiIjpbMCwwLDAsMCwwLDAsMCwwLDAsMCwwLDAsMCwwLDAsMCwwLDAsMCwwLDAsMCwwLDAsMCwwLDAsMCwwLDAsMCwwLDAsMCwwLDAsMCwwLDAsMCwwLDAsMCwwLDAsMCwwLDAsMCwwLDAsMCwwLDAsMCwwLDAsMCwwLDAsMCwwLDAsMCwwLDAsMCwwLDAsMCwwLDAsMF0sImwiOjAsInEiOjYsInIiOjd9fQAAAAAAAAAAAAAAAAAAAAAAAAAAAAAAAAAAAAAAAAAAAAA='}}
prove_29;84;18;Mul;1512;62151;0.0;833;1.909840083000745;{'verificationValue': 0.0, 'proof': {'imageId': [1668793289, 846420925, 177576343, 3835873862, 66333553, 2894566030, 598275815, 2718278580], 'receipt': 'AwAAAAAAAAAAAAAAFPIgAEBa/KxpnrWjLW5ZBdoVsH8Dr4kePkUNGJK+LwGcLUh4AAAAAAAAAAAAAAAAAAAAAAAAAAAAAAAAAAAAAAAAAAAAAAAAAAAAAAAAAAAAAAAAAQAAAAAAAAAAAAAAAAAAAAAAAAAAAAAAAAAAAAAAAAAAAAAAAAAAAAEAAAAAPAEAAAAAAAAHAAAANjIxNTEuMAAqAQAAeyJ3YXNfZmlyc3RfZXZlbnQiOmZhbHNlLCJpbWFnZV9pZCI6WzE2Njg3OTMyODksODQ2NDIwOTI1LDE3NzU3NjM0MywzODM1ODczODYyLDY2MzMzNTUzLDI4OTQ1NjYwMzAsNTk4Mjc1ODE1LDI3MTgyNzg1ODBdLCJxZiI6eyJiIjpbMCwwLDAsMCwwLDAsMCwwLDAsMCwwLDAsMCwwLDAsMCwwLDAsMCwwLDAsMCwwLDAsMCwwLDAsMCwwLDAsMCwwLDAsMCwwLDAsMCwwLDAsMCwwLDAsMCwwLDAsMCwwLDAsMCwwLDAsMCwwLDAsMCwwLDAsMCwwLDAsMCwwLDAsMCwwLDAsMCwwLDAsMCwwLDAsMF0sImwiOjAsInEiOjYsInIiOjd9fQAAAAAAAAAAAAAAAAAAPAEAAAAAAAAHAAAANjIxNTEuMAAqAQAAeyJ3YXNfZmlyc3RfZXZlbnQiOmZhbHNlLCJpbWFnZV9pZCI6WzE2Njg3OTMyODksODQ2NDIwOTI1LDE3NzU3NjM0MywzODM1ODczODYyLDY2MzMzNTUzLDI4OTQ1NjYwMzAsNTk4Mjc1ODE1LDI3MTgyNzg1ODBdLCJxZiI6eyJiIjpbMCwwLDAsMCwwLDAsMCwwLDAsMCwwLDAsMCwwLDAsMCwwLDAsMCwwLDAsMCwwLDAsMCwwLDAsMCwwLDAsMCwwLDAsMCwwLDAsMCwwLDAsMCwwLDAsMCwwLDAsMCwwLDAsMCwwLDAsMCwwLDAsMCwwLDAsMCwwLDAsMCwwLDAsMCwwLDAsMCwwLDAsMCwwLDAsMF0sImwiOjAsInEiOjYsInIiOjd9fQAAAAAAAAAAAAAAAAAAAAAAAAAAAAAAAAAAAAAAAAAAAAA='}}
prove_30;14;59;Mul;826;62977;0.0;833;1.9652667079990351;{'verificationValue': 0.0, 'proof': {'imageId': [1668793289, 846420925, 177576343, 3835873862, 66333553, 2894566030, 598275815, 2718278580], 'receipt': 'AwAAAAAAAAAAAAAAFPIgAEBa/KxpnrWjLW5ZBdoVsH8Dr4kePkUNGJK+LwGcLUh4AAAAAAAAAAAAAAAAAAAAAAAAAAAAAAAAAAAAAAAAAAAAAAAAAAAAAAAAAAAAAAAAAQAAAAAAAAAAAAAAAAAAAAAAAAAAAAAAAAAAAAAAAAAAAAAAAAAAAAEAAAAAPAEAAAAAAAAHAAAANjI5NzcuMAAqAQAAeyJ3YXNfZmlyc3RfZXZlbnQiOmZhbHNlLCJpbWFnZV9pZCI6WzE2Njg3OTMyODksODQ2NDIwOTI1LDE3NzU3NjM0MywzODM1ODczODYyLDY2MzMzNTUzLDI4OTQ1NjYwMzAsNTk4Mjc1ODE1LDI3MTgyNzg1ODBdLCJxZiI6eyJiIjpbMCwwLDAsMCwwLDAsMCwwLDAsMCwwLDAsMCwwLDAsMCwwLDAsMCwwLDAsMCwwLDAsMCwwLDAsMCwwLDAsMCwwLDAsMCwwLDAsMCwwLDAsMCwwLDAsMCwwLDAsMCwwLDAsMCwwLDAsMCwwLDAsMCwwLDAsMCwwLDAsMCwwLDAsMCwwLDAsMCwwLDAsMCwwLDAsMF0sImwiOjAsInEiOjYsInIiOjd9fQAAAAAAAAAAAAAAAAAAPAEAAAAAAAAHAAAANjI5NzcuMAAqAQAAeyJ3YXNfZmlyc3RfZXZlbnQiOmZhbHNlLCJpbWFnZV9pZCI6WzE2Njg3OTMyODksODQ2NDIwOTI1LDE3NzU3NjM0MywzODM1ODczODYyLDY2MzMzNTUzLDI4OTQ1NjYwMzAsNTk4Mjc1ODE1LDI3MTgyNzg1ODBdLCJxZiI6eyJiIjpbMCwwLDAsMCwwLDAsMCwwLDAsMCwwLDAsMCwwLDAsMCwwLDAsMCwwLDAsMCwwLDAsMCwwLDAsMCwwLDAsMCwwLDAsMCwwLDAsMCwwLDAsMCwwLDAsMCwwLDAsMCwwLDAsMCwwLDAsMCwwLDAsMCwwLDAsMCwwLDAsMCwwLDAsMCwwLDAsMCwwLDAsMCwwLDAsMF0sImwiOjAsInEiOjYsInIiOjd9fQAAAAAAAAAAAAAAAAAAAAAAAAAAAAAAAAAAAAAAAAAAAAA='}}
prove_31;26;59;Mul;1534;64511;0.0;833;2.0694042920003994;{'verificationValue': 0.0, 'proof': {'imageId': [1668793289, 846420925, 177576343, 3835873862, 66333553, 2894566030, 598275815, 2718278580], 'receipt': 'AwAAAAAAAAAAAAAAFPIgAEBa/KxpnrWjLW5ZBdoVsH8Dr4kePkUNGJK+LwGcLUh4AAAAAAAAAAAAAAAAAAAAAAAAAAAAAAAAAAAAAAAAAAAAAAAAAAAAAAAAAAAAAAAAAQAAAAAAAAAAAAAAAAAAAAAAAAAAAAAAAAAAAAAAAAAAAAAAAAAAAAEAAAAAPAEAAAAAAAAHAAAANjQ1MTEuMAAqAQAAeyJ3YXNfZmlyc3RfZXZlbnQiOmZhbHNlLCJpbWFnZV9pZCI6WzE2Njg3OTMyODksODQ2NDIwOTI1LDE3NzU3NjM0MywzODM1ODczODYyLDY2MzMzNTUzLDI4OTQ1NjYwMzAsNTk4Mjc1ODE1LDI3MTgyNzg1ODBdLCJxZiI6eyJiIjpbMCwwLDAsMCwwLDAsMCwwLDAsMCwwLDAsMCwwLDAsMCwwLDAsMCwwLDAsMCwwLDAsMCwwLDAsMCwwLDAsMCwwLDAsMCwwLDAsMCwwLDAsMCwwLDAsMCwwLDAsMCwwLDAsMCwwLDAsMCwwLDAsMCwwLDAsMCwwLDAsMCwwLDAsMCwwLDAsMCwwLDAsMCwwLDAsMF0sImwiOjAsInEiOjYsInIiOjd9fQAAAAAAAAAAAAAAAAAAPAEAAAAAAAAHAAAANjQ1MTEuMAAqAQAAeyJ3YXNfZmlyc3RfZXZlbnQiOmZhbHNlLCJpbWFnZV9pZCI6WzE2Njg3OTMyODksODQ2NDIwOTI1LDE3NzU3NjM0MywzODM1ODczODYyLDY2MzMzNTUzLDI4OTQ1NjYwMzAsNTk4Mjc1ODE1LDI3MTgyNzg1ODBdLCJxZiI6eyJiIjpbMCwwLDAsMCwwLDAsMCwwLDAsMCwwLDAsMCwwLDAsMCwwLDAsMCwwLDAsMCwwLDAsMCwwLDAsMCwwLDAsMCwwLDAsMCwwLDAsMCwwLDAsMCwwLDAsMCwwLDAsMCwwLDAsMCwwLDAsMCwwLDAsMCwwLDAsMCwwLDAsMCwwLDAsMCwwLDAsMCwwLDAsMCwwLDAsMF0sImwiOjAsInEiOjYsInIiOjd9fQAAAAAAAAAAAAAAAAAAAAAAAAAAAAAAAAAAAAAAAAAAAAA='}}
prove_32;40;54;Mul;2160;66671;0.0;833;2.111776124998869;{'verificationValue': 0.0, 'proof': {'imageId': [1668793289, 846420925, 177576343, 3835873862, 66333553, 2894566030, 598275815, 2718278580], 'receipt': 'AwAAAAAAAAAAAAAAFPIgAEBa/KxpnrWjLW5ZBdoVsH8Dr4kePkUNGJK+LwGcLUh4AAAAAAAAAAAAAAAAAAAAAAAAAAAAAAAAAAAAAAAAAAAAAAAAAAAAAAAAAAAAAAAAAQAAAAAAAAAAAAAAAAAAAAAAAAAAAAAAAAAAAAAAAAAAAAAAAAAAAAEAAAAAPAEAAAAAAAAHAAAANjY2NzEuMAAqAQAAeyJ3YXNfZmlyc3RfZXZlbnQiOmZhbHNlLCJpbWFnZV9pZCI6WzE2Njg3OTMyODksODQ2NDIwOTI1LDE3NzU3NjM0MywzODM1ODczODYyLDY2MzMzNTUzLDI4OTQ1NjYwMzAsNTk4Mjc1ODE1LDI3MTgyNzg1ODBdLCJxZiI6eyJiIjpbMCwwLDAsMCwwLDAsMCwwLDAsMCwwLDAsMCwwLDAsMCwwLDAsMCwwLDAsMCwwLDAsMCwwLDAsMCwwLDAsMCwwLDAsMCwwLDAsMCwwLDAsMCwwLDAsMCwwLDAsMCwwLDAsMCwwLDAsMCwwLDAsMCwwLDAsMCwwLDAsMCwwLDAsMCwwLDAsMCwwLDAsMCwwLDAsMF0sImwiOjAsInEiOjYsInIiOjd9fQAAAAAAAAAAAAAAAAAAPAEAAAAAAAAHAAAANjY2NzEuMAAqAQAAeyJ3YXNfZmlyc3RfZXZlbnQiOmZhbHNlLCJpbWFnZV9pZCI6WzE2Njg3OTMyODksODQ2NDIwOTI1LDE3NzU3NjM0MywzODM1ODczODYyLDY2MzMzNTUzLDI4OTQ1NjYwMzAsNTk4Mjc1ODE1LDI3MTgyNzg1ODBdLCJxZiI6eyJiIjpbMCwwLDAsMCwwLDAsMCwwLDAsMCwwLDAsMCwwLDAsMCwwLDAsMCwwLDAsMCwwLDAsMCwwLDAsMCwwLDAsMCwwLDAsMCwwLDAsMCwwLDAsMCwwLDAsMCwwLDAsMCwwLDAsMCwwLDAsMCwwLDAsMCwwLDAsMCwwLDAsMCwwLDAsMCwwLDAsMCwwLDAsMCwwLDAsMF0sImwiOjAsInEiOjYsInIiOjd9fQAAAAAAAAAAAAAAAAAAAAAAAAAAAAAAAAAAAAAAAAAAAAA='}}
prove_33;27;83;Mul;2241;68912;0.0;833;2.179747125001086;{'verificationValue': 0.0, 'proof': {'imageId': [1668793289, 846420925, 177576343, 3835873862, 66333553, 2894566030, 598275815, 2718278580], 'receipt': 'AwAAAAAAAAAAAAAAFPIgAEBa/KxpnrWjLW5ZBdoVsH8Dr4kePkUNGJK+LwGcLUh4AAAAAAAAAAAAAAAAAAAAAAAAAAAAAAAAAAAAAAAAAAAAAAAAAAAAAAAAAAAAAAAAAQAAAAAAAAAAAAAAAAAAAAAAAAAAAAAAAAAAAAAAAAAAAAAAAAAAAAEAAAAAPAEAAAAAAAAHAAAANjg5MTIuMAAqAQAAeyJ3YXNfZmlyc3RfZXZlbnQiOmZhbHNlLCJpbWFnZV9pZCI6WzE2Njg3OTMyODksODQ2NDIwOTI1LDE3NzU3NjM0MywzODM1ODczODYyLDY2MzMzNTUzLDI4OTQ1NjYwMzAsNTk4Mjc1ODE1LDI3MTgyNzg1ODBdLCJxZiI6eyJiIjpbMCwwLDAsMCwwLDAsMCwwLDAsMCwwLDAsMCwwLDAsMCwwLDAsMCwwLDAsMCwwLDAsMCwwLDAsMCwwLDAsMCwwLDAsMCwwLDAsMCwwLDAsMCwwLDAsMCwwLDAsMCwwLDAsMCwwLDAsMCwwLDAsMCwwLDAsMCwwLDAsMCwwLDAsMCwwLDAsMCwwLDAsMCwwLDAsMF0sImwiOjAsInEiOjYsInIiOjd9fQAAAAAAAAAAAAAAAAAAPAEAAAAAAAAHAAAANjg5MTIuMAAqAQAAeyJ3YXNfZmlyc3RfZXZlbnQiOmZhbHNlLCJpbWFnZV9pZCI6WzE2Njg3OTMyODksODQ2NDIwOTI1LDE3NzU3NjM0MywzODM1ODczODYyLDY2MzMzNTUzLDI4OTQ1NjYwMzAsNTk4Mjc1ODE1LDI3MTgyNzg1ODBdLCJxZiI6eyJiIjpbMCwwLDAsMCwwLDAsMCwwLDAsMCwwLDAsMCwwLDAsMCwwLDAsMCwwLDAsMCwwLDAsMCwwLDAsMCwwLDAsMCwwLDAsMCwwLDAsMCwwLDAsMCwwLDAsMCwwLDAsMCwwLDAsMCwwLDAsMCwwLDAsMCwwLDAsMCwwLDAsMCwwLDAsMCwwLDAsMCwwLDAsMCwwLDAsMF0sImwiOjAsInEiOjYsInIiOjd9fQAAAAAAAAAAAAAAAAAAAAAAAAAAAAAAAAAAAAAAAAAAAAA='}}
prove_34;55;20;Mul;1100;70012;0.0;833;2.2810048749997804;{'verificationValue': 0.0, 'proof': {'imageId': [1668793289, 846420925, 177576343, 3835873862, 66333553, 2894566030, 598275815, 2718278580], 'receipt': 'AwAAAAAAAAAAAAAAFPIgAEBa/KxpnrWjLW5ZBdoVsH8Dr4kePkUNGJK+LwGcLUh4AAAAAAAAAAAAAAAAAAAAAAAAAAAAAAAAAAAAAAAAAAAAAAAAAAAAAAAAAAAAAAAAAQAAAAAAAAAAAAAAAAAAAAAAAAAAAAAAAAAAAAAAAAAAAAAAAAAAAAEAAAAAPAEAAAAAAAAHAAAANzAwMTIuMAAqAQAAeyJ3YXNfZmlyc3RfZXZlbnQiOmZhbHNlLCJpbWFnZV9pZCI6WzE2Njg3OTMyODksODQ2NDIwOTI1LDE3NzU3NjM0MywzODM1ODczODYyLDY2MzMzNTUzLDI4OTQ1NjYwMzAsNTk4Mjc1ODE1LDI3MTgyNzg1ODBdLCJxZiI6eyJiIjpbMCwwLDAsMCwwLDAsMCwwLDAsMCwwLDAsMCwwLDAsMCwwLDAsMCwwLDAsMCwwLDAsMCwwLDAsMCwwLDAsMCwwLDAsMCwwLDAsMCwwLDAsMCwwLDAsMCwwLDAsMCwwLDAsMCwwLDAsMCwwLDAsMCwwLDAsMCwwLDAsMCwwLDAsMCwwLDAsMCwwLDAsMCwwLDAsMF0sImwiOjAsInEiOjYsInIiOjd9fQAAAAAAAAAAAAAAAAAAPAEAAAAAAAAHAAAANzAwMTIuMAAqAQAAeyJ3YXNfZmlyc3RfZXZlbnQiOmZhbHNlLCJpbWFnZV9pZCI6WzE2Njg3OTMyODksODQ2NDIwOTI1LDE3NzU3NjM0MywzODM1ODczODYyLDY2MzMzNTUzLDI4OTQ1NjYwMzAsNTk4Mjc1ODE1LDI3MTgyNzg1ODBdLCJxZiI6eyJiIjpbMCwwLDAsMCwwLDAsMCwwLDAsMCwwLDAsMCwwLDAsMCwwLDAsMCwwLDAsMCwwLDAsMCwwLDAsMCwwLDAsMCwwLDAsMCwwLDAsMCwwLDAsMCwwLDAsMCwwLDAsMCwwLDAsMCwwLDAsMCwwLDAsMCwwLDAsMCwwLDAsMCwwLDAsMCwwLDAsMCwwLDAsMCwwLDAsMF0sImwiOjAsInEiOjYsInIiOjd9fQAAAAAAAAAAAAAAAAAAAAAAAAAAAAAAAAAAAAAAAAAAAAA='}}
prove_35;26;98;Mul;2548;72560;0.0;833;2.34176991700042;{'verificationValue': 0.0, 'proof': {'imageId': [1668793289, 846420925, 177576343, 3835873862, 66333553, 2894566030, 598275815, 2718278580], 'receipt': 'AwAAAAAAAAAAAAAAFPIgAEBa/KxpnrWjLW5ZBdoVsH8Dr4kePkUNGJK+LwGcLUh4AAAAAAAAAAAAAAAAAAAAAAAAAAAAAAAAAAAAAAAAAAAAAAAAAAAAAAAAAAAAAAAAAQAAAAAAAAAAAAAAAAAAAAAAAAAAAAAAAAAAAAAAAAAAAAAAAAAAAAEAAAAAPAEAAAAAAAAHAAAANzI1NjAuMAAqAQAAeyJ3YXNfZmlyc3RfZXZlbnQiOmZhbHNlLCJpbWFnZV9pZCI6WzE2Njg3OTMyODksODQ2NDIwOTI1LDE3NzU3NjM0MywzODM1ODczODYyLDY2MzMzNTUzLDI4OTQ1NjYwMzAsNTk4Mjc1ODE1LDI3MTgyNzg1ODBdLCJxZiI6eyJiIjpbMCwwLDAsMCwwLDAsMCwwLDAsMCwwLDAsMCwwLDAsMCwwLDAsMCwwLDAsMCwwLDAsMCwwLDAsMCwwLDAsMCwwLDAsMCwwLDAsMCwwLDAsMCwwLDAsMCwwLDAsMCwwLDAsMCwwLDAsMCwwLDAsMCwwLDAsMCwwLDAsMCwwLDAsMCwwLDAsMCwwLDAsMCwwLDAsMF0sImwiOjAsInEiOjYsInIiOjd9fQAAAAAAAAAAAAAAAAAAPAEAAAAAAAAHAAAANzI1NjAuMAAqAQAAeyJ3YXNfZmlyc3RfZXZlbnQiOmZhbHNlLCJpbWFnZV9pZCI6WzE2Njg3OTMyODksODQ2NDIwOTI1LDE3NzU3NjM0MywzODM1ODczODYyLDY2MzMzNTUzLDI4OTQ1NjYwMzAsNTk4Mjc1ODE1LDI3MTgyNzg1ODBdLCJxZiI6eyJiIjpbMCwwLDAsMCwwLDAsMCwwLDAsMCwwLDAsMCwwLDAsMCwwLDAsMCwwLDAsMCwwLDAsMCwwLDAsMCwwLDAsMCwwLDAsMCwwLDAsMCwwLDAsMCwwLDAsMCwwLDAsMCwwLDAsMCwwLDAsMCwwLDAsMCwwLDAsMCwwLDAsMCwwLDAsMCwwLDAsMCwwLDAsMCwwLDAsMF0sImwiOjAsInEiOjYsInIiOjd9fQAAAAAAAAAAAAAAAAAAAAAAAAAAAAAAAAAAAAAAAAAAAAA='}}
prove_36;32;60;Mul;1920;74480;0.0;833;2.384139249999862;{'verificationValue': 0.0, 'proof': {'imageId': [1668793289, 846420925, 177576343, 3835873862, 66333553, 2894566030, 598275815, 2718278580], 'receipt': 'AwAAAAAAAAAAAAAAFPIgAEBa/KxpnrWjLW5ZBdoVsH8Dr4kePkUNGJK+LwGcLUh4AAAAAAAAAAAAAAAAAAAAAAAAAAAAAAAAAAAAAAAAAAAAAAAAAAAAAAAAAAAAAAAAAQAAAAAAAAAAAAAAAAAAAAAAAAAAAAAAAAAAAAAAAAAAAAAAAAAAAAEAAAAAPAEAAAAAAAAHAAAANzQ0ODAuMAAqAQAAeyJ3YXNfZmlyc3RfZXZlbnQiOmZhbHNlLCJpbWFnZV9pZCI6WzE2Njg3OTMyODksODQ2NDIwOTI1LDE3NzU3NjM0MywzODM1ODczODYyLDY2MzMzNTUzLDI4OTQ1NjYwMzAsNTk4Mjc1ODE1LDI3MTgyNzg1ODBdLCJxZiI6eyJiIjpbMCwwLDAsMCwwLDAsMCwwLDAsMCwwLDAsMCwwLDAsMCwwLDAsMCwwLDAsMCwwLDAsMCwwLDAsMCwwLDAsMCwwLDAsMCwwLDAsMCwwLDAsMCwwLDAsMCwwLDAsMCwwLDAsMCwwLDAsMCwwLDAsMCwwLDAsMCwwLDAsMCwwLDAsMCwwLDAsMCwwLDAsMCwwLDAsMF0sImwiOjAsInEiOjYsInIiOjd9fQAAAAAAAAAAAAAAAAAAPAEAAAAAAAAHAAAANzQ0ODAuMAAqAQAAeyJ3YXNfZmlyc3RfZXZlbnQiOmZhbHNlLCJpbWFnZV9pZCI6WzE2Njg3OTMyODksODQ2NDIwOTI1LDE3NzU3NjM0MywzODM1ODczODYyLDY2MzMzNTUzLDI4OTQ1NjYwMzAsNTk4Mjc1ODE1LDI3MTgyNzg1ODBdLCJxZiI6eyJiIjpbMCwwLDAsMCwwLDAsMCwwLDAsMCwwLDAsMCwwLDAsMCwwLDAsMCwwLDAsMCwwLDAsMCwwLDAsMCwwLDAsMCwwLDAsMCwwLDAsMCwwLDAsMCwwLDAsMCwwLDAsMCwwLDAsMCwwLDAsMCwwLDAsMCwwLDAsMCwwLDAsMCwwLDAsMCwwLDAsMCwwLDAsMCwwLDAsMF0sImwiOjAsInEiOjYsInIiOjd9fQAAAAAAAAAAAAAAAAAAAAAAAAAAAAAAAAAAAAAAAAAAAAA='}}
prove_37;75;92;Mul;6900;81380;0.0;833;2.4320357920005335;{'verificationValue': 0.0, 'proof': {'imageId': [1668793289, 846420925, 177576343, 3835873862, 66333553, 2894566030, 598275815, 2718278580], 'receipt': 'AwAAAAAAAAAAAAAAFPIgAEBa/KxpnrWjLW5ZBdoVsH8Dr4kePkUNGJK+LwGcLUh4AAAAAAAAAAAAAAAAAAAAAAAAAAAAAAAAAAAAAAAAAAAAAAAAAAAAAAAAAAAAAAAAAQAAAAAAAAAAAAAAAAAAAAAAAAAAAAAAAAAAAAAAAAAAAAAAAAAAAAEAAAAAPAEAAAAAAAAHAAAAODEzODAuMAAqAQAAeyJ3YXNfZmlyc3RfZXZlbnQiOmZhbHNlLCJpbWFnZV9pZCI6WzE2Njg3OTMyODksODQ2NDIwOTI1LDE3NzU3NjM0MywzODM1ODczODYyLDY2MzMzNTUzLDI4OTQ1NjYwMzAsNTk4Mjc1ODE1LDI3MTgyNzg1ODBdLCJxZiI6eyJiIjpbMCwwLDAsMCwwLDAsMCwwLDAsMCwwLDAsMCwwLDAsMCwwLDAsMCwwLDAsMCwwLDAsMCwwLDAsMCwwLDAsMCwwLDAsMCwwLDAsMCwwLDAsMCwwLDAsMCwwLDAsMCwwLDAsMCwwLDAsMCwwLDAsMCwwLDAsMCwwLDAsMCwwLDAsMCwwLDAsMCwwLDAsMCwwLDAsMF0sImwiOjAsInEiOjYsInIiOjd9fQAAAAAAAAAAAAAAAAAAPAEAAAAAAAAHAAAAODEzODAuMAAqAQAAeyJ3YXNfZmlyc3RfZXZlbnQiOmZhbHNlLCJpbWFnZV9pZCI6WzE2Njg3OTMyODksODQ2NDIwOTI1LDE3NzU3NjM0MywzODM1ODczODYyLDY2MzMzNTUzLDI4OTQ1NjYwMzAsNTk4Mjc1ODE1LDI3MTgyNzg1ODBdLCJxZiI6eyJiIjpbMCwwLDAsMCwwLDAsMCwwLDAsMCwwLDAsMCwwLDAsMCwwLDAsMCwwLDAsMCwwLDAsMCwwLDAsMCwwLDAsMCwwLDAsMCwwLDAsMCwwLDAsMCwwLDAsMCwwLDAsMCwwLDAsMCwwLDAsMCwwLDAsMCwwLDAsMCwwLDAsMCwwLDAsMCwwLDAsMCwwLDAsMCwwLDAsMF0sImwiOjAsInEiOjYsInIiOjd9fQAAAAAAAAAAAAAAAAAAAAAAAAAAAAAAAAAAAAAAAAAAAAA='}}
prove_38;99;40;Mul;3960;85340;0.0;833;2.5509996250002587;{'verificationValue': 0.0, 'proof': {'imageId': [1668793289, 846420925, 177576343, 3835873862, 66333553, 2894566030, 598275815, 2718278580], 'receipt': 'AwAAAAAAAAAAAAAAFPIgAEBa/KxpnrWjLW5ZBdoVsH8Dr4kePkUNGJK+LwGcLUh4AAAAAAAAAAAAAAAAAAAAAAAAAAAAAAAAAAAAAAAAAAAAAAAAAAAAAAAAAAAAAAAAAQAAAAAAAAAAAAAAAAAAAAAAAAAAAAAAAAAAAAAAAAAAAAAAAAAAAAEAAAAAPAEAAAAAAAAHAAAAODUzNDAuMAAqAQAAeyJ3YXNfZmlyc3RfZXZlbnQiOmZhbHNlLCJpbWFnZV9pZCI6WzE2Njg3OTMyODksODQ2NDIwOTI1LDE3NzU3NjM0MywzODM1ODczODYyLDY2MzMzNTUzLDI4OTQ1NjYwMzAsNTk4Mjc1ODE1LDI3MTgyNzg1ODBdLCJxZiI6eyJiIjpbMCwwLDAsMCwwLDAsMCwwLDAsMCwwLDAsMCwwLDAsMCwwLDAsMCwwLDAsMCwwLDAsMCwwLDAsMCwwLDAsMCwwLDAsMCwwLDAsMCwwLDAsMCwwLDAsMCwwLDAsMCwwLDAsMCwwLDAsMCwwLDAsMCwwLDAsMCwwLDAsMCwwLDAsMCwwLDAsMCwwLDAsMCwwLDAsMF0sImwiOjAsInEiOjYsInIiOjd9fQAAAAAAAAAAAAAAAAAAPAEAAAAAAAAHAAAAODUzNDAuMAAqAQAAeyJ3YXNfZmlyc3RfZXZlbnQiOmZhbHNlLCJpbWFnZV9pZCI6WzE2Njg3OTMyODksODQ2NDIwOTI1LDE3NzU3NjM0MywzODM1ODczODYyLDY2MzMzNTUzLDI4OTQ1NjYwMzAsNTk4Mjc1ODE1LDI3MTgyNzg1ODBdLCJxZiI6eyJiIjpbMCwwLDAsMCwwLDAsMCwwLDAsMCwwLDAsMCwwLDAsMCwwLDAsMCwwLDAsMCwwLDAsMCwwLDAsMCwwLDAsMCwwLDAsMCwwLDAsMCwwLDAsMCwwLDAsMCwwLDAsMCwwLDAsMCwwLDAsMCwwLDAsMCwwLDAsMCwwLDAsMCwwLDAsMCwwLDAsMCwwLDAsMCwwLDAsMF0sImwiOjAsInEiOjYsInIiOjd9fQAAAAAAAAAAAAAAAAAAAAAAAAAAAAAAAAAAAAAAAAAAAAA='}}
prove_39;66;75;Mul;4950;90290;0.0;833;2.5975794999994832;{'verificationValue': 0.0, 'proof': {'imageId': [1668793289, 846420925, 177576343, 3835873862, 66333553, 2894566030, 598275815, 2718278580], 'receipt': 'AwAAAAAAAAAAAAAAFPIgAEBa/KxpnrWjLW5ZBdoVsH8Dr4kePkUNGJK+LwGcLUh4AAAAAAAAAAAAAAAAAAAAAAAAAAAAAAAAAAAAAAAAAAAAAAAAAAAAAAAAAAAAAAAAAQAAAAAAAAAAAAAAAAAAAAAAAAAAAAAAAAAAAAAAAAAAAAAAAAAAAAEAAAAAPAEAAAAAAAAHAAAAOTAyOTAuMAAqAQAAeyJ3YXNfZmlyc3RfZXZlbnQiOmZhbHNlLCJpbWFnZV9pZCI6WzE2Njg3OTMyODksODQ2NDIwOTI1LDE3NzU3NjM0MywzODM1ODczODYyLDY2MzMzNTUzLDI4OTQ1NjYwMzAsNTk4Mjc1ODE1LDI3MTgyNzg1ODBdLCJxZiI6eyJiIjpbMCwwLDAsMCwwLDAsMCwwLDAsMCwwLDAsMCwwLDAsMCwwLDAsMCwwLDAsMCwwLDAsMCwwLDAsMCwwLDAsMCwwLDAsMCwwLDAsMCwwLDAsMCwwLDAsMCwwLDAsMCwwLDAsMCwwLDAsMCwwLDAsMCwwLDAsMCwwLDAsMCwwLDAsMCwwLDAsMCwwLDAsMCwwLDAsMF0sImwiOjAsInEiOjYsInIiOjd9fQAAAAAAAAAAAAAAAAAAPAEAAAAAAAAHAAAAOTAyOTAuMAAqAQAAeyJ3YXNfZmlyc3RfZXZlbnQiOmZhbHNlLCJpbWFnZV9pZCI6WzE2Njg3OTMyODksODQ2NDIwOTI1LDE3NzU3NjM0MywzODM1ODczODYyLDY2MzMzNTUzLDI4OTQ1NjYwMzAsNTk4Mjc1ODE1LDI3MTgyNzg1ODBdLCJxZiI6eyJiIjpbMCwwLDAsMCwwLDAsMCwwLDAsMCwwLDAsMCwwLDAsMCwwLDAsMCwwLDAsMCwwLDAsMCwwLDAsMCwwLDAsMCwwLDAsMCwwLDAsMCwwLDAsMCwwLDAsMCwwLDAsMCwwLDAsMCwwLDAsMCwwLDAsMCwwLDAsMCwwLDAsMCwwLDAsMCwwLDAsMCwwLDAsMCwwLDAsMF0sImwiOjAsInEiOjYsInIiOjd9fQAAAAAAAAAAAAAAAAAAAAAAAAAAAAAAAAAAAAAAAAAAAAA='}}
prove_40;54;53;Mul;2862;93152;0.0;833;2.6646055839992187;{'verificationValue': 0.0, 'proof': {'imageId': [1668793289, 846420925, 177576343, 3835873862, 66333553, 2894566030, 598275815, 2718278580], 'receipt': 'AwAAAAAAAAAAAAAAFPIgAEBa/KxpnrWjLW5ZBdoVsH8Dr4kePkUNGJK+LwGcLUh4AAAAAAAAAAAAAAAAAAAAAAAAAAAAAAAAAAAAAAAAAAAAAAAAAAAAAAAAAAAAAAAAAQAAAAAAAAAAAAAAAAAAAAAAAAAAAAAAAAAAAAAAAAAAAAAAAAAAAAEAAAAAPAEAAAAAAAAHAAAAOTMxNTIuMAAqAQAAeyJ3YXNfZmlyc3RfZXZlbnQiOmZhbHNlLCJpbWFnZV9pZCI6WzE2Njg3OTMyODksODQ2NDIwOTI1LDE3NzU3NjM0MywzODM1ODczODYyLDY2MzMzNTUzLDI4OTQ1NjYwMzAsNTk4Mjc1ODE1LDI3MTgyNzg1ODBdLCJxZiI6eyJiIjpbMCwwLDAsMCwwLDAsMCwwLDAsMCwwLDAsMCwwLDAsMCwwLDAsMCwwLDAsMCwwLDAsMCwwLDAsMCwwLDAsMCwwLDAsMCwwLDAsMCwwLDAsMCwwLDAsMCwwLDAsMCwwLDAsMCwwLDAsMCwwLDAsMCwwLDAsMCwwLDAsMCwwLDAsMCwwLDAsMCwwLDAsMCwwLDAsMF0sImwiOjAsInEiOjYsInIiOjd9fQAAAAAAAAAAAAAAAAAAPAEAAAAAAAAHAAAAOTMxNTIuMAAqAQAAeyJ3YXNfZmlyc3RfZXZlbnQiOmZhbHNlLCJpbWFnZV9pZCI6WzE2Njg3OTMyODksODQ2NDIwOTI1LDE3NzU3NjM0MywzODM1ODczODYyLDY2MzMzNTUzLDI4OTQ1NjYwMzAsNTk4Mjc1ODE1LDI3MTgyNzg1ODBdLCJxZiI6eyJiIjpbMCwwLDAsMCwwLDAsMCwwLDAsMCwwLDAsMCwwLDAsMCwwLDAsMCwwLDAsMCwwLDAsMCwwLDAsMCwwLDAsMCwwLDAsMCwwLDAsMCwwLDAsMCwwLDAsMCwwLDAsMCwwLDAsMCwwLDAsMCwwLDAsMCwwLDAsMCwwLDAsMCwwLDAsMCwwLDAsMCwwLDAsMCwwLDAsMF0sImwiOjAsInEiOjYsInIiOjd9fQAAAAAAAAAAAAAAAAAAAAAAAAAAAAAAAAAAAAAAAAAAAAA='}}
prove_41;8;43;Mul;344;93496;0.0;833;2.7583352090005064;{'verificationValue': 0.0, 'proof': {'imageId': [1668793289, 846420925, 177576343, 3835873862, 66333553, 2894566030, 598275815, 2718278580], 'receipt': 'AwAAAAAAAAAAAAAAFPIgAEBa/KxpnrWjLW5ZBdoVsH8Dr4kePkUNGJK+LwGcLUh4AAAAAAAAAAAAAAAAAAAAAAAAAAAAAAAAAAAAAAAAAAAAAAAAAAAAAAAAAAAAAAAAAQAAAAAAAAAAAAAAAAAAAAAAAAAAAAAAAAAAAAAAAAAAAAAAAAAAAAEAAAAAPAEAAAAAAAAHAAAAOTM0OTYuMAAqAQAAeyJ3YXNfZmlyc3RfZXZlbnQiOmZhbHNlLCJpbWFnZV9pZCI6WzE2Njg3OTMyODksODQ2NDIwOTI1LDE3NzU3NjM0MywzODM1ODczODYyLDY2MzMzNTUzLDI4OTQ1NjYwMzAsNTk4Mjc1ODE1LDI3MTgyNzg1ODBdLCJxZiI6eyJiIjpbMCwwLDAsMCwwLDAsMCwwLDAsMCwwLDAsMCwwLDAsMCwwLDAsMCwwLDAsMCwwLDAsMCwwLDAsMCwwLDAsMCwwLDAsMCwwLDAsMCwwLDAsMCwwLDAsMCwwLDAsMCwwLDAsMCwwLDAsMCwwLDAsMCwwLDAsMCwwLDAsMCwwLDAsMCwwLDAsMCwwLDAsMCwwLDAsMF0sImwiOjAsInEiOjYsInIiOjd9fQAAAAAAAAAAAAAAAAAAPAEAAAAAAAAHAAAAOTM0OTYuMAAqAQAAeyJ3YXNfZmlyc3RfZXZlbnQiOmZhbHNlLCJpbWFnZV9pZCI6WzE2Njg3OTMyODksODQ2NDIwOTI1LDE3NzU3NjM0MywzODM1ODczODYyLDY2MzMzNTUzLDI4OTQ1NjYwMzAsNTk4Mjc1ODE1LDI3MTgyNzg1ODBdLCJxZiI6eyJiIjpbMCwwLDAsMCwwLDAsMCwwLDAsMCwwLDAsMCwwLDAsMCwwLDAsMCwwLDAsMCwwLDAsMCwwLDAsMCwwLDAsMCwwLDAsMCwwLDAsMCwwLDAsMCwwLDAsMCwwLDAsMCwwLDAsMCwwLDAsMCwwLDAsMCwwLDAsMCwwLDAsMCwwLDAsMCwwLDAsMCwwLDAsMCwwLDAsMF0sImwiOjAsInEiOjYsInIiOjd9fQAAAAAAAAAAAAAAAAAAAAAAAAAAAAAAAAAAAAAAAAAAAAA='}}
prove_42;83;49;Mul;4067;97563;0.0;833;2.852205375000267;{'verificationValue': 0.0, 'proof': {'imageId': [1668793289, 846420925, 177576343, 3835873862, 66333553, 2894566030, 598275815, 2718278580], 'receipt': 'AwAAAAAAAAAAAAAAFPIgAEBa/KxpnrWjLW5ZBdoVsH8Dr4kePkUNGJK+LwGcLUh4AAAAAAAAAAAAAAAAAAAAAAAAAAAAAAAAAAAAAAAAAAAAAAAAAAAAAAAAAAAAAAAAAQAAAAAAAAAAAAAAAAAAAAAAAAAAAAAAAAAAAAAAAAAAAAAAAAAAAAEAAAAAPAEAAAAAAAAHAAAAOTc1NjMuMAAqAQAAeyJ3YXNfZmlyc3RfZXZlbnQiOmZhbHNlLCJpbWFnZV9pZCI6WzE2Njg3OTMyODksODQ2NDIwOTI1LDE3NzU3NjM0MywzODM1ODczODYyLDY2MzMzNTUzLDI4OTQ1NjYwMzAsNTk4Mjc1ODE1LDI3MTgyNzg1ODBdLCJxZiI6eyJiIjpbMCwwLDAsMCwwLDAsMCwwLDAsMCwwLDAsMCwwLDAsMCwwLDAsMCwwLDAsMCwwLDAsMCwwLDAsMCwwLDAsMCwwLDAsMCwwLDAsMCwwLDAsMCwwLDAsMCwwLDAsMCwwLDAsMCwwLDAsMCwwLDAsMCwwLDAsMCwwLDAsMCwwLDAsMCwwLDAsMCwwLDAsMCwwLDAsMF0sImwiOjAsInEiOjYsInIiOjd9fQAAAAAAAAAAAAAAAAAAPAEAAAAAAAAHAAAAOTc1NjMuMAAqAQAAeyJ3YXNfZmlyc3RfZXZlbnQiOmZhbHNlLCJpbWFnZV9pZCI6WzE2Njg3OTMyODksODQ2NDIwOTI1LDE3NzU3NjM0MywzODM1ODczODYyLDY2MzMzNTUzLDI4OTQ1NjYwMzAsNTk4Mjc1ODE1LDI3MTgyNzg1ODBdLCJxZiI6eyJiIjpbMCwwLDAsMCwwLDAsMCwwLDAsMCwwLDAsMCwwLDAsMCwwLDAsMCwwLDAsMCwwLDAsMCwwLDAsMCwwLDAsMCwwLDAsMCwwLDAsMCwwLDAsMCwwLDAsMCwwLDAsMCwwLDAsMCwwLDAsMCwwLDAsMCwwLDAsMCwwLDAsMCwwLDAsMCwwLDAsMCwwLDAsMCwwLDAsMF0sImwiOjAsInEiOjYsInIiOjd9fQAAAAAAAAAAAAAAAAAAAAAAAAAAAAAAAAAAAAAAAAAAAAA='}}
prove_43;85;26;Mul;2210;99773;0.0;833;2.9597044160000223;{'verificationValue': 0.0, 'proof': {'imageId': [1668793289, 846420925, 177576343, 3835873862, 66333553, 2894566030, 598275815, 2718278580], 'receipt': 'AwAAAAAAAAAAAAAAFPIgAEBa/KxpnrWjLW5ZBdoVsH8Dr4kePkUNGJK+LwGcLUh4AAAAAAAAAAAAAAAAAAAAAAAAAAAAAAAAAAAAAAAAAAAAAAAAAAAAAAAAAAAAAAAAAQAAAAAAAAAAAAAAAAAAAAAAAAAAAAAAAAAAAAAAAAAAAAAAAAAAAAEAAAAAPAEAAAAAAAAHAAAAOTk3NzMuMAAqAQAAeyJ3YXNfZmlyc3RfZXZlbnQiOmZhbHNlLCJpbWFnZV9pZCI6WzE2Njg3OTMyODksODQ2NDIwOTI1LDE3NzU3NjM0MywzODM1ODczODYyLDY2MzMzNTUzLDI4OTQ1NjYwMzAsNTk4Mjc1ODE1LDI3MTgyNzg1ODBdLCJxZiI6eyJiIjpbMCwwLDAsMCwwLDAsMCwwLDAsMCwwLDAsMCwwLDAsMCwwLDAsMCwwLDAsMCwwLDAsMCwwLDAsMCwwLDAsMCwwLDAsMCwwLDAsMCwwLDAsMCwwLDAsMCwwLDAsMCwwLDAsMCwwLDAsMCwwLDAsMCwwLDAsMCwwLDAsMCwwLDAsMCwwLDAsMCwwLDAsMCwwLDAsMF0sImwiOjAsInEiOjYsInIiOjd9fQAAAAAAAAAAAAAAAAAAPAEAAAAAAAAHAAAAOTk3NzMuMAAqAQAAeyJ3YXNfZmlyc3RfZXZlbnQiOmZhbHNlLCJpbWFnZV9pZCI6WzE2Njg3OTMyODksODQ2NDIwOTI1LDE3NzU3NjM0MywzODM1ODczODYyLDY2MzMzNTUzLDI4OTQ1NjYwMzAsNTk4Mjc1ODE1LDI3MTgyNzg1ODBdLCJxZiI6eyJiIjpbMCwwLDAsMCwwLDAsMCwwLDAsMCwwLDAsMCwwLDAsMCwwLDAsMCwwLDAsMCwwLDAsMCwwLDAsMCwwLDAsMCwwLDAsMCwwLDAsMCwwLDAsMCwwLDAsMCwwLDAsMCwwLDAsMCwwLDAsMCwwLDAsMCwwLDAsMCwwLDAsMCwwLDAsMCwwLDAsMCwwLDAsMCwwLDAsMF0sImwiOjAsInEiOjYsInIiOjd9fQAAAAAAAAAAAAAAAAAAAAAAAAAAAAAAAAAAAAAAAAAAAAA='}}
prove_44;66;94;Mul;6204;105977;0.0;833;2.9385383330009063;{'verificationValue': 0.0, 'proof': {'imageId': [1668793289, 846420925, 177576343, 3835873862, 66333553, 2894566030, 598275815, 2718278580], 'receipt': 'AwAAAAAAAAAAAAAAFPIgAEBa/KxpnrWjLW5ZBdoVsH8Dr4kePkUNGJK+LwGcLUh4AAAAAAAAAAAAAAAAAAAAAAAAAAAAAAAAAAAAAAAAAAAAAAAAAAAAAAAAAAAAAAAAAQAAAAAAAAAAAAAAAAAAAAAAAAAAAAAAAAAAAAAAAAAAAAAAAAAAAAEAAAAAPAEAAAAAAAAIAAAAMTA1OTc3LjAqAQAAeyJ3YXNfZmlyc3RfZXZlbnQiOmZhbHNlLCJpbWFnZV9pZCI6WzE2Njg3OTMyODksODQ2NDIwOTI1LDE3NzU3NjM0MywzODM1ODczODYyLDY2MzMzNTUzLDI4OTQ1NjYwMzAsNTk4Mjc1ODE1LDI3MTgyNzg1ODBdLCJxZiI6eyJiIjpbMCwwLDAsMCwwLDAsMCwwLDAsMCwwLDAsMCwwLDAsMCwwLDAsMCwwLDAsMCwwLDAsMCwwLDAsMCwwLDAsMCwwLDAsMCwwLDAsMCwwLDAsMCwwLDAsMCwwLDAsMCwwLDAsMCwwLDAsMCwwLDAsMCwwLDAsMCwwLDAsMCwwLDAsMCwwLDAsMCwwLDAsMCwwLDAsMF0sImwiOjAsInEiOjYsInIiOjd9fQAAAAAAAAAAAAAAAAAAPAEAAAAAAAAIAAAAMTA1OTc3LjAqAQAAeyJ3YXNfZmlyc3RfZXZlbnQiOmZhbHNlLCJpbWFnZV9pZCI6WzE2Njg3OTMyODksODQ2NDIwOTI1LDE3NzU3NjM0MywzODM1ODczODYyLDY2MzMzNTUzLDI4OTQ1NjYwMzAsNTk4Mjc1ODE1LDI3MTgyNzg1ODBdLCJxZiI6eyJiIjpbMCwwLDAsMCwwLDAsMCwwLDAsMCwwLDAsMCwwLDAsMCwwLDAsMCwwLDAsMCwwLDAsMCwwLDAsMCwwLDAsMCwwLDAsMCwwLDAsMCwwLDAsMCwwLDAsMCwwLDAsMCwwLDAsMCwwLDAsMCwwLDAsMCwwLDAsMCwwLDAsMCwwLDAsMCwwLDAsMCwwLDAsMCwwLDAsMF0sImwiOjAsInEiOjYsInIiOjd9fQAAAAAAAAAAAAAAAAAAAAAAAAAAAAAAAAAAAAAAAAAAAAA='}}
prove_45;61;49;Mul;2989;108966;0.0;833;3.019612957999925;{'verificationValue': 0.0, 'proof': {'imageId': [1668793289, 846420925, 177576343, 3835873862, 66333553, 2894566030, 598275815, 2718278580], 'receipt': 'AwAAAAAAAAAAAAAAFPIgAEBa/KxpnrWjLW5ZBdoVsH8Dr4kePkUNGJK+LwGcLUh4AAAAAAAAAAAAAAAAAAAAAAAAAAAAAAAAAAAAAAAAAAAAAAAAAAAAAAAAAAAAAAAAAQAAAAAAAAAAAAAAAAAAAAAAAAAAAAAAAAAAAAAAAAAAAAAAAAAAAAEAAAAAPAEAAAAAAAAIAAAAMTA4OTY2LjAqAQAAeyJ3YXNfZmlyc3RfZXZlbnQiOmZhbHNlLCJpbWFnZV9pZCI6WzE2Njg3OTMyODksODQ2NDIwOTI1LDE3NzU3NjM0MywzODM1ODczODYyLDY2MzMzNTUzLDI4OTQ1NjYwMzAsNTk4Mjc1ODE1LDI3MTgyNzg1ODBdLCJxZiI6eyJiIjpbMCwwLDAsMCwwLDAsMCwwLDAsMCwwLDAsMCwwLDAsMCwwLDAsMCwwLDAsMCwwLDAsMCwwLDAsMCwwLDAsMCwwLDAsMCwwLDAsMCwwLDAsMCwwLDAsMCwwLDAsMCwwLDAsMCwwLDAsMCwwLDAsMCwwLDAsMCwwLDAsMCwwLDAsMCwwLDAsMCwwLDAsMCwwLDAsMF0sImwiOjAsInEiOjYsInIiOjd9fQAAAAAAAAAAAAAAAAAAPAEAAAAAAAAIAAAAMTA4OTY2LjAqAQAAeyJ3YXNfZmlyc3RfZXZlbnQiOmZhbHNlLCJpbWFnZV9pZCI6WzE2Njg3OTMyODksODQ2NDIwOTI1LDE3NzU3NjM0MywzODM1ODczODYyLDY2MzMzNTUzLDI4OTQ1NjYwMzAsNTk4Mjc1ODE1LDI3MTgyNzg1ODBdLCJxZiI6eyJiIjpbMCwwLDAsMCwwLDAsMCwwLDAsMCwwLDAsMCwwLDAsMCwwLDAsMCwwLDAsMCwwLDAsMCwwLDAsMCwwLDAsMCwwLDAsMCwwLDAsMCwwLDAsMCwwLDAsMCwwLDAsMCwwLDAsMCwwLDAsMCwwLDAsMCwwLDAsMCwwLDAsMCwwLDAsMCwwLDAsMCwwLDAsMCwwLDAsMF0sImwiOjAsInEiOjYsInIiOjd9fQAAAAAAAAAAAAAAAAAAAAAAAAAAAAAAAAAAAAAAAAAAAAA='}}
prove_46;20;7;Mul;140;109106;0.0;833;3.060231792000195;{'verificationValue': 0.0, 'proof': {'imageId': [1668793289, 846420925, 177576343, 3835873862, 66333553, 2894566030, 598275815, 2718278580], 'receipt': 'AwAAAAAAAAAAAAAAFPIgAEBa/KxpnrWjLW5ZBdoVsH8Dr4kePkUNGJK+LwGcLUh4AAAAAAAAAAAAAAAAAAAAAAAAAAAAAAAAAAAAAAAAAAAAAAAAAAAAAAAAAAAAAAAAAQAAAAAAAAAAAAAAAAAAAAAAAAAAAAAAAAAAAAAAAAAAAAAAAAAAAAEAAAAAPAEAAAAAAAAIAAAAMTA5MTA2LjAqAQAAeyJ3YXNfZmlyc3RfZXZlbnQiOmZhbHNlLCJpbWFnZV9pZCI6WzE2Njg3OTMyODksODQ2NDIwOTI1LDE3NzU3NjM0MywzODM1ODczODYyLDY2MzMzNTUzLDI4OTQ1NjYwMzAsNTk4Mjc1ODE1LDI3MTgyNzg1ODBdLCJxZiI6eyJiIjpbMCwwLDAsMCwwLDAsMCwwLDAsMCwwLDAsMCwwLDAsMCwwLDAsMCwwLDAsMCwwLDAsMCwwLDAsMCwwLDAsMCwwLDAsMCwwLDAsMCwwLDAsMCwwLDAsMCwwLDAsMCwwLDAsMCwwLDAsMCwwLDAsMCwwLDAsMCwwLDAsMCwwLDAsMCwwLDAsMCwwLDAsMCwwLDAsMF0sImwiOjAsInEiOjYsInIiOjd9fQAAAAAAAAAAAAAAAAAAPAEAAAAAAAAIAAAAMTA5MTA2LjAqAQAAeyJ3YXNfZmlyc3RfZXZlbnQiOmZhbHNlLCJpbWFnZV9pZCI6WzE2Njg3OTMyODksODQ2NDIwOTI1LDE3NzU3NjM0MywzODM1ODczODYyLDY2MzMzNTUzLDI4OTQ1NjYwMzAsNTk4Mjc1ODE1LDI3MTgyNzg1ODBdLCJxZiI6eyJiIjpbMCwwLDAsMCwwLDAsMCwwLDAsMCwwLDAsMCwwLDAsMCwwLDAsMCwwLDAsMCwwLDAsMCwwLDAsMCwwLDAsMCwwLDAsMCwwLDAsMCwwLDAsMCwwLDAsMCwwLDAsMCwwLDAsMCwwLDAsMCwwLDAsMCwwLDAsMCwwLDAsMCwwLDAsMCwwLDAsMCwwLDAsMCwwLDAsMF0sImwiOjAsInEiOjYsInIiOjd9fQAAAAAAAAAAAAAAAAAAAAAAAAAAAAAAAAAAAAAAAAAAAAA='}}
prove_47;95;79;Mul;7505;116611;0.0;833;3.2065563749983994;{'verificationValue': 0.0, 'proof': {'imageId': [1668793289, 846420925, 177576343, 3835873862, 66333553, 2894566030, 598275815, 2718278580], 'receipt': 'AwAAAAAAAAAAAAAAFPIgAEBa/KxpnrWjLW5ZBdoVsH8Dr4kePkUNGJK+LwGcLUh4AAAAAAAAAAAAAAAAAAAAAAAAAAAAAAAAAAAAAAAAAAAAAAAAAAAAAAAAAAAAAAAAAQAAAAAAAAAAAAAAAAAAAAAAAAAAAAAAAAAAAAAAAAAAAAAAAAAAAAEAAAAAPAEAAAAAAAAIAAAAMTE2NjExLjAqAQAAeyJ3YXNfZmlyc3RfZXZlbnQiOmZhbHNlLCJpbWFnZV9pZCI6WzE2Njg3OTMyODksODQ2NDIwOTI1LDE3NzU3NjM0MywzODM1ODczODYyLDY2MzMzNTUzLDI4OTQ1NjYwMzAsNTk4Mjc1ODE1LDI3MTgyNzg1ODBdLCJxZiI6eyJiIjpbMCwwLDAsMCwwLDAsMCwwLDAsMCwwLDAsMCwwLDAsMCwwLDAsMCwwLDAsMCwwLDAsMCwwLDAsMCwwLDAsMCwwLDAsMCwwLDAsMCwwLDAsMCwwLDAsMCwwLDAsMCwwLDAsMCwwLDAsMCwwLDAsMCwwLDAsMCwwLDAsMCwwLDAsMCwwLDAsMCwwLDAsMCwwLDAsMF0sImwiOjAsInEiOjYsInIiOjd9fQAAAAAAAAAAAAAAAAAAPAEAAAAAAAAIAAAAMTE2NjExLjAqAQAAeyJ3YXNfZmlyc3RfZXZlbnQiOmZhbHNlLCJpbWFnZV9pZCI6WzE2Njg3OTMyODksODQ2NDIwOTI1LDE3NzU3NjM0MywzODM1ODczODYyLDY2MzMzNTUzLDI4OTQ1NjYwMzAsNTk4Mjc1ODE1LDI3MTgyNzg1ODBdLCJxZiI6eyJiIjpbMCwwLDAsMCwwLDAsMCwwLDAsMCwwLDAsMCwwLDAsMCwwLDAsMCwwLDAsMCwwLDAsMCwwLDAsMCwwLDAsMCwwLDAsMCwwLDAsMCwwLDAsMCwwLDAsMCwwLDAsMCwwLDAsMCwwLDAsMCwwLDAsMCwwLDAsMCwwLDAsMCwwLDAsMCwwLDAsMCwwLDAsMCwwLDAsMF0sImwiOjAsInEiOjYsInIiOjd9fQAAAAAAAAAAAAAAAAAAAAAAAAAAAAAAAAAAAAAAAAAAAAA='}}
prove_48;27;60;Mul;1620;118231;0.0;833;3.226860625001791;{'verificationValue': 0.0, 'proof': {'imageId': [1668793289, 846420925, 177576343, 3835873862, 66333553, 2894566030, 598275815, 2718278580], 'receipt': 'AwAAAAAAAAAAAAAAFPIgAEBa/KxpnrWjLW5ZBdoVsH8Dr4kePkUNGJK+LwGcLUh4AAAAAAAAAAAAAAAAAAAAAAAAAAAAAAAAAAAAAAAAAAAAAAAAAAAAAAAAAAAAAAAAAQAAAAAAAAAAAAAAAAAAAAAAAAAAAAAAAAAAAAAAAAAAAAAAAAAAAAEAAAAAPAEAAAAAAAAIAAAAMTE4MjMxLjAqAQAAeyJ3YXNfZmlyc3RfZXZlbnQiOmZhbHNlLCJpbWFnZV9pZCI6WzE2Njg3OTMyODksODQ2NDIwOTI1LDE3NzU3NjM0MywzODM1ODczODYyLDY2MzMzNTUzLDI4OTQ1NjYwMzAsNTk4Mjc1ODE1LDI3MTgyNzg1ODBdLCJxZiI6eyJiIjpbMCwwLDAsMCwwLDAsMCwwLDAsMCwwLDAsMCwwLDAsMCwwLDAsMCwwLDAsMCwwLDAsMCwwLDAsMCwwLDAsMCwwLDAsMCwwLDAsMCwwLDAsMCwwLDAsMCwwLDAsMCwwLDAsMCwwLDAsMCwwLDAsMCwwLDAsMCwwLDAsMCwwLDAsMCwwLDAsMCwwLDAsMCwwLDAsMF0sImwiOjAsInEiOjYsInIiOjd9fQAAAAAAAAAAAAAAAAAAPAEAAAAAAAAIAAAAMTE4MjMxLjAqAQAAeyJ3YXNfZmlyc3RfZXZlbnQiOmZhbHNlLCJpbWFnZV9pZCI6WzE2Njg3OTMyODksODQ2NDIwOTI1LDE3NzU3NjM0MywzODM1ODczODYyLDY2MzMzNTUzLDI4OTQ1NjYwMzAsNTk4Mjc1ODE1LDI3MTgyNzg1ODBdLCJxZiI6eyJiIjpbMCwwLDAsMCwwLDAsMCwwLDAsMCwwLDAsMCwwLDAsMCwwLDAsMCwwLDAsMCwwLDAsMCwwLDAsMCwwLDAsMCwwLDAsMCwwLDAsMCwwLDAsMCwwLDAsMCwwLDAsMCwwLDAsMCwwLDAsMCwwLDAsMCwwLDAsMCwwLDAsMCwwLDAsMCwwLDAsMCwwLDAsMCwwLDAsMF0sImwiOjAsInEiOjYsInIiOjd9fQAAAAAAAAAAAAAAAAAAAAAAAAAAAAAAAAAAAAAAAAAAAAA='}}
prove_49;91;61;Mul;5551;123782;0.0;833;3.313678583001092;{'verificationValue': 0.0, 'proof': {'imageId': [1668793289, 846420925, 177576343, 3835873862, 66333553, 2894566030, 598275815, 2718278580], 'receipt': 'AwAAAAAAAAAAAAAAFPIgAEBa/KxpnrWjLW5ZBdoVsH8Dr4kePkUNGJK+LwGcLUh4AAAAAAAAAAAAAAAAAAAAAAAAAAAAAAAAAAAAAAAAAAAAAAAAAAAAAAAAAAAAAAAAAQAAAAAAAAAAAAAAAAAAAAAAAAAAAAAAAAAAAAAAAAAAAAAAAAAAAAEAAAAAPAEAAAAAAAAIAAAAMTIzNzgyLjAqAQAAeyJ3YXNfZmlyc3RfZXZlbnQiOmZhbHNlLCJpbWFnZV9pZCI6WzE2Njg3OTMyODksODQ2NDIwOTI1LDE3NzU3NjM0MywzODM1ODczODYyLDY2MzMzNTUzLDI4OTQ1NjYwMzAsNTk4Mjc1ODE1LDI3MTgyNzg1ODBdLCJxZiI6eyJiIjpbMCwwLDAsMCwwLDAsMCwwLDAsMCwwLDAsMCwwLDAsMCwwLDAsMCwwLDAsMCwwLDAsMCwwLDAsMCwwLDAsMCwwLDAsMCwwLDAsMCwwLDAsMCwwLDAsMCwwLDAsMCwwLDAsMCwwLDAsMCwwLDAsMCwwLDAsMCwwLDAsMCwwLDAsMCwwLDAsMCwwLDAsMCwwLDAsMF0sImwiOjAsInEiOjYsInIiOjd9fQAAAAAAAAAAAAAAAAAAPAEAAAAAAAAIAAAAMTIzNzgyLjAqAQAAeyJ3YXNfZmlyc3RfZXZlbnQiOmZhbHNlLCJpbWFnZV9pZCI6WzE2Njg3OTMyODksODQ2NDIwOTI1LDE3NzU3NjM0MywzODM1ODczODYyLDY2MzMzNTUzLDI4OTQ1NjYwMzAsNTk4Mjc1ODE1LDI3MTgyNzg1ODBdLCJxZiI6eyJiIjpbMCwwLDAsMCwwLDAsMCwwLDAsMCwwLDAsMCwwLDAsMCwwLDAsMCwwLDAsMCwwLDAsMCwwLDAsMCwwLDAsMCwwLDAsMCwwLDAsMCwwLDAsMCwwLDAsMCwwLDAsMCwwLDAsMCwwLDAsMCwwLDAsMCwwLDAsMCwwLDAsMCwwLDAsMCwwLDAsMCwwLDAsMCwwLDAsMF0sImwiOjAsInEiOjYsInIiOjd9fQAAAAAAAAAAAAAAAAAAAAAAAAAAAAAAAAAAAAAAAAAAAAA='}}
prove_50;28;57;Mul;1596;125378;0.0;833;3.3820685829996364;{'verificationValue': 0.0, 'proof': {'imageId': [1668793289, 846420925, 177576343, 3835873862, 66333553, 2894566030, 598275815, 2718278580], 'receipt': 'AwAAAAAAAAAAAAAAFPIgAEBa/KxpnrWjLW5ZBdoVsH8Dr4kePkUNGJK+LwGcLUh4AAAAAAAAAAAAAAAAAAAAAAAAAAAAAAAAAAAAAAAAAAAAAAAAAAAAAAAAAAAAAAAAAQAAAAAAAAAAAAAAAAAAAAAAAAAAAAAAAAAAAAAAAAAAAAAAAAAAAAEAAAAAPAEAAAAAAAAIAAAAMTI1Mzc4LjAqAQAAeyJ3YXNfZmlyc3RfZXZlbnQiOmZhbHNlLCJpbWFnZV9pZCI6WzE2Njg3OTMyODksODQ2NDIwOTI1LDE3NzU3NjM0MywzODM1ODczODYyLDY2MzMzNTUzLDI4OTQ1NjYwMzAsNTk4Mjc1ODE1LDI3MTgyNzg1ODBdLCJxZiI6eyJiIjpbMCwwLDAsMCwwLDAsMCwwLDAsMCwwLDAsMCwwLDAsMCwwLDAsMCwwLDAsMCwwLDAsMCwwLDAsMCwwLDAsMCwwLDAsMCwwLDAsMCwwLDAsMCwwLDAsMCwwLDAsMCwwLDAsMCwwLDAsMCwwLDAsMCwwLDAsMCwwLDAsMCwwLDAsMCwwLDAsMCwwLDAsMCwwLDAsMF0sImwiOjAsInEiOjYsInIiOjd9fQAAAAAAAAAAAAAAAAAAPAEAAAAAAAAIAAAAMTI1Mzc4LjAqAQAAeyJ3YXNfZmlyc3RfZXZlbnQiOmZhbHNlLCJpbWFnZV9pZCI6WzE2Njg3OTMyODksODQ2NDIwOTI1LDE3NzU3NjM0MywzODM1ODczODYyLDY2MzMzNTUzLDI4OTQ1NjYwMzAsNTk4Mjc1ODE1LDI3MTgyNzg1ODBdLCJxZiI6eyJiIjpbMCwwLDAsMCwwLDAsMCwwLDAsMCwwLDAsMCwwLDAsMCwwLDAsMCwwLDAsMCwwLDAsMCwwLDAsMCwwLDAsMCwwLDAsMCwwLDAsMCwwLDAsMCwwLDAsMCwwLDAsMCwwLDAsMCwwLDAsMCwwLDAsMCwwLDAsMCwwLDAsMCwwLDAsMCwwLDAsMCwwLDAsMCwwLDAsMF0sImwiOjAsInEiOjYsInIiOjd9fQAAAAAAAAAAAAAAAAAAAAAAAAAAAAAAAAAAAAAAAAAAAAA='}}
prove_51;11;17;Mul;187;125565;0.0;833;3.5343005419999827;{'verificationValue': 0.0, 'proof': {'imageId': [1668793289, 846420925, 177576343, 3835873862, 66333553, 2894566030, 598275815, 2718278580], 'receipt': 'AwAAAAAAAAAAAAAAFPIgAEBa/KxpnrWjLW5ZBdoVsH8Dr4kePkUNGJK+LwGcLUh4AAAAAAAAAAAAAAAAAAAAAAAAAAAAAAAAAAAAAAAAAAAAAAAAAAAAAAAAAAAAAAAAAQAAAAAAAAAAAAAAAAAAAAAAAAAAAAAAAAAAAAAAAAAAAAAAAAAAAAEAAAAAPAEAAAAAAAAIAAAAMTI1NTY1LjAqAQAAeyJ3YXNfZmlyc3RfZXZlbnQiOmZhbHNlLCJpbWFnZV9pZCI6WzE2Njg3OTMyODksODQ2NDIwOTI1LDE3NzU3NjM0MywzODM1ODczODYyLDY2MzMzNTUzLDI4OTQ1NjYwMzAsNTk4Mjc1ODE1LDI3MTgyNzg1ODBdLCJxZiI6eyJiIjpbMCwwLDAsMCwwLDAsMCwwLDAsMCwwLDAsMCwwLDAsMCwwLDAsMCwwLDAsMCwwLDAsMCwwLDAsMCwwLDAsMCwwLDAsMCwwLDAsMCwwLDAsMCwwLDAsMCwwLDAsMCwwLDAsMCwwLDAsMCwwLDAsMCwwLDAsMCwwLDAsMCwwLDAsMCwwLDAsMCwwLDAsMCwwLDAsMF0sImwiOjAsInEiOjYsInIiOjd9fQAAAAAAAAAAAAAAAAAAPAEAAAAAAAAIAAAAMTI1NTY1LjAqAQAAeyJ3YXNfZmlyc3RfZXZlbnQiOmZhbHNlLCJpbWFnZV9pZCI6WzE2Njg3OTMyODksODQ2NDIwOTI1LDE3NzU3NjM0MywzODM1ODczODYyLDY2MzMzNTUzLDI4OTQ1NjYwMzAsNTk4Mjc1ODE1LDI3MTgyNzg1ODBdLCJxZiI6eyJiIjpbMCwwLDAsMCwwLDAsMCwwLDAsMCwwLDAsMCwwLDAsMCwwLDAsMCwwLDAsMCwwLDAsMCwwLDAsMCwwLDAsMCwwLDAsMCwwLDAsMCwwLDAsMCwwLDAsMCwwLDAsMCwwLDAsMCwwLDAsMCwwLDAsMCwwLDAsMCwwLDAsMCwwLDAsMCwwLDAsMCwwLDAsMCwwLDAsMF0sImwiOjAsInEiOjYsInIiOjd9fQAAAAAAAAAAAAAAAAAAAAAAAAAAAAAAAAAAAAAAAAAAAAA='}}
prove_52;88;71;Mul;6248;131813;0.0;833;3.558501792000243;{'verificationValue': 0.0, 'proof': {'imageId': [1668793289, 846420925, 177576343, 3835873862, 66333553, 2894566030, 598275815, 2718278580], 'receipt': 'AwAAAAAAAAAAAAAAFPIgAEBa/KxpnrWjLW5ZBdoVsH8Dr4kePkUNGJK+LwGcLUh4AAAAAAAAAAAAAAAAAAAAAAAAAAAAAAAAAAAAAAAAAAAAAAAAAAAAAAAAAAAAAAAAAQAAAAAAAAAAAAAAAAAAAAAAAAAAAAAAAAAAAAAAAAAAAAAAAAAAAAEAAAAAPAEAAAAAAAAIAAAAMTMxODEzLjAqAQAAeyJ3YXNfZmlyc3RfZXZlbnQiOmZhbHNlLCJpbWFnZV9pZCI6WzE2Njg3OTMyODksODQ2NDIwOTI1LDE3NzU3NjM0MywzODM1ODczODYyLDY2MzMzNTUzLDI4OTQ1NjYwMzAsNTk4Mjc1ODE1LDI3MTgyNzg1ODBdLCJxZiI6eyJiIjpbMCwwLDAsMCwwLDAsMCwwLDAsMCwwLDAsMCwwLDAsMCwwLDAsMCwwLDAsMCwwLDAsMCwwLDAsMCwwLDAsMCwwLDAsMCwwLDAsMCwwLDAsMCwwLDAsMCwwLDAsMCwwLDAsMCwwLDAsMCwwLDAsMCwwLDAsMCwwLDAsMCwwLDAsMCwwLDAsMCwwLDAsMCwwLDAsMF0sImwiOjAsInEiOjYsInIiOjd9fQAAAAAAAAAAAAAAAAAAPAEAAAAAAAAIAAAAMTMxODEzLjAqAQAAeyJ3YXNfZmlyc3RfZXZlbnQiOmZhbHNlLCJpbWFnZV9pZCI6WzE2Njg3OTMyODksODQ2NDIwOTI1LDE3NzU3NjM0MywzODM1ODczODYyLDY2MzMzNTUzLDI4OTQ1NjYwMzAsNTk4Mjc1ODE1LDI3MTgyNzg1ODBdLCJxZiI6eyJiIjpbMCwwLDAsMCwwLDAsMCwwLDAsMCwwLDAsMCwwLDAsMCwwLDAsMCwwLDAsMCwwLDAsMCwwLDAsMCwwLDAsMCwwLDAsMCwwLDAsMCwwLDAsMCwwLDAsMCwwLDAsMCwwLDAsMCwwLDAsMCwwLDAsMCwwLDAsMCwwLDAsMCwwLDAsMCwwLDAsMCwwLDAsMCwwLDAsMF0sImwiOjAsInEiOjYsInIiOjd9fQAAAAAAAAAAAAAAAAAAAAAAAAAAAAAAAAAAAAAAAAAAAAA='}}
prove_53;13;13;Mul;169;131982;0.0;833;3.568519959000696;{'verificationValue': 0.0, 'proof': {'imageId': [1668793289, 846420925, 177576343, 3835873862, 66333553, 2894566030, 598275815, 2718278580], 'receipt': 'AwAAAAAAAAAAAAAAFPIgAEBa/KxpnrWjLW5ZBdoVsH8Dr4kePkUNGJK+LwGcLUh4AAAAAAAAAAAAAAAAAAAAAAAAAAAAAAAAAAAAAAAAAAAAAAAAAAAAAAAAAAAAAAAAAQAAAAAAAAAAAAAAAAAAAAAAAAAAAAAAAAAAAAAAAAAAAAAAAAAAAAEAAAAAPAEAAAAAAAAIAAAAMTMxOTgyLjAqAQAAeyJ3YXNfZmlyc3RfZXZlbnQiOmZhbHNlLCJpbWFnZV9pZCI6WzE2Njg3OTMyODksODQ2NDIwOTI1LDE3NzU3NjM0MywzODM1ODczODYyLDY2MzMzNTUzLDI4OTQ1NjYwMzAsNTk4Mjc1ODE1LDI3MTgyNzg1ODBdLCJxZiI6eyJiIjpbMCwwLDAsMCwwLDAsMCwwLDAsMCwwLDAsMCwwLDAsMCwwLDAsMCwwLDAsMCwwLDAsMCwwLDAsMCwwLDAsMCwwLDAsMCwwLDAsMCwwLDAsMCwwLDAsMCwwLDAsMCwwLDAsMCwwLDAsMCwwLDAsMCwwLDAsMCwwLDAsMCwwLDAsMCwwLDAsMCwwLDAsMCwwLDAsMF0sImwiOjAsInEiOjYsInIiOjd9fQAAAAAAAAAAAAAAAAAAPAEAAAAAAAAIAAAAMTMxOTgyLjAqAQAAeyJ3YXNfZmlyc3RfZXZlbnQiOmZhbHNlLCJpbWFnZV9pZCI6WzE2Njg3OTMyODksODQ2NDIwOTI1LDE3NzU3NjM0MywzODM1ODczODYyLDY2MzMzNTUzLDI4OTQ1NjYwMzAsNTk4Mjc1ODE1LDI3MTgyNzg1ODBdLCJxZiI6eyJiIjpbMCwwLDAsMCwwLDAsMCwwLDAsMCwwLDAsMCwwLDAsMCwwLDAsMCwwLDAsMCwwLDAsMCwwLDAsMCwwLDAsMCwwLDAsMCwwLDAsMCwwLDAsMCwwLDAsMCwwLDAsMCwwLDAsMCwwLDAsMCwwLDAsMCwwLDAsMCwwLDAsMCwwLDAsMCwwLDAsMCwwLDAsMCwwLDAsMF0sImwiOjAsInEiOjYsInIiOjd9fQAAAAAAAAAAAAAAAAAAAAAAAAAAAAAAAAAAAAAAAAAAAAA='}}
prove_54;94;68;Mul;6392;138374;0.0;833;3.6279892919992562;{'verificationValue': 0.0, 'proof': {'imageId': [1668793289, 846420925, 177576343, 3835873862, 66333553, 2894566030, 598275815, 2718278580], 'receipt': 'AwAAAAAAAAAAAAAAFPIgAEBa/KxpnrWjLW5ZBdoVsH8Dr4kePkUNGJK+LwGcLUh4AAAAAAAAAAAAAAAAAAAAAAAAAAAAAAAAAAAAAAAAAAAAAAAAAAAAAAAAAAAAAAAAAQAAAAAAAAAAAAAAAAAAAAAAAAAAAAAAAAAAAAAAAAAAAAAAAAAAAAEAAAAAPAEAAAAAAAAIAAAAMTM4Mzc0LjAqAQAAeyJ3YXNfZmlyc3RfZXZlbnQiOmZhbHNlLCJpbWFnZV9pZCI6WzE2Njg3OTMyODksODQ2NDIwOTI1LDE3NzU3NjM0MywzODM1ODczODYyLDY2MzMzNTUzLDI4OTQ1NjYwMzAsNTk4Mjc1ODE1LDI3MTgyNzg1ODBdLCJxZiI6eyJiIjpbMCwwLDAsMCwwLDAsMCwwLDAsMCwwLDAsMCwwLDAsMCwwLDAsMCwwLDAsMCwwLDAsMCwwLDAsMCwwLDAsMCwwLDAsMCwwLDAsMCwwLDAsMCwwLDAsMCwwLDAsMCwwLDAsMCwwLDAsMCwwLDAsMCwwLDAsMCwwLDAsMCwwLDAsMCwwLDAsMCwwLDAsMCwwLDAsMF0sImwiOjAsInEiOjYsInIiOjd9fQAAAAAAAAAAAAAAAAAAPAEAAAAAAAAIAAAAMTM4Mzc0LjAqAQAAeyJ3YXNfZmlyc3RfZXZlbnQiOmZhbHNlLCJpbWFnZV9pZCI6WzE2Njg3OTMyODksODQ2NDIwOTI1LDE3NzU3NjM0MywzODM1ODczODYyLDY2MzMzNTUzLDI4OTQ1NjYwMzAsNTk4Mjc1ODE1LDI3MTgyNzg1ODBdLCJxZiI6eyJiIjpbMCwwLDAsMCwwLDAsMCwwLDAsMCwwLDAsMCwwLDAsMCwwLDAsMCwwLDAsMCwwLDAsMCwwLDAsMCwwLDAsMCwwLDAsMCwwLDAsMCwwLDAsMCwwLDAsMCwwLDAsMCwwLDAsMCwwLDAsMCwwLDAsMCwwLDAsMCwwLDAsMCwwLDAsMCwwLDAsMCwwLDAsMCwwLDAsMF0sImwiOjAsInEiOjYsInIiOjd9fQAAAAAAAAAAAAAAAAAAAAAAAAAAAAAAAAAAAAAAAAAAAAA='}}
prove_55;68;52;Mul;3536;141910;0.0;833;3.753265499999543;{'verificationValue': 0.0, 'proof': {'imageId': [1668793289, 846420925, 177576343, 3835873862, 66333553, 2894566030, 598275815, 2718278580], 'receipt': 'AwAAAAAAAAAAAAAAFPIgAEBa/KxpnrWjLW5ZBdoVsH8Dr4kePkUNGJK+LwGcLUh4AAAAAAAAAAAAAAAAAAAAAAAAAAAAAAAAAAAAAAAAAAAAAAAAAAAAAAAAAAAAAAAAAQAAAAAAAAAAAAAAAAAAAAAAAAAAAAAAAAAAAAAAAAAAAAAAAAAAAAEAAAAAPAEAAAAAAAAIAAAAMTQxOTEwLjAqAQAAeyJ3YXNfZmlyc3RfZXZlbnQiOmZhbHNlLCJpbWFnZV9pZCI6WzE2Njg3OTMyODksODQ2NDIwOTI1LDE3NzU3NjM0MywzODM1ODczODYyLDY2MzMzNTUzLDI4OTQ1NjYwMzAsNTk4Mjc1ODE1LDI3MTgyNzg1ODBdLCJxZiI6eyJiIjpbMCwwLDAsMCwwLDAsMCwwLDAsMCwwLDAsMCwwLDAsMCwwLDAsMCwwLDAsMCwwLDAsMCwwLDAsMCwwLDAsMCwwLDAsMCwwLDAsMCwwLDAsMCwwLDAsMCwwLDAsMCwwLDAsMCwwLDAsMCwwLDAsMCwwLDAsMCwwLDAsMCwwLDAsMCwwLDAsMCwwLDAsMCwwLDAsMF0sImwiOjAsInEiOjYsInIiOjd9fQAAAAAAAAAAAAAAAAAAPAEAAAAAAAAIAAAAMTQxOTEwLjAqAQAAeyJ3YXNfZmlyc3RfZXZlbnQiOmZhbHNlLCJpbWFnZV9pZCI6WzE2Njg3OTMyODksODQ2NDIwOTI1LDE3NzU3NjM0MywzODM1ODczODYyLDY2MzMzNTUzLDI4OTQ1NjYwMzAsNTk4Mjc1ODE1LDI3MTgyNzg1ODBdLCJxZiI6eyJiIjpbMCwwLDAsMCwwLDAsMCwwLDAsMCwwLDAsMCwwLDAsMCwwLDAsMCwwLDAsMCwwLDAsMCwwLDAsMCwwLDAsMCwwLDAsMCwwLDAsMCwwLDAsMCwwLDAsMCwwLDAsMCwwLDAsMCwwLDAsMCwwLDAsMCwwLDAsMCwwLDAsMCwwLDAsMCwwLDAsMCwwLDAsMCwwLDAsMF0sImwiOjAsInEiOjYsInIiOjd9fQAAAAAAAAAAAAAAAAAAAAAAAAAAAAAAAAAAAAAAAAAAAAA='}}
prove_56;44;75;Mul;3300;145210;0.0;833;3.849731250000332;{'verificationValue': 0.0, 'proof': {'imageId': [1668793289, 846420925, 177576343, 3835873862, 66333553, 2894566030, 598275815, 2718278580], 'receipt': 'AwAAAAAAAAAAAAAAFPIgAEBa/KxpnrWjLW5ZBdoVsH8Dr4kePkUNGJK+LwGcLUh4AAAAAAAAAAAAAAAAAAAAAAAAAAAAAAAAAAAAAAAAAAAAAAAAAAAAAAAAAAAAAAAAAQAAAAAAAAAAAAAAAAAAAAAAAAAAAAAAAAAAAAAAAAAAAAAAAAAAAAEAAAAAPAEAAAAAAAAIAAAAMTQ1MjEwLjAqAQAAeyJ3YXNfZmlyc3RfZXZlbnQiOmZhbHNlLCJpbWFnZV9pZCI6WzE2Njg3OTMyODksODQ2NDIwOTI1LDE3NzU3NjM0MywzODM1ODczODYyLDY2MzMzNTUzLDI4OTQ1NjYwMzAsNTk4Mjc1ODE1LDI3MTgyNzg1ODBdLCJxZiI6eyJiIjpbMCwwLDAsMCwwLDAsMCwwLDAsMCwwLDAsMCwwLDAsMCwwLDAsMCwwLDAsMCwwLDAsMCwwLDAsMCwwLDAsMCwwLDAsMCwwLDAsMCwwLDAsMCwwLDAsMCwwLDAsMCwwLDAsMCwwLDAsMCwwLDAsMCwwLDAsMCwwLDAsMCwwLDAsMCwwLDAsMCwwLDAsMCwwLDAsMF0sImwiOjAsInEiOjYsInIiOjd9fQAAAAAAAAAAAAAAAAAAPAEAAAAAAAAIAAAAMTQ1MjEwLjAqAQAAeyJ3YXNfZmlyc3RfZXZlbnQiOmZhbHNlLCJpbWFnZV9pZCI6WzE2Njg3OTMyODksODQ2NDIwOTI1LDE3NzU3NjM0MywzODM1ODczODYyLDY2MzMzNTUzLDI4OTQ1NjYwMzAsNTk4Mjc1ODE1LDI3MTgyNzg1ODBdLCJxZiI6eyJiIjpbMCwwLDAsMCwwLDAsMCwwLDAsMCwwLDAsMCwwLDAsMCwwLDAsMCwwLDAsMCwwLDAsMCwwLDAsMCwwLDAsMCwwLDAsMCwwLDAsMCwwLDAsMCwwLDAsMCwwLDAsMCwwLDAsMCwwLDAsMCwwLDAsMCwwLDAsMCwwLDAsMCwwLDAsMCwwLDAsMCwwLDAsMCwwLDAsMF0sImwiOjAsInEiOjYsInIiOjd9fQAAAAAAAAAAAAAAAAAAAAAAAAAAAAAAAAAAAAAAAAAAAAA='}}
prove_57;57;47;Mul;2679;147889;0.0;833;3.938524834000418;{'verificationValue': 0.0, 'proof': {'imageId': [1668793289, 846420925, 177576343, 3835873862, 66333553, 2894566030, 598275815, 2718278580], 'receipt': 'AwAAAAAAAAAAAAAAFPIgAEBa/KxpnrWjLW5ZBdoVsH8Dr4kePkUNGJK+LwGcLUh4AAAAAAAAAAAAAAAAAAAAAAAAAAAAAAAAAAAAAAAAAAAAAAAAAAAAAAAAAAAAAAAAAQAAAAAAAAAAAAAAAAAAAAAAAAAAAAAAAAAAAAAAAAAAAAAAAAAAAAEAAAAAPAEAAAAAAAAIAAAAMTQ3ODg5LjAqAQAAeyJ3YXNfZmlyc3RfZXZlbnQiOmZhbHNlLCJpbWFnZV9pZCI6WzE2Njg3OTMyODksODQ2NDIwOTI1LDE3NzU3NjM0MywzODM1ODczODYyLDY2MzMzNTUzLDI4OTQ1NjYwMzAsNTk4Mjc1ODE1LDI3MTgyNzg1ODBdLCJxZiI6eyJiIjpbMCwwLDAsMCwwLDAsMCwwLDAsMCwwLDAsMCwwLDAsMCwwLDAsMCwwLDAsMCwwLDAsMCwwLDAsMCwwLDAsMCwwLDAsMCwwLDAsMCwwLDAsMCwwLDAsMCwwLDAsMCwwLDAsMCwwLDAsMCwwLDAsMCwwLDAsMCwwLDAsMCwwLDAsMCwwLDAsMCwwLDAsMCwwLDAsMF0sImwiOjAsInEiOjYsInIiOjd9fQAAAAAAAAAAAAAAAAAAPAEAAAAAAAAIAAAAMTQ3ODg5LjAqAQAAeyJ3YXNfZmlyc3RfZXZlbnQiOmZhbHNlLCJpbWFnZV9pZCI6WzE2Njg3OTMyODksODQ2NDIwOTI1LDE3NzU3NjM0MywzODM1ODczODYyLDY2MzMzNTUzLDI4OTQ1NjYwMzAsNTk4Mjc1ODE1LDI3MTgyNzg1ODBdLCJxZiI6eyJiIjpbMCwwLDAsMCwwLDAsMCwwLDAsMCwwLDAsMCwwLDAsMCwwLDAsMCwwLDAsMCwwLDAsMCwwLDAsMCwwLDAsMCwwLDAsMCwwLDAsMCwwLDAsMCwwLDAsMCwwLDAsMCwwLDAsMCwwLDAsMCwwLDAsMCwwLDAsMCwwLDAsMCwwLDAsMCwwLDAsMCwwLDAsMCwwLDAsMF0sImwiOjAsInEiOjYsInIiOjd9fQAAAAAAAAAAAAAAAAAAAAAAAAAAAAAAAAAAAAAAAAAAAAA='}}
prove_58;1;94;Mul;94;147983;0.0;833;3.929653708000842;{'verificationValue': 0.0, 'proof': {'imageId': [1668793289, 846420925, 177576343, 3835873862, 66333553, 2894566030, 598275815, 2718278580], 'receipt': 'AwAAAAAAAAAAAAAAFPIgAEBa/KxpnrWjLW5ZBdoVsH8Dr4kePkUNGJK+LwGcLUh4AAAAAAAAAAAAAAAAAAAAAAAAAAAAAAAAAAAAAAAAAAAAAAAAAAAAAAAAAAAAAAAAAQAAAAAAAAAAAAAAAAAAAAAAAAAAAAAAAAAAAAAAAAAAAAAAAAAAAAEAAAAAPAEAAAAAAAAIAAAAMTQ3OTgzLjAqAQAAeyJ3YXNfZmlyc3RfZXZlbnQiOmZhbHNlLCJpbWFnZV9pZCI6WzE2Njg3OTMyODksODQ2NDIwOTI1LDE3NzU3NjM0MywzODM1ODczODYyLDY2MzMzNTUzLDI4OTQ1NjYwMzAsNTk4Mjc1ODE1LDI3MTgyNzg1ODBdLCJxZiI6eyJiIjpbMCwwLDAsMCwwLDAsMCwwLDAsMCwwLDAsMCwwLDAsMCwwLDAsMCwwLDAsMCwwLDAsMCwwLDAsMCwwLDAsMCwwLDAsMCwwLDAsMCwwLDAsMCwwLDAsMCwwLDAsMCwwLDAsMCwwLDAsMCwwLDAsMCwwLDAsMCwwLDAsMCwwLDAsMCwwLDAsMCwwLDAsMCwwLDAsMF0sImwiOjAsInEiOjYsInIiOjd9fQAAAAAAAAAAAAAAAAAAPAEAAAAAAAAIAAAAMTQ3OTgzLjAqAQAAeyJ3YXNfZmlyc3RfZXZlbnQiOmZhbHNlLCJpbWFnZV9pZCI6WzE2Njg3OTMyODksODQ2NDIwOTI1LDE3NzU3NjM0MywzODM1ODczODYyLDY2MzMzNTUzLDI4OTQ1NjYwMzAsNTk4Mjc1ODE1LDI3MTgyNzg1ODBdLCJxZiI6eyJiIjpbMCwwLDAsMCwwLDAsMCwwLDAsMCwwLDAsMCwwLDAsMCwwLDAsMCwwLDAsMCwwLDAsMCwwLDAsMCwwLDAsMCwwLDAsMCwwLDAsMCwwLDAsMCwwLDAsMCwwLDAsMCwwLDAsMCwwLDAsMCwwLDAsMCwwLDAsMCwwLDAsMCwwLDAsMCwwLDAsMCwwLDAsMCwwLDAsMF0sImwiOjAsInEiOjYsInIiOjd9fQAAAAAAAAAAAAAAAAAAAAAAAAAAAAAAAAAAAAAAAAAAAAA='}}
prove_59;22;23;Mul;506;148489;0.0;833;3.9873722920001455;{'verificationValue': 0.0, 'proof': {'imageId': [1668793289, 846420925, 177576343, 3835873862, 66333553, 2894566030, 598275815, 2718278580], 'receipt': 'AwAAAAAAAAAAAAAAFPIgAEBa/KxpnrWjLW5ZBdoVsH8Dr4kePkUNGJK+LwGcLUh4AAAAAAAAAAAAAAAAAAAAAAAAAAAAAAAAAAAAAAAAAAAAAAAAAAAAAAAAAAAAAAAAAQAAAAAAAAAAAAAAAAAAAAAAAAAAAAAAAAAAAAAAAAAAAAAAAAAAAAEAAAAAPAEAAAAAAAAIAAAAMTQ4NDg5LjAqAQAAeyJ3YXNfZmlyc3RfZXZlbnQiOmZhbHNlLCJpbWFnZV9pZCI6WzE2Njg3OTMyODksODQ2NDIwOTI1LDE3NzU3NjM0MywzODM1ODczODYyLDY2MzMzNTUzLDI4OTQ1NjYwMzAsNTk4Mjc1ODE1LDI3MTgyNzg1ODBdLCJxZiI6eyJiIjpbMCwwLDAsMCwwLDAsMCwwLDAsMCwwLDAsMCwwLDAsMCwwLDAsMCwwLDAsMCwwLDAsMCwwLDAsMCwwLDAsMCwwLDAsMCwwLDAsMCwwLDAsMCwwLDAsMCwwLDAsMCwwLDAsMCwwLDAsMCwwLDAsMCwwLDAsMCwwLDAsMCwwLDAsMCwwLDAsMCwwLDAsMCwwLDAsMF0sImwiOjAsInEiOjYsInIiOjd9fQAAAAAAAAAAAAAAAAAAPAEAAAAAAAAIAAAAMTQ4NDg5LjAqAQAAeyJ3YXNfZmlyc3RfZXZlbnQiOmZhbHNlLCJpbWFnZV9pZCI6WzE2Njg3OTMyODksODQ2NDIwOTI1LDE3NzU3NjM0MywzODM1ODczODYyLDY2MzMzNTUzLDI4OTQ1NjYwMzAsNTk4Mjc1ODE1LDI3MTgyNzg1ODBdLCJxZiI6eyJiIjpbMCwwLDAsMCwwLDAsMCwwLDAsMCwwLDAsMCwwLDAsMCwwLDAsMCwwLDAsMCwwLDAsMCwwLDAsMCwwLDAsMCwwLDAsMCwwLDAsMCwwLDAsMCwwLDAsMCwwLDAsMCwwLDAsMCwwLDAsMCwwLDAsMCwwLDAsMCwwLDAsMCwwLDAsMCwwLDAsMCwwLDAsMCwwLDAsMF0sImwiOjAsInEiOjYsInIiOjd9fQAAAAAAAAAAAAAAAAAAAAAAAAAAAAAAAAAAAAAAAAAAAAA='}}
prove_60;7;42;Mul;294;148783;0.0;833;4.105351666001297;{'verificationValue': 0.0, 'proof': {'imageId': [1668793289, 846420925, 177576343, 3835873862, 66333553, 2894566030, 598275815, 2718278580], 'receipt': 'AwAAAAAAAAAAAAAAFPIgAEBa/KxpnrWjLW5ZBdoVsH8Dr4kePkUNGJK+LwGcLUh4AAAAAAAAAAAAAAAAAAAAAAAAAAAAAAAAAAAAAAAAAAAAAAAAAAAAAAAAAAAAAAAAAQAAAAAAAAAAAAAAAAAAAAAAAAAAAAAAAAAAAAAAAAAAAAAAAAAAAAEAAAAAPAEAAAAAAAAIAAAAMTQ4NzgzLjAqAQAAeyJ3YXNfZmlyc3RfZXZlbnQiOmZhbHNlLCJpbWFnZV9pZCI6WzE2Njg3OTMyODksODQ2NDIwOTI1LDE3NzU3NjM0MywzODM1ODczODYyLDY2MzMzNTUzLDI4OTQ1NjYwMzAsNTk4Mjc1ODE1LDI3MTgyNzg1ODBdLCJxZiI6eyJiIjpbMCwwLDAsMCwwLDAsMCwwLDAsMCwwLDAsMCwwLDAsMCwwLDAsMCwwLDAsMCwwLDAsMCwwLDAsMCwwLDAsMCwwLDAsMCwwLDAsMCwwLDAsMCwwLDAsMCwwLDAsMCwwLDAsMCwwLDAsMCwwLDAsMCwwLDAsMCwwLDAsMCwwLDAsMCwwLDAsMCwwLDAsMCwwLDAsMF0sImwiOjAsInEiOjYsInIiOjd9fQAAAAAAAAAAAAAAAAAAPAEAAAAAAAAIAAAAMTQ4NzgzLjAqAQAAeyJ3YXNfZmlyc3RfZXZlbnQiOmZhbHNlLCJpbWFnZV9pZCI6WzE2Njg3OTMyODksODQ2NDIwOTI1LDE3NzU3NjM0MywzODM1ODczODYyLDY2MzMzNTUzLDI4OTQ1NjYwMzAsNTk4Mjc1ODE1LDI3MTgyNzg1ODBdLCJxZiI6eyJiIjpbMCwwLDAsMCwwLDAsMCwwLDAsMCwwLDAsMCwwLDAsMCwwLDAsMCwwLDAsMCwwLDAsMCwwLDAsMCwwLDAsMCwwLDAsMCwwLDAsMCwwLDAsMCwwLDAsMCwwLDAsMCwwLDAsMCwwLDAsMCwwLDAsMCwwLDAsMCwwLDAsMCwwLDAsMCwwLDAsMCwwLDAsMCwwLDAsMF0sImwiOjAsInEiOjYsInIiOjd9fQAAAAAAAAAAAAAAAAAAAAAAAAAAAAAAAAAAAAAAAAAAAAA='}}
prove_61;29;18;Mul;522;149305;0.0;833;4.278164375000415;{'verificationValue': 0.0, 'proof': {'imageId': [1668793289, 846420925, 177576343, 3835873862, 66333553, 2894566030, 598275815, 2718278580], 'receipt': 'AwAAAAAAAAAAAAAAFPIgAEBa/KxpnrWjLW5ZBdoVsH8Dr4kePkUNGJK+LwGcLUh4AAAAAAAAAAAAAAAAAAAAAAAAAAAAAAAAAAAAAAAAAAAAAAAAAAAAAAAAAAAAAAAAAQAAAAAAAAAAAAAAAAAAAAAAAAAAAAAAAAAAAAAAAAAAAAAAAAAAAAEAAAAAPAEAAAAAAAAIAAAAMTQ5MzA1LjAqAQAAeyJ3YXNfZmlyc3RfZXZlbnQiOmZhbHNlLCJpbWFnZV9pZCI6WzE2Njg3OTMyODksODQ2NDIwOTI1LDE3NzU3NjM0MywzODM1ODczODYyLDY2MzMzNTUzLDI4OTQ1NjYwMzAsNTk4Mjc1ODE1LDI3MTgyNzg1ODBdLCJxZiI6eyJiIjpbMCwwLDAsMCwwLDAsMCwwLDAsMCwwLDAsMCwwLDAsMCwwLDAsMCwwLDAsMCwwLDAsMCwwLDAsMCwwLDAsMCwwLDAsMCwwLDAsMCwwLDAsMCwwLDAsMCwwLDAsMCwwLDAsMCwwLDAsMCwwLDAsMCwwLDAsMCwwLDAsMCwwLDAsMCwwLDAsMCwwLDAsMCwwLDAsMF0sImwiOjAsInEiOjYsInIiOjd9fQAAAAAAAAAAAAAAAAAAPAEAAAAAAAAIAAAAMTQ5MzA1LjAqAQAAeyJ3YXNfZmlyc3RfZXZlbnQiOmZhbHNlLCJpbWFnZV9pZCI6WzE2Njg3OTMyODksODQ2NDIwOTI1LDE3NzU3NjM0MywzODM1ODczODYyLDY2MzMzNTUzLDI4OTQ1NjYwMzAsNTk4Mjc1ODE1LDI3MTgyNzg1ODBdLCJxZiI6eyJiIjpbMCwwLDAsMCwwLDAsMCwwLDAsMCwwLDAsMCwwLDAsMCwwLDAsMCwwLDAsMCwwLDAsMCwwLDAsMCwwLDAsMCwwLDAsMCwwLDAsMCwwLDAsMCwwLDAsMCwwLDAsMCwwLDAsMCwwLDAsMCwwLDAsMCwwLDAsMCwwLDAsMCwwLDAsMCwwLDAsMCwwLDAsMCwwLDAsMF0sImwiOjAsInEiOjYsInIiOjd9fQAAAAAAAAAAAAAAAAAAAAAAAAAAAAAAAAAAAAAAAAAAAAA='}}
prove_62;97;21;Mul;2037;151342;0.0;833;4.307040415998927;{'verificationValue': 0.0, 'proof': {'imageId': [1668793289, 846420925, 177576343, 3835873862, 66333553, 2894566030, 598275815, 2718278580], 'receipt': 'AwAAAAAAAAAAAAAAFPIgAEBa/KxpnrWjLW5ZBdoVsH8Dr4kePkUNGJK+LwGcLUh4AAAAAAAAAAAAAAAAAAAAAAAAAAAAAAAAAAAAAAAAAAAAAAAAAAAAAAAAAAAAAAAAAQAAAAAAAAAAAAAAAAAAAAAAAAAAAAAAAAAAAAAAAAAAAAAAAAAAAAEAAAAAPAEAAAAAAAAIAAAAMTUxMzQyLjAqAQAAeyJ3YXNfZmlyc3RfZXZlbnQiOmZhbHNlLCJpbWFnZV9pZCI6WzE2Njg3OTMyODksODQ2NDIwOTI1LDE3NzU3NjM0MywzODM1ODczODYyLDY2MzMzNTUzLDI4OTQ1NjYwMzAsNTk4Mjc1ODE1LDI3MTgyNzg1ODBdLCJxZiI6eyJiIjpbMCwwLDAsMCwwLDAsMCwwLDAsMCwwLDAsMCwwLDAsMCwwLDAsMCwwLDAsMCwwLDAsMCwwLDAsMCwwLDAsMCwwLDAsMCwwLDAsMCwwLDAsMCwwLDAsMCwwLDAsMCwwLDAsMCwwLDAsMCwwLDAsMCwwLDAsMCwwLDAsMCwwLDAsMCwwLDAsMCwwLDAsMCwwLDAsMF0sImwiOjAsInEiOjYsInIiOjd9fQAAAAAAAAAAAAAAAAAAPAEAAAAAAAAIAAAAMTUxMzQyLjAqAQAAeyJ3YXNfZmlyc3RfZXZlbnQiOmZhbHNlLCJpbWFnZV9pZCI6WzE2Njg3OTMyODksODQ2NDIwOTI1LDE3NzU3NjM0MywzODM1ODczODYyLDY2MzMzNTUzLDI4OTQ1NjYwMzAsNTk4Mjc1ODE1LDI3MTgyNzg1ODBdLCJxZiI6eyJiIjpbMCwwLDAsMCwwLDAsMCwwLDAsMCwwLDAsMCwwLDAsMCwwLDAsMCwwLDAsMCwwLDAsMCwwLDAsMCwwLDAsMCwwLDAsMCwwLDAsMCwwLDAsMCwwLDAsMCwwLDAsMCwwLDAsMCwwLDAsMCwwLDAsMCwwLDAsMCwwLDAsMCwwLDAsMCwwLDAsMCwwLDAsMCwwLDAsMF0sImwiOjAsInEiOjYsInIiOjd9fQAAAAAAAAAAAAAAAAAAAAAAAAAAAAAAAAAAAAAAAAAAAAA='}}
prove_63;50;76;Mul;3800;155142;0.0;833;4.400997165999797;{'verificationValue': 0.0, 'proof': {'imageId': [1668793289, 846420925, 177576343, 3835873862, 66333553, 2894566030, 598275815, 2718278580], 'receipt': 'AwAAAAAAAAAAAAAAFPIgAEBa/KxpnrWjLW5ZBdoVsH8Dr4kePkUNGJK+LwGcLUh4AAAAAAAAAAAAAAAAAAAAAAAAAAAAAAAAAAAAAAAAAAAAAAAAAAAAAAAAAAAAAAAAAQAAAAAAAAAAAAAAAAAAAAAAAAAAAAAAAAAAAAAAAAAAAAAAAAAAAAEAAAAAPAEAAAAAAAAIAAAAMTU1MTQyLjAqAQAAeyJ3YXNfZmlyc3RfZXZlbnQiOmZhbHNlLCJpbWFnZV9pZCI6WzE2Njg3OTMyODksODQ2NDIwOTI1LDE3NzU3NjM0MywzODM1ODczODYyLDY2MzMzNTUzLDI4OTQ1NjYwMzAsNTk4Mjc1ODE1LDI3MTgyNzg1ODBdLCJxZiI6eyJiIjpbMCwwLDAsMCwwLDAsMCwwLDAsMCwwLDAsMCwwLDAsMCwwLDAsMCwwLDAsMCwwLDAsMCwwLDAsMCwwLDAsMCwwLDAsMCwwLDAsMCwwLDAsMCwwLDAsMCwwLDAsMCwwLDAsMCwwLDAsMCwwLDAsMCwwLDAsMCwwLDAsMCwwLDAsMCwwLDAsMCwwLDAsMCwwLDAsMF0sImwiOjAsInEiOjYsInIiOjd9fQAAAAAAAAAAAAAAAAAAPAEAAAAAAAAIAAAAMTU1MTQyLjAqAQAAeyJ3YXNfZmlyc3RfZXZlbnQiOmZhbHNlLCJpbWFnZV9pZCI6WzE2Njg3OTMyODksODQ2NDIwOTI1LDE3NzU3NjM0MywzODM1ODczODYyLDY2MzMzNTUzLDI4OTQ1NjYwMzAsNTk4Mjc1ODE1LDI3MTgyNzg1ODBdLCJxZiI6eyJiIjpbMCwwLDAsMCwwLDAsMCwwLDAsMCwwLDAsMCwwLDAsMCwwLDAsMCwwLDAsMCwwLDAsMCwwLDAsMCwwLDAsMCwwLDAsMCwwLDAsMCwwLDAsMCwwLDAsMCwwLDAsMCwwLDAsMCwwLDAsMCwwLDAsMCwwLDAsMCwwLDAsMCwwLDAsMCwwLDAsMCwwLDAsMCwwLDAsMF0sImwiOjAsInEiOjYsInIiOjd9fQAAAAAAAAAAAAAAAAAAAAAAAAAAAAAAAAAAAAAAAAAAAAA='}}
prove_64;6;22;Mul;132;155274;0.0;833;4.665958249999676;{'verificationValue': 0.0, 'proof': {'imageId': [1668793289, 846420925, 177576343, 3835873862, 66333553, 2894566030, 598275815, 2718278580], 'receipt': 'AwAAAAAAAAAAAAAAFPIgAEBa/KxpnrWjLW5ZBdoVsH8Dr4kePkUNGJK+LwGcLUh4AAAAAAAAAAAAAAAAAAAAAAAAAAAAAAAAAAAAAAAAAAAAAAAAAAAAAAAAAAAAAAAAAQAAAAAAAAAAAAAAAAAAAAAAAAAAAAAAAAAAAAAAAAAAAAAAAAAAAAEAAAAAPAEAAAAAAAAIAAAAMTU1Mjc0LjAqAQAAeyJ3YXNfZmlyc3RfZXZlbnQiOmZhbHNlLCJpbWFnZV9pZCI6WzE2Njg3OTMyODksODQ2NDIwOTI1LDE3NzU3NjM0MywzODM1ODczODYyLDY2MzMzNTUzLDI4OTQ1NjYwMzAsNTk4Mjc1ODE1LDI3MTgyNzg1ODBdLCJxZiI6eyJiIjpbMCwwLDAsMCwwLDAsMCwwLDAsMCwwLDAsMCwwLDAsMCwwLDAsMCwwLDAsMCwwLDAsMCwwLDAsMCwwLDAsMCwwLDAsMCwwLDAsMCwwLDAsMCwwLDAsMCwwLDAsMCwwLDAsMCwwLDAsMCwwLDAsMCwwLDAsMCwwLDAsMCwwLDAsMCwwLDAsMCwwLDAsMCwwLDAsMF0sImwiOjAsInEiOjYsInIiOjd9fQAAAAAAAAAAAAAAAAAAPAEAAAAAAAAIAAAAMTU1Mjc0LjAqAQAAeyJ3YXNfZmlyc3RfZXZlbnQiOmZhbHNlLCJpbWFnZV9pZCI6WzE2Njg3OTMyODksODQ2NDIwOTI1LDE3NzU3NjM0MywzODM1ODczODYyLDY2MzMzNTUzLDI4OTQ1NjYwMzAsNTk4Mjc1ODE1LDI3MTgyNzg1ODBdLCJxZiI6eyJiIjpbMCwwLDAsMCwwLDAsMCwwLDAsMCwwLDAsMCwwLDAsMCwwLDAsMCwwLDAsMCwwLDAsMCwwLDAsMCwwLDAsMCwwLDAsMCwwLDAsMCwwLDAsMCwwLDAsMCwwLDAsMCwwLDAsMCwwLDAsMCwwLDAsMCwwLDAsMCwwLDAsMCwwLDAsMCwwLDAsMCwwLDAsMCwwLDAsMF0sImwiOjAsInEiOjYsInIiOjd9fQAAAAAAAAAAAAAAAAAAAAAAAAAAAAAAAAAAAAAAAAAAAAA='}}
prove_65;32;93;Mul;2976;158250;0.0;833;4.503249916999266;{'verificationValue': 0.0, 'proof': {'imageId': [1668793289, 846420925, 177576343, 3835873862, 66333553, 2894566030, 598275815, 2718278580], 'receipt': 'AwAAAAAAAAAAAAAAFPIgAEBa/KxpnrWjLW5ZBdoVsH8Dr4kePkUNGJK+LwGcLUh4AAAAAAAAAAAAAAAAAAAAAAAAAAAAAAAAAAAAAAAAAAAAAAAAAAAAAAAAAAAAAAAAAQAAAAAAAAAAAAAAAAAAAAAAAAAAAAAAAAAAAAAAAAAAAAAAAAAAAAEAAAAAPAEAAAAAAAAIAAAAMTU4MjUwLjAqAQAAeyJ3YXNfZmlyc3RfZXZlbnQiOmZhbHNlLCJpbWFnZV9pZCI6WzE2Njg3OTMyODksODQ2NDIwOTI1LDE3NzU3NjM0MywzODM1ODczODYyLDY2MzMzNTUzLDI4OTQ1NjYwMzAsNTk4Mjc1ODE1LDI3MTgyNzg1ODBdLCJxZiI6eyJiIjpbMCwwLDAsMCwwLDAsMCwwLDAsMCwwLDAsMCwwLDAsMCwwLDAsMCwwLDAsMCwwLDAsMCwwLDAsMCwwLDAsMCwwLDAsMCwwLDAsMCwwLDAsMCwwLDAsMCwwLDAsMCwwLDAsMCwwLDAsMCwwLDAsMCwwLDAsMCwwLDAsMCwwLDAsMCwwLDAsMCwwLDAsMCwwLDAsMF0sImwiOjAsInEiOjYsInIiOjd9fQAAAAAAAAAAAAAAAAAAPAEAAAAAAAAIAAAAMTU4MjUwLjAqAQAAeyJ3YXNfZmlyc3RfZXZlbnQiOmZhbHNlLCJpbWFnZV9pZCI6WzE2Njg3OTMyODksODQ2NDIwOTI1LDE3NzU3NjM0MywzODM1ODczODYyLDY2MzMzNTUzLDI4OTQ1NjYwMzAsNTk4Mjc1ODE1LDI3MTgyNzg1ODBdLCJxZiI6eyJiIjpbMCwwLDAsMCwwLDAsMCwwLDAsMCwwLDAsMCwwLDAsMCwwLDAsMCwwLDAsMCwwLDAsMCwwLDAsMCwwLDAsMCwwLDAsMCwwLDAsMCwwLDAsMCwwLDAsMCwwLDAsMCwwLDAsMCwwLDAsMCwwLDAsMCwwLDAsMCwwLDAsMCwwLDAsMCwwLDAsMCwwLDAsMCwwLDAsMF0sImwiOjAsInEiOjYsInIiOjd9fQAAAAAAAAAAAAAAAAAAAAAAAAAAAAAAAAAAAAAAAAAAAAA='}}
prove_66;43;99;Mul;4257;162507;0.0;833;4.615479375001087;{'verificationValue': 0.0, 'proof': {'imageId': [1668793289, 846420925, 177576343, 3835873862, 66333553, 2894566030, 598275815, 2718278580], 'receipt': 'AwAAAAAAAAAAAAAAFPIgAEBa/KxpnrWjLW5ZBdoVsH8Dr4kePkUNGJK+LwGcLUh4AAAAAAAAAAAAAAAAAAAAAAAAAAAAAAAAAAAAAAAAAAAAAAAAAAAAAAAAAAAAAAAAAQAAAAAAAAAAAAAAAAAAAAAAAAAAAAAAAAAAAAAAAAAAAAAAAAAAAAEAAAAAPAEAAAAAAAAIAAAAMTYyNTA3LjAqAQAAeyJ3YXNfZmlyc3RfZXZlbnQiOmZhbHNlLCJpbWFnZV9pZCI6WzE2Njg3OTMyODksODQ2NDIwOTI1LDE3NzU3NjM0MywzODM1ODczODYyLDY2MzMzNTUzLDI4OTQ1NjYwMzAsNTk4Mjc1ODE1LDI3MTgyNzg1ODBdLCJxZiI6eyJiIjpbMCwwLDAsMCwwLDAsMCwwLDAsMCwwLDAsMCwwLDAsMCwwLDAsMCwwLDAsMCwwLDAsMCwwLDAsMCwwLDAsMCwwLDAsMCwwLDAsMCwwLDAsMCwwLDAsMCwwLDAsMCwwLDAsMCwwLDAsMCwwLDAsMCwwLDAsMCwwLDAsMCwwLDAsMCwwLDAsMCwwLDAsMCwwLDAsMF0sImwiOjAsInEiOjYsInIiOjd9fQAAAAAAAAAAAAAAAAAAPAEAAAAAAAAIAAAAMTYyNTA3LjAqAQAAeyJ3YXNfZmlyc3RfZXZlbnQiOmZhbHNlLCJpbWFnZV9pZCI6WzE2Njg3OTMyODksODQ2NDIwOTI1LDE3NzU3NjM0MywzODM1ODczODYyLDY2MzMzNTUzLDI4OTQ1NjYwMzAsNTk4Mjc1ODE1LDI3MTgyNzg1ODBdLCJxZiI6eyJiIjpbMCwwLDAsMCwwLDAsMCwwLDAsMCwwLDAsMCwwLDAsMCwwLDAsMCwwLDAsMCwwLDAsMCwwLDAsMCwwLDAsMCwwLDAsMCwwLDAsMCwwLDAsMCwwLDAsMCwwLDAsMCwwLDAsMCwwLDAsMCwwLDAsMCwwLDAsMCwwLDAsMCwwLDAsMCwwLDAsMCwwLDAsMCwwLDAsMF0sImwiOjAsInEiOjYsInIiOjd9fQAAAAAAAAAAAAAAAAAAAAAAAAAAAAAAAAAAAAAAAAAAAAA='}}
prove_67;34;79;Mul;2686;165193;0.0;833;4.586325915999623;{'verificationValue': 0.0, 'proof': {'imageId': [1668793289, 846420925, 177576343, 3835873862, 66333553, 2894566030, 598275815, 2718278580], 'receipt': 'AwAAAAAAAAAAAAAAFPIgAEBa/KxpnrWjLW5ZBdoVsH8Dr4kePkUNGJK+LwGcLUh4AAAAAAAAAAAAAAAAAAAAAAAAAAAAAAAAAAAAAAAAAAAAAAAAAAAAAAAAAAAAAAAAAQAAAAAAAAAAAAAAAAAAAAAAAAAAAAAAAAAAAAAAAAAAAAAAAAAAAAEAAAAAPAEAAAAAAAAIAAAAMTY1MTkzLjAqAQAAeyJ3YXNfZmlyc3RfZXZlbnQiOmZhbHNlLCJpbWFnZV9pZCI6WzE2Njg3OTMyODksODQ2NDIwOTI1LDE3NzU3NjM0MywzODM1ODczODYyLDY2MzMzNTUzLDI4OTQ1NjYwMzAsNTk4Mjc1ODE1LDI3MTgyNzg1ODBdLCJxZiI6eyJiIjpbMCwwLDAsMCwwLDAsMCwwLDAsMCwwLDAsMCwwLDAsMCwwLDAsMCwwLDAsMCwwLDAsMCwwLDAsMCwwLDAsMCwwLDAsMCwwLDAsMCwwLDAsMCwwLDAsMCwwLDAsMCwwLDAsMCwwLDAsMCwwLDAsMCwwLDAsMCwwLDAsMCwwLDAsMCwwLDAsMCwwLDAsMCwwLDAsMF0sImwiOjAsInEiOjYsInIiOjd9fQAAAAAAAAAAAAAAAAAAPAEAAAAAAAAIAAAAMTY1MTkzLjAqAQAAeyJ3YXNfZmlyc3RfZXZlbnQiOmZhbHNlLCJpbWFnZV9pZCI6WzE2Njg3OTMyODksODQ2NDIwOTI1LDE3NzU3NjM0MywzODM1ODczODYyLDY2MzMzNTUzLDI4OTQ1NjYwMzAsNTk4Mjc1ODE1LDI3MTgyNzg1ODBdLCJxZiI6eyJiIjpbMCwwLDAsMCwwLDAsMCwwLDAsMCwwLDAsMCwwLDAsMCwwLDAsMCwwLDAsMCwwLDAsMCwwLDAsMCwwLDAsMCwwLDAsMCwwLDAsMCwwLDAsMCwwLDAsMCwwLDAsMCwwLDAsMCwwLDAsMCwwLDAsMCwwLDAsMCwwLDAsMCwwLDAsMCwwLDAsMCwwLDAsMCwwLDAsMF0sImwiOjAsInEiOjYsInIiOjd9fQAAAAAAAAAAAAAAAAAAAAAAAAAAAAAAAAAAAAAAAAAAAAA='}}
prove_68;71;32;Mul;2272;167465;0.0;833;4.692214750000858;{'verificationValue': 0.0, 'proof': {'imageId': [1668793289, 846420925, 177576343, 3835873862, 66333553, 2894566030, 598275815, 2718278580], 'receipt': 'AwAAAAAAAAAAAAAAFPIgAEBa/KxpnrWjLW5ZBdoVsH8Dr4kePkUNGJK+LwGcLUh4AAAAAAAAAAAAAAAAAAAAAAAAAAAAAAAAAAAAAAAAAAAAAAAAAAAAAAAAAAAAAAAAAQAAAAAAAAAAAAAAAAAAAAAAAAAAAAAAAAAAAAAAAAAAAAAAAAAAAAEAAAAAPAEAAAAAAAAIAAAAMTY3NDY1LjAqAQAAeyJ3YXNfZmlyc3RfZXZlbnQiOmZhbHNlLCJpbWFnZV9pZCI6WzE2Njg3OTMyODksODQ2NDIwOTI1LDE3NzU3NjM0MywzODM1ODczODYyLDY2MzMzNTUzLDI4OTQ1NjYwMzAsNTk4Mjc1ODE1LDI3MTgyNzg1ODBdLCJxZiI6eyJiIjpbMCwwLDAsMCwwLDAsMCwwLDAsMCwwLDAsMCwwLDAsMCwwLDAsMCwwLDAsMCwwLDAsMCwwLDAsMCwwLDAsMCwwLDAsMCwwLDAsMCwwLDAsMCwwLDAsMCwwLDAsMCwwLDAsMCwwLDAsMCwwLDAsMCwwLDAsMCwwLDAsMCwwLDAsMCwwLDAsMCwwLDAsMCwwLDAsMF0sImwiOjAsInEiOjYsInIiOjd9fQAAAAAAAAAAAAAAAAAAPAEAAAAAAAAIAAAAMTY3NDY1LjAqAQAAeyJ3YXNfZmlyc3RfZXZlbnQiOmZhbHNlLCJpbWFnZV9pZCI6WzE2Njg3OTMyODksODQ2NDIwOTI1LDE3NzU3NjM0MywzODM1ODczODYyLDY2MzMzNTUzLDI4OTQ1NjYwMzAsNTk4Mjc1ODE1LDI3MTgyNzg1ODBdLCJxZiI6eyJiIjpbMCwwLDAsMCwwLDAsMCwwLDAsMCwwLDAsMCwwLDAsMCwwLDAsMCwwLDAsMCwwLDAsMCwwLDAsMCwwLDAsMCwwLDAsMCwwLDAsMCwwLDAsMCwwLDAsMCwwLDAsMCwwLDAsMCwwLDAsMCwwLDAsMCwwLDAsMCwwLDAsMCwwLDAsMCwwLDAsMCwwLDAsMCwwLDAsMF0sImwiOjAsInEiOjYsInIiOjd9fQAAAAAAAAAAAAAAAAAAAAAAAAAAAAAAAAAAAAAAAAAAAAA='}}
prove_69;94;15;Mul;1410;168875;0.0;833;4.71181549999892;{'verificationValue': 0.0, 'proof': {'imageId': [1668793289, 846420925, 177576343, 3835873862, 66333553, 2894566030, 598275815, 2718278580], 'receipt': 'AwAAAAAAAAAAAAAAFPIgAEBa/KxpnrWjLW5ZBdoVsH8Dr4kePkUNGJK+LwGcLUh4AAAAAAAAAAAAAAAAAAAAAAAAAAAAAAAAAAAAAAAAAAAAAAAAAAAAAAAAAAAAAAAAAQAAAAAAAAAAAAAAAAAAAAAAAAAAAAAAAAAAAAAAAAAAAAAAAAAAAAEAAAAAPAEAAAAAAAAIAAAAMTY4ODc1LjAqAQAAeyJ3YXNfZmlyc3RfZXZlbnQiOmZhbHNlLCJpbWFnZV9pZCI6WzE2Njg3OTMyODksODQ2NDIwOTI1LDE3NzU3NjM0MywzODM1ODczODYyLDY2MzMzNTUzLDI4OTQ1NjYwMzAsNTk4Mjc1ODE1LDI3MTgyNzg1ODBdLCJxZiI6eyJiIjpbMCwwLDAsMCwwLDAsMCwwLDAsMCwwLDAsMCwwLDAsMCwwLDAsMCwwLDAsMCwwLDAsMCwwLDAsMCwwLDAsMCwwLDAsMCwwLDAsMCwwLDAsMCwwLDAsMCwwLDAsMCwwLDAsMCwwLDAsMCwwLDAsMCwwLDAsMCwwLDAsMCwwLDAsMCwwLDAsMCwwLDAsMCwwLDAsMF0sImwiOjAsInEiOjYsInIiOjd9fQAAAAAAAAAAAAAAAAAAPAEAAAAAAAAIAAAAMTY4ODc1LjAqAQAAeyJ3YXNfZmlyc3RfZXZlbnQiOmZhbHNlLCJpbWFnZV9pZCI6WzE2Njg3OTMyODksODQ2NDIwOTI1LDE3NzU3NjM0MywzODM1ODczODYyLDY2MzMzNTUzLDI4OTQ1NjYwMzAsNTk4Mjc1ODE1LDI3MTgyNzg1ODBdLCJxZiI6eyJiIjpbMCwwLDAsMCwwLDAsMCwwLDAsMCwwLDAsMCwwLDAsMCwwLDAsMCwwLDAsMCwwLDAsMCwwLDAsMCwwLDAsMCwwLDAsMCwwLDAsMCwwLDAsMCwwLDAsMCwwLDAsMCwwLDAsMCwwLDAsMCwwLDAsMCwwLDAsMCwwLDAsMCwwLDAsMCwwLDAsMCwwLDAsMCwwLDAsMF0sImwiOjAsInEiOjYsInIiOjd9fQAAAAAAAAAAAAAAAAAAAAAAAAAAAAAAAAAAAAAAAAAAAAA='}}
prove_70;21;59;Mul;1239;170114;0.0;833;4.886472207999759;{'verificationValue': 0.0, 'proof': {'imageId': [1668793289, 846420925, 177576343, 3835873862, 66333553, 2894566030, 598275815, 2718278580], 'receipt': 'AwAAAAAAAAAAAAAAFPIgAEBa/KxpnrWjLW5ZBdoVsH8Dr4kePkUNGJK+LwGcLUh4AAAAAAAAAAAAAAAAAAAAAAAAAAAAAAAAAAAAAAAAAAAAAAAAAAAAAAAAAAAAAAAAAQAAAAAAAAAAAAAAAAAAAAAAAAAAAAAAAAAAAAAAAAAAAAAAAAAAAAEAAAAAPAEAAAAAAAAIAAAAMTcwMTE0LjAqAQAAeyJ3YXNfZmlyc3RfZXZlbnQiOmZhbHNlLCJpbWFnZV9pZCI6WzE2Njg3OTMyODksODQ2NDIwOTI1LDE3NzU3NjM0MywzODM1ODczODYyLDY2MzMzNTUzLDI4OTQ1NjYwMzAsNTk4Mjc1ODE1LDI3MTgyNzg1ODBdLCJxZiI6eyJiIjpbMCwwLDAsMCwwLDAsMCwwLDAsMCwwLDAsMCwwLDAsMCwwLDAsMCwwLDAsMCwwLDAsMCwwLDAsMCwwLDAsMCwwLDAsMCwwLDAsMCwwLDAsMCwwLDAsMCwwLDAsMCwwLDAsMCwwLDAsMCwwLDAsMCwwLDAsMCwwLDAsMCwwLDAsMCwwLDAsMCwwLDAsMCwwLDAsMF0sImwiOjAsInEiOjYsInIiOjd9fQAAAAAAAAAAAAAAAAAAPAEAAAAAAAAIAAAAMTcwMTE0LjAqAQAAeyJ3YXNfZmlyc3RfZXZlbnQiOmZhbHNlLCJpbWFnZV9pZCI6WzE2Njg3OTMyODksODQ2NDIwOTI1LDE3NzU3NjM0MywzODM1ODczODYyLDY2MzMzNTUzLDI4OTQ1NjYwMzAsNTk4Mjc1ODE1LDI3MTgyNzg1ODBdLCJxZiI6eyJiIjpbMCwwLDAsMCwwLDAsMCwwLDAsMCwwLDAsMCwwLDAsMCwwLDAsMCwwLDAsMCwwLDAsMCwwLDAsMCwwLDAsMCwwLDAsMCwwLDAsMCwwLDAsMCwwLDAsMCwwLDAsMCwwLDAsMCwwLDAsMCwwLDAsMCwwLDAsMCwwLDAsMCwwLDAsMCwwLDAsMCwwLDAsMCwwLDAsMF0sImwiOjAsInEiOjYsInIiOjd9fQAAAAAAAAAAAAAAAAAAAAAAAAAAAAAAAAAAAAAAAAAAAAA='}}
prove_71;99;52;Mul;5148;175262;0.0;833;4.901578667000649;{'verificationValue': 0.0, 'proof': {'imageId': [1668793289, 846420925, 177576343, 3835873862, 66333553, 2894566030, 598275815, 2718278580], 'receipt': 'AwAAAAAAAAAAAAAAFPIgAEBa/KxpnrWjLW5ZBdoVsH8Dr4kePkUNGJK+LwGcLUh4AAAAAAAAAAAAAAAAAAAAAAAAAAAAAAAAAAAAAAAAAAAAAAAAAAAAAAAAAAAAAAAAAQAAAAAAAAAAAAAAAAAAAAAAAAAAAAAAAAAAAAAAAAAAAAAAAAAAAAEAAAAAPAEAAAAAAAAIAAAAMTc1MjYyLjAqAQAAeyJ3YXNfZmlyc3RfZXZlbnQiOmZhbHNlLCJpbWFnZV9pZCI6WzE2Njg3OTMyODksODQ2NDIwOTI1LDE3NzU3NjM0MywzODM1ODczODYyLDY2MzMzNTUzLDI4OTQ1NjYwMzAsNTk4Mjc1ODE1LDI3MTgyNzg1ODBdLCJxZiI6eyJiIjpbMCwwLDAsMCwwLDAsMCwwLDAsMCwwLDAsMCwwLDAsMCwwLDAsMCwwLDAsMCwwLDAsMCwwLDAsMCwwLDAsMCwwLDAsMCwwLDAsMCwwLDAsMCwwLDAsMCwwLDAsMCwwLDAsMCwwLDAsMCwwLDAsMCwwLDAsMCwwLDAsMCwwLDAsMCwwLDAsMCwwLDAsMCwwLDAsMF0sImwiOjAsInEiOjYsInIiOjd9fQAAAAAAAAAAAAAAAAAAPAEAAAAAAAAIAAAAMTc1MjYyLjAqAQAAeyJ3YXNfZmlyc3RfZXZlbnQiOmZhbHNlLCJpbWFnZV9pZCI6WzE2Njg3OTMyODksODQ2NDIwOTI1LDE3NzU3NjM0MywzODM1ODczODYyLDY2MzMzNTUzLDI4OTQ1NjYwMzAsNTk4Mjc1ODE1LDI3MTgyNzg1ODBdLCJxZiI6eyJiIjpbMCwwLDAsMCwwLDAsMCwwLDAsMCwwLDAsMCwwLDAsMCwwLDAsMCwwLDAsMCwwLDAsMCwwLDAsMCwwLDAsMCwwLDAsMCwwLDAsMCwwLDAsMCwwLDAsMCwwLDAsMCwwLDAsMCwwLDAsMCwwLDAsMCwwLDAsMCwwLDAsMCwwLDAsMCwwLDAsMCwwLDAsMCwwLDAsMF0sImwiOjAsInEiOjYsInIiOjd9fQAAAAAAAAAAAAAAAAAAAAAAAAAAAAAAAAAAAAAAAAAAAAA='}}
prove_72;73;74;Mul;5402;180664;0.0;833;4.973910875000001;{'verificationValue': 0.0, 'proof': {'imageId': [1668793289, 846420925, 177576343, 3835873862, 66333553, 2894566030, 598275815, 2718278580], 'receipt': 'AwAAAAAAAAAAAAAAFPIgAEBa/KxpnrWjLW5ZBdoVsH8Dr4kePkUNGJK+LwGcLUh4AAAAAAAAAAAAAAAAAAAAAAAAAAAAAAAAAAAAAAAAAAAAAAAAAAAAAAAAAAAAAAAAAQAAAAAAAAAAAAAAAAAAAAAAAAAAAAAAAAAAAAAAAAAAAAAAAAAAAAEAAAAAPAEAAAAAAAAIAAAAMTgwNjY0LjAqAQAAeyJ3YXNfZmlyc3RfZXZlbnQiOmZhbHNlLCJpbWFnZV9pZCI6WzE2Njg3OTMyODksODQ2NDIwOTI1LDE3NzU3NjM0MywzODM1ODczODYyLDY2MzMzNTUzLDI4OTQ1NjYwMzAsNTk4Mjc1ODE1LDI3MTgyNzg1ODBdLCJxZiI6eyJiIjpbMCwwLDAsMCwwLDAsMCwwLDAsMCwwLDAsMCwwLDAsMCwwLDAsMCwwLDAsMCwwLDAsMCwwLDAsMCwwLDAsMCwwLDAsMCwwLDAsMCwwLDAsMCwwLDAsMCwwLDAsMCwwLDAsMCwwLDAsMCwwLDAsMCwwLDAsMCwwLDAsMCwwLDAsMCwwLDAsMCwwLDAsMCwwLDAsMF0sImwiOjAsInEiOjYsInIiOjd9fQAAAAAAAAAAAAAAAAAAPAEAAAAAAAAIAAAAMTgwNjY0LjAqAQAAeyJ3YXNfZmlyc3RfZXZlbnQiOmZhbHNlLCJpbWFnZV9pZCI6WzE2Njg3OTMyODksODQ2NDIwOTI1LDE3NzU3NjM0MywzODM1ODczODYyLDY2MzMzNTUzLDI4OTQ1NjYwMzAsNTk4Mjc1ODE1LDI3MTgyNzg1ODBdLCJxZiI6eyJiIjpbMCwwLDAsMCwwLDAsMCwwLDAsMCwwLDAsMCwwLDAsMCwwLDAsMCwwLDAsMCwwLDAsMCwwLDAsMCwwLDAsMCwwLDAsMCwwLDAsMCwwLDAsMCwwLDAsMCwwLDAsMCwwLDAsMCwwLDAsMCwwLDAsMCwwLDAsMCwwLDAsMCwwLDAsMCwwLDAsMCwwLDAsMCwwLDAsMF0sImwiOjAsInEiOjYsInIiOjd9fQAAAAAAAAAAAAAAAAAAAAAAAAAAAAAAAAAAAAAAAAAAAAA='}}
prove_73;48;3;Mul;144;180808;0.0;833;5.077341250000245;{'verificationValue': 0.0, 'proof': {'imageId': [1668793289, 846420925, 177576343, 3835873862, 66333553, 2894566030, 598275815, 2718278580], 'receipt': 'AwAAAAAAAAAAAAAAFPIgAEBa/KxpnrWjLW5ZBdoVsH8Dr4kePkUNGJK+LwGcLUh4AAAAAAAAAAAAAAAAAAAAAAAAAAAAAAAAAAAAAAAAAAAAAAAAAAAAAAAAAAAAAAAAAQAAAAAAAAAAAAAAAAAAAAAAAAAAAAAAAAAAAAAAAAAAAAAAAAAAAAEAAAAAPAEAAAAAAAAIAAAAMTgwODA4LjAqAQAAeyJ3YXNfZmlyc3RfZXZlbnQiOmZhbHNlLCJpbWFnZV9pZCI6WzE2Njg3OTMyODksODQ2NDIwOTI1LDE3NzU3NjM0MywzODM1ODczODYyLDY2MzMzNTUzLDI4OTQ1NjYwMzAsNTk4Mjc1ODE1LDI3MTgyNzg1ODBdLCJxZiI6eyJiIjpbMCwwLDAsMCwwLDAsMCwwLDAsMCwwLDAsMCwwLDAsMCwwLDAsMCwwLDAsMCwwLDAsMCwwLDAsMCwwLDAsMCwwLDAsMCwwLDAsMCwwLDAsMCwwLDAsMCwwLDAsMCwwLDAsMCwwLDAsMCwwLDAsMCwwLDAsMCwwLDAsMCwwLDAsMCwwLDAsMCwwLDAsMCwwLDAsMF0sImwiOjAsInEiOjYsInIiOjd9fQAAAAAAAAAAAAAAAAAAPAEAAAAAAAAIAAAAMTgwODA4LjAqAQAAeyJ3YXNfZmlyc3RfZXZlbnQiOmZhbHNlLCJpbWFnZV9pZCI6WzE2Njg3OTMyODksODQ2NDIwOTI1LDE3NzU3NjM0MywzODM1ODczODYyLDY2MzMzNTUzLDI4OTQ1NjYwMzAsNTk4Mjc1ODE1LDI3MTgyNzg1ODBdLCJxZiI6eyJiIjpbMCwwLDAsMCwwLDAsMCwwLDAsMCwwLDAsMCwwLDAsMCwwLDAsMCwwLDAsMCwwLDAsMCwwLDAsMCwwLDAsMCwwLDAsMCwwLDAsMCwwLDAsMCwwLDAsMCwwLDAsMCwwLDAsMCwwLDAsMCwwLDAsMCwwLDAsMCwwLDAsMCwwLDAsMCwwLDAsMCwwLDAsMCwwLDAsMF0sImwiOjAsInEiOjYsInIiOjd9fQAAAAAAAAAAAAAAAAAAAAAAAAAAAAAAAAAAAAAAAAAAAAA='}}
prove_74;8;29;Mul;232;181040;0.0;833;5.256380208998962;{'verificationValue': 0.0, 'proof': {'imageId': [1668793289, 846420925, 177576343, 3835873862, 66333553, 2894566030, 598275815, 2718278580], 'receipt': 'AwAAAAAAAAAAAAAAFPIgAEBa/KxpnrWjLW5ZBdoVsH8Dr4kePkUNGJK+LwGcLUh4AAAAAAAAAAAAAAAAAAAAAAAAAAAAAAAAAAAAAAAAAAAAAAAAAAAAAAAAAAAAAAAAAQAAAAAAAAAAAAAAAAAAAAAAAAAAAAAAAAAAAAAAAAAAAAAAAAAAAAEAAAAAPAEAAAAAAAAIAAAAMTgxMDQwLjAqAQAAeyJ3YXNfZmlyc3RfZXZlbnQiOmZhbHNlLCJpbWFnZV9pZCI6WzE2Njg3OTMyODksODQ2NDIwOTI1LDE3NzU3NjM0MywzODM1ODczODYyLDY2MzMzNTUzLDI4OTQ1NjYwMzAsNTk4Mjc1ODE1LDI3MTgyNzg1ODBdLCJxZiI6eyJiIjpbMCwwLDAsMCwwLDAsMCwwLDAsMCwwLDAsMCwwLDAsMCwwLDAsMCwwLDAsMCwwLDAsMCwwLDAsMCwwLDAsMCwwLDAsMCwwLDAsMCwwLDAsMCwwLDAsMCwwLDAsMCwwLDAsMCwwLDAsMCwwLDAsMCwwLDAsMCwwLDAsMCwwLDAsMCwwLDAsMCwwLDAsMCwwLDAsMF0sImwiOjAsInEiOjYsInIiOjd9fQAAAAAAAAAAAAAAAAAAPAEAAAAAAAAIAAAAMTgxMDQwLjAqAQAAeyJ3YXNfZmlyc3RfZXZlbnQiOmZhbHNlLCJpbWFnZV9pZCI6WzE2Njg3OTMyODksODQ2NDIwOTI1LDE3NzU3NjM0MywzODM1ODczODYyLDY2MzMzNTUzLDI4OTQ1NjYwMzAsNTk4Mjc1ODE1LDI3MTgyNzg1ODBdLCJxZiI6eyJiIjpbMCwwLDAsMCwwLDAsMCwwLDAsMCwwLDAsMCwwLDAsMCwwLDAsMCwwLDAsMCwwLDAsMCwwLDAsMCwwLDAsMCwwLDAsMCwwLDAsMCwwLDAsMCwwLDAsMCwwLDAsMCwwLDAsMCwwLDAsMCwwLDAsMCwwLDAsMCwwLDAsMCwwLDAsMCwwLDAsMCwwLDAsMCwwLDAsMF0sImwiOjAsInEiOjYsInIiOjd9fQAAAAAAAAAAAAAAAAAAAAAAAAAAAAAAAAAAAAAAAAAAAAA='}}
prove_75;15;77;Mul;1155;182195;0.0;833;5.334476083000482;{'verificationValue': 0.0, 'proof': {'imageId': [1668793289, 846420925, 177576343, 3835873862, 66333553, 2894566030, 598275815, 2718278580], 'receipt': 'AwAAAAAAAAAAAAAAFPIgAEBa/KxpnrWjLW5ZBdoVsH8Dr4kePkUNGJK+LwGcLUh4AAAAAAAAAAAAAAAAAAAAAAAAAAAAAAAAAAAAAAAAAAAAAAAAAAAAAAAAAAAAAAAAAQAAAAAAAAAAAAAAAAAAAAAAAAAAAAAAAAAAAAAAAAAAAAAAAAAAAAEAAAAAPAEAAAAAAAAIAAAAMTgyMTk1LjAqAQAAeyJ3YXNfZmlyc3RfZXZlbnQiOmZhbHNlLCJpbWFnZV9pZCI6WzE2Njg3OTMyODksODQ2NDIwOTI1LDE3NzU3NjM0MywzODM1ODczODYyLDY2MzMzNTUzLDI4OTQ1NjYwMzAsNTk4Mjc1ODE1LDI3MTgyNzg1ODBdLCJxZiI6eyJiIjpbMCwwLDAsMCwwLDAsMCwwLDAsMCwwLDAsMCwwLDAsMCwwLDAsMCwwLDAsMCwwLDAsMCwwLDAsMCwwLDAsMCwwLDAsMCwwLDAsMCwwLDAsMCwwLDAsMCwwLDAsMCwwLDAsMCwwLDAsMCwwLDAsMCwwLDAsMCwwLDAsMCwwLDAsMCwwLDAsMCwwLDAsMCwwLDAsMF0sImwiOjAsInEiOjYsInIiOjd9fQAAAAAAAAAAAAAAAAAAPAEAAAAAAAAIAAAAMTgyMTk1LjAqAQAAeyJ3YXNfZmlyc3RfZXZlbnQiOmZhbHNlLCJpbWFnZV9pZCI6WzE2Njg3OTMyODksODQ2NDIwOTI1LDE3NzU3NjM0MywzODM1ODczODYyLDY2MzMzNTUzLDI4OTQ1NjYwMzAsNTk4Mjc1ODE1LDI3MTgyNzg1ODBdLCJxZiI6eyJiIjpbMCwwLDAsMCwwLDAsMCwwLDAsMCwwLDAsMCwwLDAsMCwwLDAsMCwwLDAsMCwwLDAsMCwwLDAsMCwwLDAsMCwwLDAsMCwwLDAsMCwwLDAsMCwwLDAsMCwwLDAsMCwwLDAsMCwwLDAsMCwwLDAsMCwwLDAsMCwwLDAsMCwwLDAsMCwwLDAsMCwwLDAsMCwwLDAsMF0sImwiOjAsInEiOjYsInIiOjd9fQAAAAAAAAAAAAAAAAAAAAAAAAAAAAAAAAAAAAAAAAAAAAA='}}
prove_76;62;68;Mul;4216;186411;0.0;833;5.6645688749995315;{'verificationValue': 0.0, 'proof': {'imageId': [1668793289, 846420925, 177576343, 3835873862, 66333553, 2894566030, 598275815, 2718278580], 'receipt': 'AwAAAAAAAAAAAAAAFPIgAEBa/KxpnrWjLW5ZBdoVsH8Dr4kePkUNGJK+LwGcLUh4AAAAAAAAAAAAAAAAAAAAAAAAAAAAAAAAAAAAAAAAAAAAAAAAAAAAAAAAAAAAAAAAAQAAAAAAAAAAAAAAAAAAAAAAAAAAAAAAAAAAAAAAAAAAAAAAAAAAAAEAAAAAPAEAAAAAAAAIAAAAMTg2NDExLjAqAQAAeyJ3YXNfZmlyc3RfZXZlbnQiOmZhbHNlLCJpbWFnZV9pZCI6WzE2Njg3OTMyODksODQ2NDIwOTI1LDE3NzU3NjM0MywzODM1ODczODYyLDY2MzMzNTUzLDI4OTQ1NjYwMzAsNTk4Mjc1ODE1LDI3MTgyNzg1ODBdLCJxZiI6eyJiIjpbMCwwLDAsMCwwLDAsMCwwLDAsMCwwLDAsMCwwLDAsMCwwLDAsMCwwLDAsMCwwLDAsMCwwLDAsMCwwLDAsMCwwLDAsMCwwLDAsMCwwLDAsMCwwLDAsMCwwLDAsMCwwLDAsMCwwLDAsMCwwLDAsMCwwLDAsMCwwLDAsMCwwLDAsMCwwLDAsMCwwLDAsMCwwLDAsMF0sImwiOjAsInEiOjYsInIiOjd9fQAAAAAAAAAAAAAAAAAAPAEAAAAAAAAIAAAAMTg2NDExLjAqAQAAeyJ3YXNfZmlyc3RfZXZlbnQiOmZhbHNlLCJpbWFnZV9pZCI6WzE2Njg3OTMyODksODQ2NDIwOTI1LDE3NzU3NjM0MywzODM1ODczODYyLDY2MzMzNTUzLDI4OTQ1NjYwMzAsNTk4Mjc1ODE1LDI3MTgyNzg1ODBdLCJxZiI6eyJiIjpbMCwwLDAsMCwwLDAsMCwwLDAsMCwwLDAsMCwwLDAsMCwwLDAsMCwwLDAsMCwwLDAsMCwwLDAsMCwwLDAsMCwwLDAsMCwwLDAsMCwwLDAsMCwwLDAsMCwwLDAsMCwwLDAsMCwwLDAsMCwwLDAsMCwwLDAsMCwwLDAsMCwwLDAsMCwwLDAsMCwwLDAsMCwwLDAsMF0sImwiOjAsInEiOjYsInIiOjd9fQAAAAAAAAAAAAAAAAAAAAAAAAAAAAAAAAAAAAAAAAAAAAA='}}
prove_77;50;68;Mul;3400;189811;0.0;833;5.493824250001126;{'verificationValue': 0.0, 'proof': {'imageId': [1668793289, 846420925, 177576343, 3835873862, 66333553, 2894566030, 598275815, 2718278580], 'receipt': 'AwAAAAAAAAAAAAAAFPIgAEBa/KxpnrWjLW5ZBdoVsH8Dr4kePkUNGJK+LwGcLUh4AAAAAAAAAAAAAAAAAAAAAAAAAAAAAAAAAAAAAAAAAAAAAAAAAAAAAAAAAAAAAAAAAQAAAAAAAAAAAAAAAAAAAAAAAAAAAAAAAAAAAAAAAAAAAAAAAAAAAAEAAAAAPAEAAAAAAAAIAAAAMTg5ODExLjAqAQAAeyJ3YXNfZmlyc3RfZXZlbnQiOmZhbHNlLCJpbWFnZV9pZCI6WzE2Njg3OTMyODksODQ2NDIwOTI1LDE3NzU3NjM0MywzODM1ODczODYyLDY2MzMzNTUzLDI4OTQ1NjYwMzAsNTk4Mjc1ODE1LDI3MTgyNzg1ODBdLCJxZiI6eyJiIjpbMCwwLDAsMCwwLDAsMCwwLDAsMCwwLDAsMCwwLDAsMCwwLDAsMCwwLDAsMCwwLDAsMCwwLDAsMCwwLDAsMCwwLDAsMCwwLDAsMCwwLDAsMCwwLDAsMCwwLDAsMCwwLDAsMCwwLDAsMCwwLDAsMCwwLDAsMCwwLDAsMCwwLDAsMCwwLDAsMCwwLDAsMCwwLDAsMF0sImwiOjAsInEiOjYsInIiOjd9fQAAAAAAAAAAAAAAAAAAPAEAAAAAAAAIAAAAMTg5ODExLjAqAQAAeyJ3YXNfZmlyc3RfZXZlbnQiOmZhbHNlLCJpbWFnZV9pZCI6WzE2Njg3OTMyODksODQ2NDIwOTI1LDE3NzU3NjM0MywzODM1ODczODYyLDY2MzMzNTUzLDI4OTQ1NjYwMzAsNTk4Mjc1ODE1LDI3MTgyNzg1ODBdLCJxZiI6eyJiIjpbMCwwLDAsMCwwLDAsMCwwLDAsMCwwLDAsMCwwLDAsMCwwLDAsMCwwLDAsMCwwLDAsMCwwLDAsMCwwLDAsMCwwLDAsMCwwLDAsMCwwLDAsMCwwLDAsMCwwLDAsMCwwLDAsMCwwLDAsMCwwLDAsMCwwLDAsMCwwLDAsMCwwLDAsMCwwLDAsMCwwLDAsMCwwLDAsMF0sImwiOjAsInEiOjYsInIiOjd9fQAAAAAAAAAAAAAAAAAAAAAAAAAAAAAAAAAAAAAAAAAAAAA='}}
prove_78;65;77;Mul;5005;194816;0.0;833;5.542199416000585;{'verificationValue': 0.0, 'proof': {'imageId': [1668793289, 846420925, 177576343, 3835873862, 66333553, 2894566030, 598275815, 2718278580], 'receipt': 'AwAAAAAAAAAAAAAAFPIgAEBa/KxpnrWjLW5ZBdoVsH8Dr4kePkUNGJK+LwGcLUh4AAAAAAAAAAAAAAAAAAAAAAAAAAAAAAAAAAAAAAAAAAAAAAAAAAAAAAAAAAAAAAAAAQAAAAAAAAAAAAAAAAAAAAAAAAAAAAAAAAAAAAAAAAAAAAAAAAAAAAEAAAAAPAEAAAAAAAAIAAAAMTk0ODE2LjAqAQAAeyJ3YXNfZmlyc3RfZXZlbnQiOmZhbHNlLCJpbWFnZV9pZCI6WzE2Njg3OTMyODksODQ2NDIwOTI1LDE3NzU3NjM0MywzODM1ODczODYyLDY2MzMzNTUzLDI4OTQ1NjYwMzAsNTk4Mjc1ODE1LDI3MTgyNzg1ODBdLCJxZiI6eyJiIjpbMCwwLDAsMCwwLDAsMCwwLDAsMCwwLDAsMCwwLDAsMCwwLDAsMCwwLDAsMCwwLDAsMCwwLDAsMCwwLDAsMCwwLDAsMCwwLDAsMCwwLDAsMCwwLDAsMCwwLDAsMCwwLDAsMCwwLDAsMCwwLDAsMCwwLDAsMCwwLDAsMCwwLDAsMCwwLDAsMCwwLDAsMCwwLDAsMF0sImwiOjAsInEiOjYsInIiOjd9fQAAAAAAAAAAAAAAAAAAPAEAAAAAAAAIAAAAMTk0ODE2LjAqAQAAeyJ3YXNfZmlyc3RfZXZlbnQiOmZhbHNlLCJpbWFnZV9pZCI6WzE2Njg3OTMyODksODQ2NDIwOTI1LDE3NzU3NjM0MywzODM1ODczODYyLDY2MzMzNTUzLDI4OTQ1NjYwMzAsNTk4Mjc1ODE1LDI3MTgyNzg1ODBdLCJxZiI6eyJiIjpbMCwwLDAsMCwwLDAsMCwwLDAsMCwwLDAsMCwwLDAsMCwwLDAsMCwwLDAsMCwwLDAsMCwwLDAsMCwwLDAsMCwwLDAsMCwwLDAsMCwwLDAsMCwwLDAsMCwwLDAsMCwwLDAsMCwwLDAsMCwwLDAsMCwwLDAsMCwwLDAsMCwwLDAsMCwwLDAsMCwwLDAsMCwwLDAsMF0sImwiOjAsInEiOjYsInIiOjd9fQAAAAAAAAAAAAAAAAAAAAAAAAAAAAAAAAAAAAAAAAAAAAA='}}
prove_79;14;35;Mul;490;195306;0.0;833;5.408002457999828;{'verificationValue': 0.0, 'proof': {'imageId': [1668793289, 846420925, 177576343, 3835873862, 66333553, 2894566030, 598275815, 2718278580], 'receipt': 'AwAAAAAAAAAAAAAAFPIgAEBa/KxpnrWjLW5ZBdoVsH8Dr4kePkUNGJK+LwGcLUh4AAAAAAAAAAAAAAAAAAAAAAAAAAAAAAAAAAAAAAAAAAAAAAAAAAAAAAAAAAAAAAAAAQAAAAAAAAAAAAAAAAAAAAAAAAAAAAAAAAAAAAAAAAAAAAAAAAAAAAEAAAAAPAEAAAAAAAAIAAAAMTk1MzA2LjAqAQAAeyJ3YXNfZmlyc3RfZXZlbnQiOmZhbHNlLCJpbWFnZV9pZCI6WzE2Njg3OTMyODksODQ2NDIwOTI1LDE3NzU3NjM0MywzODM1ODczODYyLDY2MzMzNTUzLDI4OTQ1NjYwMzAsNTk4Mjc1ODE1LDI3MTgyNzg1ODBdLCJxZiI6eyJiIjpbMCwwLDAsMCwwLDAsMCwwLDAsMCwwLDAsMCwwLDAsMCwwLDAsMCwwLDAsMCwwLDAsMCwwLDAsMCwwLDAsMCwwLDAsMCwwLDAsMCwwLDAsMCwwLDAsMCwwLDAsMCwwLDAsMCwwLDAsMCwwLDAsMCwwLDAsMCwwLDAsMCwwLDAsMCwwLDAsMCwwLDAsMCwwLDAsMF0sImwiOjAsInEiOjYsInIiOjd9fQAAAAAAAAAAAAAAAAAAPAEAAAAAAAAIAAAAMTk1MzA2LjAqAQAAeyJ3YXNfZmlyc3RfZXZlbnQiOmZhbHNlLCJpbWFnZV9pZCI6WzE2Njg3OTMyODksODQ2NDIwOTI1LDE3NzU3NjM0MywzODM1ODczODYyLDY2MzMzNTUzLDI4OTQ1NjYwMzAsNTk4Mjc1ODE1LDI3MTgyNzg1ODBdLCJxZiI6eyJiIjpbMCwwLDAsMCwwLDAsMCwwLDAsMCwwLDAsMCwwLDAsMCwwLDAsMCwwLDAsMCwwLDAsMCwwLDAsMCwwLDAsMCwwLDAsMCwwLDAsMCwwLDAsMCwwLDAsMCwwLDAsMCwwLDAsMCwwLDAsMCwwLDAsMCwwLDAsMCwwLDAsMCwwLDAsMCwwLDAsMCwwLDAsMCwwLDAsMF0sImwiOjAsInEiOjYsInIiOjd9fQAAAAAAAAAAAAAAAAAAAAAAAAAAAAAAAAAAAAAAAAAAAAA='}}
prove_80;42;89;Mul;3738;199044;0.0;833;5.5172889580007904;{'verificationValue': 0.0, 'proof': {'imageId': [1668793289, 846420925, 177576343, 3835873862, 66333553, 2894566030, 598275815, 2718278580], 'receipt': 'AwAAAAAAAAAAAAAAFPIgAEBa/KxpnrWjLW5ZBdoVsH8Dr4kePkUNGJK+LwGcLUh4AAAAAAAAAAAAAAAAAAAAAAAAAAAAAAAAAAAAAAAAAAAAAAAAAAAAAAAAAAAAAAAAAQAAAAAAAAAAAAAAAAAAAAAAAAAAAAAAAAAAAAAAAAAAAAAAAAAAAAEAAAAAPAEAAAAAAAAIAAAAMTk5MDQ0LjAqAQAAeyJ3YXNfZmlyc3RfZXZlbnQiOmZhbHNlLCJpbWFnZV9pZCI6WzE2Njg3OTMyODksODQ2NDIwOTI1LDE3NzU3NjM0MywzODM1ODczODYyLDY2MzMzNTUzLDI4OTQ1NjYwMzAsNTk4Mjc1ODE1LDI3MTgyNzg1ODBdLCJxZiI6eyJiIjpbMCwwLDAsMCwwLDAsMCwwLDAsMCwwLDAsMCwwLDAsMCwwLDAsMCwwLDAsMCwwLDAsMCwwLDAsMCwwLDAsMCwwLDAsMCwwLDAsMCwwLDAsMCwwLDAsMCwwLDAsMCwwLDAsMCwwLDAsMCwwLDAsMCwwLDAsMCwwLDAsMCwwLDAsMCwwLDAsMCwwLDAsMCwwLDAsMF0sImwiOjAsInEiOjYsInIiOjd9fQAAAAAAAAAAAAAAAAAAPAEAAAAAAAAIAAAAMTk5MDQ0LjAqAQAAeyJ3YXNfZmlyc3RfZXZlbnQiOmZhbHNlLCJpbWFnZV9pZCI6WzE2Njg3OTMyODksODQ2NDIwOTI1LDE3NzU3NjM0MywzODM1ODczODYyLDY2MzMzNTUzLDI4OTQ1NjYwMzAsNTk4Mjc1ODE1LDI3MTgyNzg1ODBdLCJxZiI6eyJiIjpbMCwwLDAsMCwwLDAsMCwwLDAsMCwwLDAsMCwwLDAsMCwwLDAsMCwwLDAsMCwwLDAsMCwwLDAsMCwwLDAsMCwwLDAsMCwwLDAsMCwwLDAsMCwwLDAsMCwwLDAsMCwwLDAsMCwwLDAsMCwwLDAsMCwwLDAsMCwwLDAsMCwwLDAsMCwwLDAsMCwwLDAsMCwwLDAsMF0sImwiOjAsInEiOjYsInIiOjd9fQAAAAAAAAAAAAAAAAAAAAAAAAAAAAAAAAAAAAAAAAAAAAA='}}
prove_81;65;25;Mul;1625;200669;0.0;833;5.704169458000251;{'verificationValue': 0.0, 'proof': {'imageId': [1668793289, 846420925, 177576343, 3835873862, 66333553, 2894566030, 598275815, 2718278580], 'receipt': 'AwAAAAAAAAAAAAAAFPIgAEBa/KxpnrWjLW5ZBdoVsH8Dr4kePkUNGJK+LwGcLUh4AAAAAAAAAAAAAAAAAAAAAAAAAAAAAAAAAAAAAAAAAAAAAAAAAAAAAAAAAAAAAAAAAQAAAAAAAAAAAAAAAAAAAAAAAAAAAAAAAAAAAAAAAAAAAAAAAAAAAAEAAAAAPAEAAAAAAAAIAAAAMjAwNjY5LjAqAQAAeyJ3YXNfZmlyc3RfZXZlbnQiOmZhbHNlLCJpbWFnZV9pZCI6WzE2Njg3OTMyODksODQ2NDIwOTI1LDE3NzU3NjM0MywzODM1ODczODYyLDY2MzMzNTUzLDI4OTQ1NjYwMzAsNTk4Mjc1ODE1LDI3MTgyNzg1ODBdLCJxZiI6eyJiIjpbMCwwLDAsMCwwLDAsMCwwLDAsMCwwLDAsMCwwLDAsMCwwLDAsMCwwLDAsMCwwLDAsMCwwLDAsMCwwLDAsMCwwLDAsMCwwLDAsMCwwLDAsMCwwLDAsMCwwLDAsMCwwLDAsMCwwLDAsMCwwLDAsMCwwLDAsMCwwLDAsMCwwLDAsMCwwLDAsMCwwLDAsMCwwLDAsMF0sImwiOjAsInEiOjYsInIiOjd9fQAAAAAAAAAAAAAAAAAAPAEAAAAAAAAIAAAAMjAwNjY5LjAqAQAAeyJ3YXNfZmlyc3RfZXZlbnQiOmZhbHNlLCJpbWFnZV9pZCI6WzE2Njg3OTMyODksODQ2NDIwOTI1LDE3NzU3NjM0MywzODM1ODczODYyLDY2MzMzNTUzLDI4OTQ1NjYwMzAsNTk4Mjc1ODE1LDI3MTgyNzg1ODBdLCJxZiI6eyJiIjpbMCwwLDAsMCwwLDAsMCwwLDAsMCwwLDAsMCwwLDAsMCwwLDAsMCwwLDAsMCwwLDAsMCwwLDAsMCwwLDAsMCwwLDAsMCwwLDAsMCwwLDAsMCwwLDAsMCwwLDAsMCwwLDAsMCwwLDAsMCwwLDAsMCwwLDAsMCwwLDAsMCwwLDAsMCwwLDAsMCwwLDAsMCwwLDAsMF0sImwiOjAsInEiOjYsInIiOjd9fQAAAAAAAAAAAAAAAAAAAAAAAAAAAAAAAAAAAAAAAAAAAAA='}}
prove_82;73;55;Mul;4015;204684;0.0;833;5.80465091699989;{'verificationValue': 0.0, 'proof': {'imageId': [1668793289, 846420925, 177576343, 3835873862, 66333553, 2894566030, 598275815, 2718278580], 'receipt': 'AwAAAAAAAAAAAAAAFPIgAEBa/KxpnrWjLW5ZBdoVsH8Dr4kePkUNGJK+LwGcLUh4AAAAAAAAAAAAAAAAAAAAAAAAAAAAAAAAAAAAAAAAAAAAAAAAAAAAAAAAAAAAAAAAAQAAAAAAAAAAAAAAAAAAAAAAAAAAAAAAAAAAAAAAAAAAAAAAAAAAAAEAAAAAPAEAAAAAAAAIAAAAMjA0Njg0LjAqAQAAeyJ3YXNfZmlyc3RfZXZlbnQiOmZhbHNlLCJpbWFnZV9pZCI6WzE2Njg3OTMyODksODQ2NDIwOTI1LDE3NzU3NjM0MywzODM1ODczODYyLDY2MzMzNTUzLDI4OTQ1NjYwMzAsNTk4Mjc1ODE1LDI3MTgyNzg1ODBdLCJxZiI6eyJiIjpbMCwwLDAsMCwwLDAsMCwwLDAsMCwwLDAsMCwwLDAsMCwwLDAsMCwwLDAsMCwwLDAsMCwwLDAsMCwwLDAsMCwwLDAsMCwwLDAsMCwwLDAsMCwwLDAsMCwwLDAsMCwwLDAsMCwwLDAsMCwwLDAsMCwwLDAsMCwwLDAsMCwwLDAsMCwwLDAsMCwwLDAsMCwwLDAsMF0sImwiOjAsInEiOjYsInIiOjd9fQAAAAAAAAAAAAAAAAAAPAEAAAAAAAAIAAAAMjA0Njg0LjAqAQAAeyJ3YXNfZmlyc3RfZXZlbnQiOmZhbHNlLCJpbWFnZV9pZCI6WzE2Njg3OTMyODksODQ2NDIwOTI1LDE3NzU3NjM0MywzODM1ODczODYyLDY2MzMzNTUzLDI4OTQ1NjYwMzAsNTk4Mjc1ODE1LDI3MTgyNzg1ODBdLCJxZiI6eyJiIjpbMCwwLDAsMCwwLDAsMCwwLDAsMCwwLDAsMCwwLDAsMCwwLDAsMCwwLDAsMCwwLDAsMCwwLDAsMCwwLDAsMCwwLDAsMCwwLDAsMCwwLDAsMCwwLDAsMCwwLDAsMCwwLDAsMCwwLDAsMCwwLDAsMCwwLDAsMCwwLDAsMCwwLDAsMCwwLDAsMCwwLDAsMCwwLDAsMF0sImwiOjAsInEiOjYsInIiOjd9fQAAAAAAAAAAAAAAAAAAAAAAAAAAAAAAAAAAAAAAAAAAAAA='}}
prove_83;21;5;Mul;105;204789;0.0;833;5.7769187499998225;{'verificationValue': 0.0, 'proof': {'imageId': [1668793289, 846420925, 177576343, 3835873862, 66333553, 2894566030, 598275815, 2718278580], 'receipt': 'AwAAAAAAAAAAAAAAFPIgAEBa/KxpnrWjLW5ZBdoVsH8Dr4kePkUNGJK+LwGcLUh4AAAAAAAAAAAAAAAAAAAAAAAAAAAAAAAAAAAAAAAAAAAAAAAAAAAAAAAAAAAAAAAAAQAAAAAAAAAAAAAAAAAAAAAAAAAAAAAAAAAAAAAAAAAAAAAAAAAAAAEAAAAAPAEAAAAAAAAIAAAAMjA0Nzg5LjAqAQAAeyJ3YXNfZmlyc3RfZXZlbnQiOmZhbHNlLCJpbWFnZV9pZCI6WzE2Njg3OTMyODksODQ2NDIwOTI1LDE3NzU3NjM0MywzODM1ODczODYyLDY2MzMzNTUzLDI4OTQ1NjYwMzAsNTk4Mjc1ODE1LDI3MTgyNzg1ODBdLCJxZiI6eyJiIjpbMCwwLDAsMCwwLDAsMCwwLDAsMCwwLDAsMCwwLDAsMCwwLDAsMCwwLDAsMCwwLDAsMCwwLDAsMCwwLDAsMCwwLDAsMCwwLDAsMCwwLDAsMCwwLDAsMCwwLDAsMCwwLDAsMCwwLDAsMCwwLDAsMCwwLDAsMCwwLDAsMCwwLDAsMCwwLDAsMCwwLDAsMCwwLDAsMF0sImwiOjAsInEiOjYsInIiOjd9fQAAAAAAAAAAAAAAAAAAPAEAAAAAAAAIAAAAMjA0Nzg5LjAqAQAAeyJ3YXNfZmlyc3RfZXZlbnQiOmZhbHNlLCJpbWFnZV9pZCI6WzE2Njg3OTMyODksODQ2NDIwOTI1LDE3NzU3NjM0MywzODM1ODczODYyLDY2MzMzNTUzLDI4OTQ1NjYwMzAsNTk4Mjc1ODE1LDI3MTgyNzg1ODBdLCJxZiI6eyJiIjpbMCwwLDAsMCwwLDAsMCwwLDAsMCwwLDAsMCwwLDAsMCwwLDAsMCwwLDAsMCwwLDAsMCwwLDAsMCwwLDAsMCwwLDAsMCwwLDAsMCwwLDAsMCwwLDAsMCwwLDAsMCwwLDAsMCwwLDAsMCwwLDAsMCwwLDAsMCwwLDAsMCwwLDAsMCwwLDAsMCwwLDAsMCwwLDAsMF0sImwiOjAsInEiOjYsInIiOjd9fQAAAAAAAAAAAAAAAAAAAAAAAAAAAAAAAAAAAAAAAAAAAAA='}}
prove_84;90;74;Mul;6660;211449;0.0;833;5.946805915998993;{'verificationValue': 0.0, 'proof': {'imageId': [1668793289, 846420925, 177576343, 3835873862, 66333553, 2894566030, 598275815, 2718278580], 'receipt': 'AwAAAAAAAAAAAAAAFPIgAEBa/KxpnrWjLW5ZBdoVsH8Dr4kePkUNGJK+LwGcLUh4AAAAAAAAAAAAAAAAAAAAAAAAAAAAAAAAAAAAAAAAAAAAAAAAAAAAAAAAAAAAAAAAAQAAAAAAAAAAAAAAAAAAAAAAAAAAAAAAAAAAAAAAAAAAAAAAAAAAAAEAAAAAPAEAAAAAAAAIAAAAMjExNDQ5LjAqAQAAeyJ3YXNfZmlyc3RfZXZlbnQiOmZhbHNlLCJpbWFnZV9pZCI6WzE2Njg3OTMyODksODQ2NDIwOTI1LDE3NzU3NjM0MywzODM1ODczODYyLDY2MzMzNTUzLDI4OTQ1NjYwMzAsNTk4Mjc1ODE1LDI3MTgyNzg1ODBdLCJxZiI6eyJiIjpbMCwwLDAsMCwwLDAsMCwwLDAsMCwwLDAsMCwwLDAsMCwwLDAsMCwwLDAsMCwwLDAsMCwwLDAsMCwwLDAsMCwwLDAsMCwwLDAsMCwwLDAsMCwwLDAsMCwwLDAsMCwwLDAsMCwwLDAsMCwwLDAsMCwwLDAsMCwwLDAsMCwwLDAsMCwwLDAsMCwwLDAsMCwwLDAsMF0sImwiOjAsInEiOjYsInIiOjd9fQAAAAAAAAAAAAAAAAAAPAEAAAAAAAAIAAAAMjExNDQ5LjAqAQAAeyJ3YXNfZmlyc3RfZXZlbnQiOmZhbHNlLCJpbWFnZV9pZCI6WzE2Njg3OTMyODksODQ2NDIwOTI1LDE3NzU3NjM0MywzODM1ODczODYyLDY2MzMzNTUzLDI4OTQ1NjYwMzAsNTk4Mjc1ODE1LDI3MTgyNzg1ODBdLCJxZiI6eyJiIjpbMCwwLDAsMCwwLDAsMCwwLDAsMCwwLDAsMCwwLDAsMCwwLDAsMCwwLDAsMCwwLDAsMCwwLDAsMCwwLDAsMCwwLDAsMCwwLDAsMCwwLDAsMCwwLDAsMCwwLDAsMCwwLDAsMCwwLDAsMCwwLDAsMCwwLDAsMCwwLDAsMCwwLDAsMCwwLDAsMCwwLDAsMCwwLDAsMF0sImwiOjAsInEiOjYsInIiOjd9fQAAAAAAAAAAAAAAAAAAAAAAAAAAAAAAAAAAAAAAAAAAAAA='}}
prove_85;29;27;Mul;783;212232;0.0;833;5.93039383300129;{'verificationValue': 0.0, 'proof': {'imageId': [1668793289, 846420925, 177576343, 3835873862, 66333553, 2894566030, 598275815, 2718278580], 'receipt': 'AwAAAAAAAAAAAAAAFPIgAEBa/KxpnrWjLW5ZBdoVsH8Dr4kePkUNGJK+LwGcLUh4AAAAAAAAAAAAAAAAAAAAAAAAAAAAAAAAAAAAAAAAAAAAAAAAAAAAAAAAAAAAAAAAAQAAAAAAAAAAAAAAAAAAAAAAAAAAAAAAAAAAAAAAAAAAAAAAAAAAAAEAAAAAPAEAAAAAAAAIAAAAMjEyMjMyLjAqAQAAeyJ3YXNfZmlyc3RfZXZlbnQiOmZhbHNlLCJpbWFnZV9pZCI6WzE2Njg3OTMyODksODQ2NDIwOTI1LDE3NzU3NjM0MywzODM1ODczODYyLDY2MzMzNTUzLDI4OTQ1NjYwMzAsNTk4Mjc1ODE1LDI3MTgyNzg1ODBdLCJxZiI6eyJiIjpbMCwwLDAsMCwwLDAsMCwwLDAsMCwwLDAsMCwwLDAsMCwwLDAsMCwwLDAsMCwwLDAsMCwwLDAsMCwwLDAsMCwwLDAsMCwwLDAsMCwwLDAsMCwwLDAsMCwwLDAsMCwwLDAsMCwwLDAsMCwwLDAsMCwwLDAsMCwwLDAsMCwwLDAsMCwwLDAsMCwwLDAsMCwwLDAsMF0sImwiOjAsInEiOjYsInIiOjd9fQAAAAAAAAAAAAAAAAAAPAEAAAAAAAAIAAAAMjEyMjMyLjAqAQAAeyJ3YXNfZmlyc3RfZXZlbnQiOmZhbHNlLCJpbWFnZV9pZCI6WzE2Njg3OTMyODksODQ2NDIwOTI1LDE3NzU3NjM0MywzODM1ODczODYyLDY2MzMzNTUzLDI4OTQ1NjYwMzAsNTk4Mjc1ODE1LDI3MTgyNzg1ODBdLCJxZiI6eyJiIjpbMCwwLDAsMCwwLDAsMCwwLDAsMCwwLDAsMCwwLDAsMCwwLDAsMCwwLDAsMCwwLDAsMCwwLDAsMCwwLDAsMCwwLDAsMCwwLDAsMCwwLDAsMCwwLDAsMCwwLDAsMCwwLDAsMCwwLDAsMCwwLDAsMCwwLDAsMCwwLDAsMCwwLDAsMCwwLDAsMCwwLDAsMCwwLDAsMF0sImwiOjAsInEiOjYsInIiOjd9fQAAAAAAAAAAAAAAAAAAAAAAAAAAAAAAAAAAAAAAAAAAAAA='}}
prove_86;25;49;Mul;1225;213457;0.0;833;6.041788332999204;{'verificationValue': 0.0, 'proof': {'imageId': [1668793289, 846420925, 177576343, 3835873862, 66333553, 2894566030, 598275815, 2718278580], 'receipt': 'AwAAAAAAAAAAAAAAFPIgAEBa/KxpnrWjLW5ZBdoVsH8Dr4kePkUNGJK+LwGcLUh4AAAAAAAAAAAAAAAAAAAAAAAAAAAAAAAAAAAAAAAAAAAAAAAAAAAAAAAAAAAAAAAAAQAAAAAAAAAAAAAAAAAAAAAAAAAAAAAAAAAAAAAAAAAAAAAAAAAAAAEAAAAAPAEAAAAAAAAIAAAAMjEzNDU3LjAqAQAAeyJ3YXNfZmlyc3RfZXZlbnQiOmZhbHNlLCJpbWFnZV9pZCI6WzE2Njg3OTMyODksODQ2NDIwOTI1LDE3NzU3NjM0MywzODM1ODczODYyLDY2MzMzNTUzLDI4OTQ1NjYwMzAsNTk4Mjc1ODE1LDI3MTgyNzg1ODBdLCJxZiI6eyJiIjpbMCwwLDAsMCwwLDAsMCwwLDAsMCwwLDAsMCwwLDAsMCwwLDAsMCwwLDAsMCwwLDAsMCwwLDAsMCwwLDAsMCwwLDAsMCwwLDAsMCwwLDAsMCwwLDAsMCwwLDAsMCwwLDAsMCwwLDAsMCwwLDAsMCwwLDAsMCwwLDAsMCwwLDAsMCwwLDAsMCwwLDAsMCwwLDAsMF0sImwiOjAsInEiOjYsInIiOjd9fQAAAAAAAAAAAAAAAAAAPAEAAAAAAAAIAAAAMjEzNDU3LjAqAQAAeyJ3YXNfZmlyc3RfZXZlbnQiOmZhbHNlLCJpbWFnZV9pZCI6WzE2Njg3OTMyODksODQ2NDIwOTI1LDE3NzU3NjM0MywzODM1ODczODYyLDY2MzMzNTUzLDI4OTQ1NjYwMzAsNTk4Mjc1ODE1LDI3MTgyNzg1ODBdLCJxZiI6eyJiIjpbMCwwLDAsMCwwLDAsMCwwLDAsMCwwLDAsMCwwLDAsMCwwLDAsMCwwLDAsMCwwLDAsMCwwLDAsMCwwLDAsMCwwLDAsMCwwLDAsMCwwLDAsMCwwLDAsMCwwLDAsMCwwLDAsMCwwLDAsMCwwLDAsMCwwLDAsMCwwLDAsMCwwLDAsMCwwLDAsMCwwLDAsMCwwLDAsMF0sImwiOjAsInEiOjYsInIiOjd9fQAAAAAAAAAAAAAAAAAAAAAAAAAAAAAAAAAAAAAAAAAAAAA='}}
prove_87;67;67;Mul;4489;217946;0.0;833;6.110011166998447;{'verificationValue': 0.0, 'proof': {'imageId': [1668793289, 846420925, 177576343, 3835873862, 66333553, 2894566030, 598275815, 2718278580], 'receipt': 'AwAAAAAAAAAAAAAAFPIgAEBa/KxpnrWjLW5ZBdoVsH8Dr4kePkUNGJK+LwGcLUh4AAAAAAAAAAAAAAAAAAAAAAAAAAAAAAAAAAAAAAAAAAAAAAAAAAAAAAAAAAAAAAAAAQAAAAAAAAAAAAAAAAAAAAAAAAAAAAAAAAAAAAAAAAAAAAAAAAAAAAEAAAAAPAEAAAAAAAAIAAAAMjE3OTQ2LjAqAQAAeyJ3YXNfZmlyc3RfZXZlbnQiOmZhbHNlLCJpbWFnZV9pZCI6WzE2Njg3OTMyODksODQ2NDIwOTI1LDE3NzU3NjM0MywzODM1ODczODYyLDY2MzMzNTUzLDI4OTQ1NjYwMzAsNTk4Mjc1ODE1LDI3MTgyNzg1ODBdLCJxZiI6eyJiIjpbMCwwLDAsMCwwLDAsMCwwLDAsMCwwLDAsMCwwLDAsMCwwLDAsMCwwLDAsMCwwLDAsMCwwLDAsMCwwLDAsMCwwLDAsMCwwLDAsMCwwLDAsMCwwLDAsMCwwLDAsMCwwLDAsMCwwLDAsMCwwLDAsMCwwLDAsMCwwLDAsMCwwLDAsMCwwLDAsMCwwLDAsMCwwLDAsMF0sImwiOjAsInEiOjYsInIiOjd9fQAAAAAAAAAAAAAAAAAAPAEAAAAAAAAIAAAAMjE3OTQ2LjAqAQAAeyJ3YXNfZmlyc3RfZXZlbnQiOmZhbHNlLCJpbWFnZV9pZCI6WzE2Njg3OTMyODksODQ2NDIwOTI1LDE3NzU3NjM0MywzODM1ODczODYyLDY2MzMzNTUzLDI4OTQ1NjYwMzAsNTk4Mjc1ODE1LDI3MTgyNzg1ODBdLCJxZiI6eyJiIjpbMCwwLDAsMCwwLDAsMCwwLDAsMCwwLDAsMCwwLDAsMCwwLDAsMCwwLDAsMCwwLDAsMCwwLDAsMCwwLDAsMCwwLDAsMCwwLDAsMCwwLDAsMCwwLDAsMCwwLDAsMCwwLDAsMCwwLDAsMCwwLDAsMCwwLDAsMCwwLDAsMCwwLDAsMCwwLDAsMCwwLDAsMCwwLDAsMF0sImwiOjAsInEiOjYsInIiOjd9fQAAAAAAAAAAAAAAAAAAAAAAAAAAAAAAAAAAAAAAAAAAAAA='}}
prove_88;38;38;Mul;1444;219390;0.0;833;6.138437792000332;{'verificationValue': 0.0, 'proof': {'imageId': [1668793289, 846420925, 177576343, 3835873862, 66333553, 2894566030, 598275815, 2718278580], 'receipt': 'AwAAAAAAAAAAAAAAFPIgAEBa/KxpnrWjLW5ZBdoVsH8Dr4kePkUNGJK+LwGcLUh4AAAAAAAAAAAAAAAAAAAAAAAAAAAAAAAAAAAAAAAAAAAAAAAAAAAAAAAAAAAAAAAAAQAAAAAAAAAAAAAAAAAAAAAAAAAAAAAAAAAAAAAAAAAAAAAAAAAAAAEAAAAAPAEAAAAAAAAIAAAAMjE5MzkwLjAqAQAAeyJ3YXNfZmlyc3RfZXZlbnQiOmZhbHNlLCJpbWFnZV9pZCI6WzE2Njg3OTMyODksODQ2NDIwOTI1LDE3NzU3NjM0MywzODM1ODczODYyLDY2MzMzNTUzLDI4OTQ1NjYwMzAsNTk4Mjc1ODE1LDI3MTgyNzg1ODBdLCJxZiI6eyJiIjpbMCwwLDAsMCwwLDAsMCwwLDAsMCwwLDAsMCwwLDAsMCwwLDAsMCwwLDAsMCwwLDAsMCwwLDAsMCwwLDAsMCwwLDAsMCwwLDAsMCwwLDAsMCwwLDAsMCwwLDAsMCwwLDAsMCwwLDAsMCwwLDAsMCwwLDAsMCwwLDAsMCwwLDAsMCwwLDAsMCwwLDAsMCwwLDAsMF0sImwiOjAsInEiOjYsInIiOjd9fQAAAAAAAAAAAAAAAAAAPAEAAAAAAAAIAAAAMjE5MzkwLjAqAQAAeyJ3YXNfZmlyc3RfZXZlbnQiOmZhbHNlLCJpbWFnZV9pZCI6WzE2Njg3OTMyODksODQ2NDIwOTI1LDE3NzU3NjM0MywzODM1ODczODYyLDY2MzMzNTUzLDI4OTQ1NjYwMzAsNTk4Mjc1ODE1LDI3MTgyNzg1ODBdLCJxZiI6eyJiIjpbMCwwLDAsMCwwLDAsMCwwLDAsMCwwLDAsMCwwLDAsMCwwLDAsMCwwLDAsMCwwLDAsMCwwLDAsMCwwLDAsMCwwLDAsMCwwLDAsMCwwLDAsMCwwLDAsMCwwLDAsMCwwLDAsMCwwLDAsMCwwLDAsMCwwLDAsMCwwLDAsMCwwLDAsMCwwLDAsMCwwLDAsMCwwLDAsMF0sImwiOjAsInEiOjYsInIiOjd9fQAAAAAAAAAAAAAAAAAAAAAAAAAAAAAAAAAAAAAAAAAAAAA='}}
prove_89;62;20;Mul;1240;220630;0.0;833;6.119878666000659;{'verificationValue': 0.0, 'proof': {'imageId': [1668793289, 846420925, 177576343, 3835873862, 66333553, 2894566030, 598275815, 2718278580], 'receipt': 'AwAAAAAAAAAAAAAAFPIgAEBa/KxpnrWjLW5ZBdoVsH8Dr4kePkUNGJK+LwGcLUh4AAAAAAAAAAAAAAAAAAAAAAAAAAAAAAAAAAAAAAAAAAAAAAAAAAAAAAAAAAAAAAAAAQAAAAAAAAAAAAAAAAAAAAAAAAAAAAAAAAAAAAAAAAAAAAAAAAAAAAEAAAAAPAEAAAAAAAAIAAAAMjIwNjMwLjAqAQAAeyJ3YXNfZmlyc3RfZXZlbnQiOmZhbHNlLCJpbWFnZV9pZCI6WzE2Njg3OTMyODksODQ2NDIwOTI1LDE3NzU3NjM0MywzODM1ODczODYyLDY2MzMzNTUzLDI4OTQ1NjYwMzAsNTk4Mjc1ODE1LDI3MTgyNzg1ODBdLCJxZiI6eyJiIjpbMCwwLDAsMCwwLDAsMCwwLDAsMCwwLDAsMCwwLDAsMCwwLDAsMCwwLDAsMCwwLDAsMCwwLDAsMCwwLDAsMCwwLDAsMCwwLDAsMCwwLDAsMCwwLDAsMCwwLDAsMCwwLDAsMCwwLDAsMCwwLDAsMCwwLDAsMCwwLDAsMCwwLDAsMCwwLDAsMCwwLDAsMCwwLDAsMF0sImwiOjAsInEiOjYsInIiOjd9fQAAAAAAAAAAAAAAAAAAPAEAAAAAAAAIAAAAMjIwNjMwLjAqAQAAeyJ3YXNfZmlyc3RfZXZlbnQiOmZhbHNlLCJpbWFnZV9pZCI6WzE2Njg3OTMyODksODQ2NDIwOTI1LDE3NzU3NjM0MywzODM1ODczODYyLDY2MzMzNTUzLDI4OTQ1NjYwMzAsNTk4Mjc1ODE1LDI3MTgyNzg1ODBdLCJxZiI6eyJiIjpbMCwwLDAsMCwwLDAsMCwwLDAsMCwwLDAsMCwwLDAsMCwwLDAsMCwwLDAsMCwwLDAsMCwwLDAsMCwwLDAsMCwwLDAsMCwwLDAsMCwwLDAsMCwwLDAsMCwwLDAsMCwwLDAsMCwwLDAsMCwwLDAsMCwwLDAsMCwwLDAsMCwwLDAsMCwwLDAsMCwwLDAsMCwwLDAsMF0sImwiOjAsInEiOjYsInIiOjd9fQAAAAAAAAAAAAAAAAAAAAAAAAAAAAAAAAAAAAAAAAAAAAA='}}
prove_90;44;77;Mul;3388;224018;0.0;833;6.3298639159984305;{'verificationValue': 0.0, 'proof': {'imageId': [1668793289, 846420925, 177576343, 3835873862, 66333553, 2894566030, 598275815, 2718278580], 'receipt': 'AwAAAAAAAAAAAAAAFPIgAEBa/KxpnrWjLW5ZBdoVsH8Dr4kePkUNGJK+LwGcLUh4AAAAAAAAAAAAAAAAAAAAAAAAAAAAAAAAAAAAAAAAAAAAAAAAAAAAAAAAAAAAAAAAAQAAAAAAAAAAAAAAAAAAAAAAAAAAAAAAAAAAAAAAAAAAAAAAAAAAAAEAAAAAPAEAAAAAAAAIAAAAMjI0MDE4LjAqAQAAeyJ3YXNfZmlyc3RfZXZlbnQiOmZhbHNlLCJpbWFnZV9pZCI6WzE2Njg3OTMyODksODQ2NDIwOTI1LDE3NzU3NjM0MywzODM1ODczODYyLDY2MzMzNTUzLDI4OTQ1NjYwMzAsNTk4Mjc1ODE1LDI3MTgyNzg1ODBdLCJxZiI6eyJiIjpbMCwwLDAsMCwwLDAsMCwwLDAsMCwwLDAsMCwwLDAsMCwwLDAsMCwwLDAsMCwwLDAsMCwwLDAsMCwwLDAsMCwwLDAsMCwwLDAsMCwwLDAsMCwwLDAsMCwwLDAsMCwwLDAsMCwwLDAsMCwwLDAsMCwwLDAsMCwwLDAsMCwwLDAsMCwwLDAsMCwwLDAsMCwwLDAsMF0sImwiOjAsInEiOjYsInIiOjd9fQAAAAAAAAAAAAAAAAAAPAEAAAAAAAAIAAAAMjI0MDE4LjAqAQAAeyJ3YXNfZmlyc3RfZXZlbnQiOmZhbHNlLCJpbWFnZV9pZCI6WzE2Njg3OTMyODksODQ2NDIwOTI1LDE3NzU3NjM0MywzODM1ODczODYyLDY2MzMzNTUzLDI4OTQ1NjYwMzAsNTk4Mjc1ODE1LDI3MTgyNzg1ODBdLCJxZiI6eyJiIjpbMCwwLDAsMCwwLDAsMCwwLDAsMCwwLDAsMCwwLDAsMCwwLDAsMCwwLDAsMCwwLDAsMCwwLDAsMCwwLDAsMCwwLDAsMCwwLDAsMCwwLDAsMCwwLDAsMCwwLDAsMCwwLDAsMCwwLDAsMCwwLDAsMCwwLDAsMCwwLDAsMCwwLDAsMCwwLDAsMCwwLDAsMCwwLDAsMF0sImwiOjAsInEiOjYsInIiOjd9fQAAAAAAAAAAAAAAAAAAAAAAAAAAAAAAAAAAAAAAAAAAAAA='}}
prove_91;88;89;Mul;7832;231850;0.0;833;6.469740082999124;{'verificationValue': 0.0, 'proof': {'imageId': [1668793289, 846420925, 177576343, 3835873862, 66333553, 2894566030, 598275815, 2718278580], 'receipt': 'AwAAAAAAAAAAAAAAFPIgAEBa/KxpnrWjLW5ZBdoVsH8Dr4kePkUNGJK+LwGcLUh4AAAAAAAAAAAAAAAAAAAAAAAAAAAAAAAAAAAAAAAAAAAAAAAAAAAAAAAAAAAAAAAAAQAAAAAAAAAAAAAAAAAAAAAAAAAAAAAAAAAAAAAAAAAAAAAAAAAAAAEAAAAAPAEAAAAAAAAIAAAAMjMxODUwLjAqAQAAeyJ3YXNfZmlyc3RfZXZlbnQiOmZhbHNlLCJpbWFnZV9pZCI6WzE2Njg3OTMyODksODQ2NDIwOTI1LDE3NzU3NjM0MywzODM1ODczODYyLDY2MzMzNTUzLDI4OTQ1NjYwMzAsNTk4Mjc1ODE1LDI3MTgyNzg1ODBdLCJxZiI6eyJiIjpbMCwwLDAsMCwwLDAsMCwwLDAsMCwwLDAsMCwwLDAsMCwwLDAsMCwwLDAsMCwwLDAsMCwwLDAsMCwwLDAsMCwwLDAsMCwwLDAsMCwwLDAsMCwwLDAsMCwwLDAsMCwwLDAsMCwwLDAsMCwwLDAsMCwwLDAsMCwwLDAsMCwwLDAsMCwwLDAsMCwwLDAsMCwwLDAsMF0sImwiOjAsInEiOjYsInIiOjd9fQAAAAAAAAAAAAAAAAAAPAEAAAAAAAAIAAAAMjMxODUwLjAqAQAAeyJ3YXNfZmlyc3RfZXZlbnQiOmZhbHNlLCJpbWFnZV9pZCI6WzE2Njg3OTMyODksODQ2NDIwOTI1LDE3NzU3NjM0MywzODM1ODczODYyLDY2MzMzNTUzLDI4OTQ1NjYwMzAsNTk4Mjc1ODE1LDI3MTgyNzg1ODBdLCJxZiI6eyJiIjpbMCwwLDAsMCwwLDAsMCwwLDAsMCwwLDAsMCwwLDAsMCwwLDAsMCwwLDAsMCwwLDAsMCwwLDAsMCwwLDAsMCwwLDAsMCwwLDAsMCwwLDAsMCwwLDAsMCwwLDAsMCwwLDAsMCwwLDAsMCwwLDAsMCwwLDAsMCwwLDAsMCwwLDAsMCwwLDAsMCwwLDAsMCwwLDAsMF0sImwiOjAsInEiOjYsInIiOjd9fQAAAAAAAAAAAAAAAAAAAAAAAAAAAAAAAAAAAAAAAAAAAAA='}}
prove_92;68;74;Mul;5032;236882;0.0;833;6.42404466699918;{'verificationValue': 0.0, 'proof': {'imageId': [1668793289, 846420925, 177576343, 3835873862, 66333553, 2894566030, 598275815, 2718278580], 'receipt': 'AwAAAAAAAAAAAAAAFPIgAEBa/KxpnrWjLW5ZBdoVsH8Dr4kePkUNGJK+LwGcLUh4AAAAAAAAAAAAAAAAAAAAAAAAAAAAAAAAAAAAAAAAAAAAAAAAAAAAAAAAAAAAAAAAAQAAAAAAAAAAAAAAAAAAAAAAAAAAAAAAAAAAAAAAAAAAAAAAAAAAAAEAAAAAPAEAAAAAAAAIAAAAMjM2ODgyLjAqAQAAeyJ3YXNfZmlyc3RfZXZlbnQiOmZhbHNlLCJpbWFnZV9pZCI6WzE2Njg3OTMyODksODQ2NDIwOTI1LDE3NzU3NjM0MywzODM1ODczODYyLDY2MzMzNTUzLDI4OTQ1NjYwMzAsNTk4Mjc1ODE1LDI3MTgyNzg1ODBdLCJxZiI6eyJiIjpbMCwwLDAsMCwwLDAsMCwwLDAsMCwwLDAsMCwwLDAsMCwwLDAsMCwwLDAsMCwwLDAsMCwwLDAsMCwwLDAsMCwwLDAsMCwwLDAsMCwwLDAsMCwwLDAsMCwwLDAsMCwwLDAsMCwwLDAsMCwwLDAsMCwwLDAsMCwwLDAsMCwwLDAsMCwwLDAsMCwwLDAsMCwwLDAsMF0sImwiOjAsInEiOjYsInIiOjd9fQAAAAAAAAAAAAAAAAAAPAEAAAAAAAAIAAAAMjM2ODgyLjAqAQAAeyJ3YXNfZmlyc3RfZXZlbnQiOmZhbHNlLCJpbWFnZV9pZCI6WzE2Njg3OTMyODksODQ2NDIwOTI1LDE3NzU3NjM0MywzODM1ODczODYyLDY2MzMzNTUzLDI4OTQ1NjYwMzAsNTk4Mjc1ODE1LDI3MTgyNzg1ODBdLCJxZiI6eyJiIjpbMCwwLDAsMCwwLDAsMCwwLDAsMCwwLDAsMCwwLDAsMCwwLDAsMCwwLDAsMCwwLDAsMCwwLDAsMCwwLDAsMCwwLDAsMCwwLDAsMCwwLDAsMCwwLDAsMCwwLDAsMCwwLDAsMCwwLDAsMCwwLDAsMCwwLDAsMCwwLDAsMCwwLDAsMCwwLDAsMCwwLDAsMCwwLDAsMF0sImwiOjAsInEiOjYsInIiOjd9fQAAAAAAAAAAAAAAAAAAAAAAAAAAAAAAAAAAAAAAAAAAAAA='}}
prove_93;96;33;Mul;3168;240050;0.0;833;6.535074000001259;{'verificationValue': 0.0, 'proof': {'imageId': [1668793289, 846420925, 177576343, 3835873862, 66333553, 2894566030, 598275815, 2718278580], 'receipt': 'AwAAAAAAAAAAAAAAFPIgAEBa/KxpnrWjLW5ZBdoVsH8Dr4kePkUNGJK+LwGcLUh4AAAAAAAAAAAAAAAAAAAAAAAAAAAAAAAAAAAAAAAAAAAAAAAAAAAAAAAAAAAAAAAAAQAAAAAAAAAAAAAAAAAAAAAAAAAAAAAAAAAAAAAAAAAAAAAAAAAAAAEAAAAAPAEAAAAAAAAIAAAAMjQwMDUwLjAqAQAAeyJ3YXNfZmlyc3RfZXZlbnQiOmZhbHNlLCJpbWFnZV9pZCI6WzE2Njg3OTMyODksODQ2NDIwOTI1LDE3NzU3NjM0MywzODM1ODczODYyLDY2MzMzNTUzLDI4OTQ1NjYwMzAsNTk4Mjc1ODE1LDI3MTgyNzg1ODBdLCJxZiI6eyJiIjpbMCwwLDAsMCwwLDAsMCwwLDAsMCwwLDAsMCwwLDAsMCwwLDAsMCwwLDAsMCwwLDAsMCwwLDAsMCwwLDAsMCwwLDAsMCwwLDAsMCwwLDAsMCwwLDAsMCwwLDAsMCwwLDAsMCwwLDAsMCwwLDAsMCwwLDAsMCwwLDAsMCwwLDAsMCwwLDAsMCwwLDAsMCwwLDAsMF0sImwiOjAsInEiOjYsInIiOjd9fQAAAAAAAAAAAAAAAAAAPAEAAAAAAAAIAAAAMjQwMDUwLjAqAQAAeyJ3YXNfZmlyc3RfZXZlbnQiOmZhbHNlLCJpbWFnZV9pZCI6WzE2Njg3OTMyODksODQ2NDIwOTI1LDE3NzU3NjM0MywzODM1ODczODYyLDY2MzMzNTUzLDI4OTQ1NjYwMzAsNTk4Mjc1ODE1LDI3MTgyNzg1ODBdLCJxZiI6eyJiIjpbMCwwLDAsMCwwLDAsMCwwLDAsMCwwLDAsMCwwLDAsMCwwLDAsMCwwLDAsMCwwLDAsMCwwLDAsMCwwLDAsMCwwLDAsMCwwLDAsMCwwLDAsMCwwLDAsMCwwLDAsMCwwLDAsMCwwLDAsMCwwLDAsMCwwLDAsMCwwLDAsMCwwLDAsMCwwLDAsMCwwLDAsMCwwLDAsMF0sImwiOjAsInEiOjYsInIiOjd9fQAAAAAAAAAAAAAAAAAAAAAAAAAAAAAAAAAAAAAAAAAAAAA='}}
prove_94;72;12;Mul;864;240914;0.0;833;6.723242542000662;{'verificationValue': 0.0, 'proof': {'imageId': [1668793289, 846420925, 177576343, 3835873862, 66333553, 2894566030, 598275815, 2718278580], 'receipt': 'AwAAAAAAAAAAAAAAFPIgAEBa/KxpnrWjLW5ZBdoVsH8Dr4kePkUNGJK+LwGcLUh4AAAAAAAAAAAAAAAAAAAAAAAAAAAAAAAAAAAAAAAAAAAAAAAAAAAAAAAAAAAAAAAAAQAAAAAAAAAAAAAAAAAAAAAAAAAAAAAAAAAAAAAAAAAAAAAAAAAAAAEAAAAAPAEAAAAAAAAIAAAAMjQwOTE0LjAqAQAAeyJ3YXNfZmlyc3RfZXZlbnQiOmZhbHNlLCJpbWFnZV9pZCI6WzE2Njg3OTMyODksODQ2NDIwOTI1LDE3NzU3NjM0MywzODM1ODczODYyLDY2MzMzNTUzLDI4OTQ1NjYwMzAsNTk4Mjc1ODE1LDI3MTgyNzg1ODBdLCJxZiI6eyJiIjpbMCwwLDAsMCwwLDAsMCwwLDAsMCwwLDAsMCwwLDAsMCwwLDAsMCwwLDAsMCwwLDAsMCwwLDAsMCwwLDAsMCwwLDAsMCwwLDAsMCwwLDAsMCwwLDAsMCwwLDAsMCwwLDAsMCwwLDAsMCwwLDAsMCwwLDAsMCwwLDAsMCwwLDAsMCwwLDAsMCwwLDAsMCwwLDAsMF0sImwiOjAsInEiOjYsInIiOjd9fQAAAAAAAAAAAAAAAAAAPAEAAAAAAAAIAAAAMjQwOTE0LjAqAQAAeyJ3YXNfZmlyc3RfZXZlbnQiOmZhbHNlLCJpbWFnZV9pZCI6WzE2Njg3OTMyODksODQ2NDIwOTI1LDE3NzU3NjM0MywzODM1ODczODYyLDY2MzMzNTUzLDI4OTQ1NjYwMzAsNTk4Mjc1ODE1LDI3MTgyNzg1ODBdLCJxZiI6eyJiIjpbMCwwLDAsMCwwLDAsMCwwLDAsMCwwLDAsMCwwLDAsMCwwLDAsMCwwLDAsMCwwLDAsMCwwLDAsMCwwLDAsMCwwLDAsMCwwLDAsMCwwLDAsMCwwLDAsMCwwLDAsMCwwLDAsMCwwLDAsMCwwLDAsMCwwLDAsMCwwLDAsMCwwLDAsMCwwLDAsMCwwLDAsMCwwLDAsMF0sImwiOjAsInEiOjYsInIiOjd9fQAAAAAAAAAAAAAAAAAAAAAAAAAAAAAAAAAAAAAAAAAAAAA='}}
prove_95;56;83;Mul;4648;245562;0.0;833;6.738322166000216;{'verificationValue': 0.0, 'proof': {'imageId': [1668793289, 846420925, 177576343, 3835873862, 66333553, 2894566030, 598275815, 2718278580], 'receipt': 'AwAAAAAAAAAAAAAAFPIgAEBa/KxpnrWjLW5ZBdoVsH8Dr4kePkUNGJK+LwGcLUh4AAAAAAAAAAAAAAAAAAAAAAAAAAAAAAAAAAAAAAAAAAAAAAAAAAAAAAAAAAAAAAAAAQAAAAAAAAAAAAAAAAAAAAAAAAAAAAAAAAAAAAAAAAAAAAAAAAAAAAEAAAAAPAEAAAAAAAAIAAAAMjQ1NTYyLjAqAQAAeyJ3YXNfZmlyc3RfZXZlbnQiOmZhbHNlLCJpbWFnZV9pZCI6WzE2Njg3OTMyODksODQ2NDIwOTI1LDE3NzU3NjM0MywzODM1ODczODYyLDY2MzMzNTUzLDI4OTQ1NjYwMzAsNTk4Mjc1ODE1LDI3MTgyNzg1ODBdLCJxZiI6eyJiIjpbMCwwLDAsMCwwLDAsMCwwLDAsMCwwLDAsMCwwLDAsMCwwLDAsMCwwLDAsMCwwLDAsMCwwLDAsMCwwLDAsMCwwLDAsMCwwLDAsMCwwLDAsMCwwLDAsMCwwLDAsMCwwLDAsMCwwLDAsMCwwLDAsMCwwLDAsMCwwLDAsMCwwLDAsMCwwLDAsMCwwLDAsMCwwLDAsMF0sImwiOjAsInEiOjYsInIiOjd9fQAAAAAAAAAAAAAAAAAAPAEAAAAAAAAIAAAAMjQ1NTYyLjAqAQAAeyJ3YXNfZmlyc3RfZXZlbnQiOmZhbHNlLCJpbWFnZV9pZCI6WzE2Njg3OTMyODksODQ2NDIwOTI1LDE3NzU3NjM0MywzODM1ODczODYyLDY2MzMzNTUzLDI4OTQ1NjYwMzAsNTk4Mjc1ODE1LDI3MTgyNzg1ODBdLCJxZiI6eyJiIjpbMCwwLDAsMCwwLDAsMCwwLDAsMCwwLDAsMCwwLDAsMCwwLDAsMCwwLDAsMCwwLDAsMCwwLDAsMCwwLDAsMCwwLDAsMCwwLDAsMCwwLDAsMCwwLDAsMCwwLDAsMCwwLDAsMCwwLDAsMCwwLDAsMCwwLDAsMCwwLDAsMCwwLDAsMCwwLDAsMCwwLDAsMCwwLDAsMF0sImwiOjAsInEiOjYsInIiOjd9fQAAAAAAAAAAAAAAAAAAAAAAAAAAAAAAAAAAAAAAAAAAAAA='}}
prove_96;60;76;Mul;4560;250122;0.0;833;6.759218625000358;{'verificationValue': 0.0, 'proof': {'imageId': [1668793289, 846420925, 177576343, 3835873862, 66333553, 2894566030, 598275815, 2718278580], 'receipt': 'AwAAAAAAAAAAAAAAFPIgAEBa/KxpnrWjLW5ZBdoVsH8Dr4kePkUNGJK+LwGcLUh4AAAAAAAAAAAAAAAAAAAAAAAAAAAAAAAAAAAAAAAAAAAAAAAAAAAAAAAAAAAAAAAAAQAAAAAAAAAAAAAAAAAAAAAAAAAAAAAAAAAAAAAAAAAAAAAAAAAAAAEAAAAAPAEAAAAAAAAIAAAAMjUwMTIyLjAqAQAAeyJ3YXNfZmlyc3RfZXZlbnQiOmZhbHNlLCJpbWFnZV9pZCI6WzE2Njg3OTMyODksODQ2NDIwOTI1LDE3NzU3NjM0MywzODM1ODczODYyLDY2MzMzNTUzLDI4OTQ1NjYwMzAsNTk4Mjc1ODE1LDI3MTgyNzg1ODBdLCJxZiI6eyJiIjpbMCwwLDAsMCwwLDAsMCwwLDAsMCwwLDAsMCwwLDAsMCwwLDAsMCwwLDAsMCwwLDAsMCwwLDAsMCwwLDAsMCwwLDAsMCwwLDAsMCwwLDAsMCwwLDAsMCwwLDAsMCwwLDAsMCwwLDAsMCwwLDAsMCwwLDAsMCwwLDAsMCwwLDAsMCwwLDAsMCwwLDAsMCwwLDAsMF0sImwiOjAsInEiOjYsInIiOjd9fQAAAAAAAAAAAAAAAAAAPAEAAAAAAAAIAAAAMjUwMTIyLjAqAQAAeyJ3YXNfZmlyc3RfZXZlbnQiOmZhbHNlLCJpbWFnZV9pZCI6WzE2Njg3OTMyODksODQ2NDIwOTI1LDE3NzU3NjM0MywzODM1ODczODYyLDY2MzMzNTUzLDI4OTQ1NjYwMzAsNTk4Mjc1ODE1LDI3MTgyNzg1ODBdLCJxZiI6eyJiIjpbMCwwLDAsMCwwLDAsMCwwLDAsMCwwLDAsMCwwLDAsMCwwLDAsMCwwLDAsMCwwLDAsMCwwLDAsMCwwLDAsMCwwLDAsMCwwLDAsMCwwLDAsMCwwLDAsMCwwLDAsMCwwLDAsMCwwLDAsMCwwLDAsMCwwLDAsMCwwLDAsMCwwLDAsMCwwLDAsMCwwLDAsMCwwLDAsMF0sImwiOjAsInEiOjYsInIiOjd9fQAAAAAAAAAAAAAAAAAAAAAAAAAAAAAAAAAAAAAAAAAAAAA='}}
prove_97;61;26;Mul;1586;251708;0.0;833;6.841097334001461;{'verificationValue': 0.0, 'proof': {'imageId': [1668793289, 846420925, 177576343, 3835873862, 66333553, 2894566030, 598275815, 2718278580], 'receipt': 'AwAAAAAAAAAAAAAAFPIgAEBa/KxpnrWjLW5ZBdoVsH8Dr4kePkUNGJK+LwGcLUh4AAAAAAAAAAAAAAAAAAAAAAAAAAAAAAAAAAAAAAAAAAAAAAAAAAAAAAAAAAAAAAAAAQAAAAAAAAAAAAAAAAAAAAAAAAAAAAAAAAAAAAAAAAAAAAAAAAAAAAEAAAAAPAEAAAAAAAAIAAAAMjUxNzA4LjAqAQAAeyJ3YXNfZmlyc3RfZXZlbnQiOmZhbHNlLCJpbWFnZV9pZCI6WzE2Njg3OTMyODksODQ2NDIwOTI1LDE3NzU3NjM0MywzODM1ODczODYyLDY2MzMzNTUzLDI4OTQ1NjYwMzAsNTk4Mjc1ODE1LDI3MTgyNzg1ODBdLCJxZiI6eyJiIjpbMCwwLDAsMCwwLDAsMCwwLDAsMCwwLDAsMCwwLDAsMCwwLDAsMCwwLDAsMCwwLDAsMCwwLDAsMCwwLDAsMCwwLDAsMCwwLDAsMCwwLDAsMCwwLDAsMCwwLDAsMCwwLDAsMCwwLDAsMCwwLDAsMCwwLDAsMCwwLDAsMCwwLDAsMCwwLDAsMCwwLDAsMCwwLDAsMF0sImwiOjAsInEiOjYsInIiOjd9fQAAAAAAAAAAAAAAAAAAPAEAAAAAAAAIAAAAMjUxNzA4LjAqAQAAeyJ3YXNfZmlyc3RfZXZlbnQiOmZhbHNlLCJpbWFnZV9pZCI6WzE2Njg3OTMyODksODQ2NDIwOTI1LDE3NzU3NjM0MywzODM1ODczODYyLDY2MzMzNTUzLDI4OTQ1NjYwMzAsNTk4Mjc1ODE1LDI3MTgyNzg1ODBdLCJxZiI6eyJiIjpbMCwwLDAsMCwwLDAsMCwwLDAsMCwwLDAsMCwwLDAsMCwwLDAsMCwwLDAsMCwwLDAsMCwwLDAsMCwwLDAsMCwwLDAsMCwwLDAsMCwwLDAsMCwwLDAsMCwwLDAsMCwwLDAsMCwwLDAsMCwwLDAsMCwwLDAsMCwwLDAsMCwwLDAsMCwwLDAsMCwwLDAsMCwwLDAsMF0sImwiOjAsInEiOjYsInIiOjd9fQAAAAAAAAAAAAAAAAAAAAAAAAAAAAAAAAAAAAAAAAAAAAA='}}
prove_98;50;72;Mul;3600;255308;0.0;833;6.713729458000671;{'verificationValue': 0.0, 'proof': {'imageId': [1668793289, 846420925, 177576343, 3835873862, 66333553, 2894566030, 598275815, 2718278580], 'receipt': 'AwAAAAAAAAAAAAAAFPIgAEBa/KxpnrWjLW5ZBdoVsH8Dr4kePkUNGJK+LwGcLUh4AAAAAAAAAAAAAAAAAAAAAAAAAAAAAAAAAAAAAAAAAAAAAAAAAAAAAAAAAAAAAAAAAQAAAAAAAAAAAAAAAAAAAAAAAAAAAAAAAAAAAAAAAAAAAAAAAAAAAAEAAAAAPAEAAAAAAAAIAAAAMjU1MzA4LjAqAQAAeyJ3YXNfZmlyc3RfZXZlbnQiOmZhbHNlLCJpbWFnZV9pZCI6WzE2Njg3OTMyODksODQ2NDIwOTI1LDE3NzU3NjM0MywzODM1ODczODYyLDY2MzMzNTUzLDI4OTQ1NjYwMzAsNTk4Mjc1ODE1LDI3MTgyNzg1ODBdLCJxZiI6eyJiIjpbMCwwLDAsMCwwLDAsMCwwLDAsMCwwLDAsMCwwLDAsMCwwLDAsMCwwLDAsMCwwLDAsMCwwLDAsMCwwLDAsMCwwLDAsMCwwLDAsMCwwLDAsMCwwLDAsMCwwLDAsMCwwLDAsMCwwLDAsMCwwLDAsMCwwLDAsMCwwLDAsMCwwLDAsMCwwLDAsMCwwLDAsMCwwLDAsMF0sImwiOjAsInEiOjYsInIiOjd9fQAAAAAAAAAAAAAAAAAAPAEAAAAAAAAIAAAAMjU1MzA4LjAqAQAAeyJ3YXNfZmlyc3RfZXZlbnQiOmZhbHNlLCJpbWFnZV9pZCI6WzE2Njg3OTMyODksODQ2NDIwOTI1LDE3NzU3NjM0MywzODM1ODczODYyLDY2MzMzNTUzLDI4OTQ1NjYwMzAsNTk4Mjc1ODE1LDI3MTgyNzg1ODBdLCJxZiI6eyJiIjpbMCwwLDAsMCwwLDAsMCwwLDAsMCwwLDAsMCwwLDAsMCwwLDAsMCwwLDAsMCwwLDAsMCwwLDAsMCwwLDAsMCwwLDAsMCwwLDAsMCwwLDAsMCwwLDAsMCwwLDAsMCwwLDAsMCwwLDAsMCwwLDAsMCwwLDAsMCwwLDAsMCwwLDAsMCwwLDAsMCwwLDAsMCwwLDAsMF0sImwiOjAsInEiOjYsInIiOjd9fQAAAAAAAAAAAAAAAAAAAAAAAAAAAAAAAAAAAAAAAAAAAAA='}}
prove_99;54;34;Mul;1836;257144;0.0;833;6.764352292000694;{'verificationValue': 0.0, 'proof': {'imageId': [1668793289, 846420925, 177576343, 3835873862, 66333553, 2894566030, 598275815, 2718278580], 'receipt': 'AwAAAAAAAAAAAAAAFPIgAEBa/KxpnrWjLW5ZBdoVsH8Dr4kePkUNGJK+LwGcLUh4AAAAAAAAAAAAAAAAAAAAAAAAAAAAAAAAAAAAAAAAAAAAAAAAAAAAAAAAAAAAAAAAAQAAAAAAAAAAAAAAAAAAAAAAAAAAAAAAAAAAAAAAAAAAAAAAAAAAAAEAAAAAPAEAAAAAAAAIAAAAMjU3MTQ0LjAqAQAAeyJ3YXNfZmlyc3RfZXZlbnQiOmZhbHNlLCJpbWFnZV9pZCI6WzE2Njg3OTMyODksODQ2NDIwOTI1LDE3NzU3NjM0MywzODM1ODczODYyLDY2MzMzNTUzLDI4OTQ1NjYwMzAsNTk4Mjc1ODE1LDI3MTgyNzg1ODBdLCJxZiI6eyJiIjpbMCwwLDAsMCwwLDAsMCwwLDAsMCwwLDAsMCwwLDAsMCwwLDAsMCwwLDAsMCwwLDAsMCwwLDAsMCwwLDAsMCwwLDAsMCwwLDAsMCwwLDAsMCwwLDAsMCwwLDAsMCwwLDAsMCwwLDAsMCwwLDAsMCwwLDAsMCwwLDAsMCwwLDAsMCwwLDAsMCwwLDAsMCwwLDAsMF0sImwiOjAsInEiOjYsInIiOjd9fQAAAAAAAAAAAAAAAAAAPAEAAAAAAAAIAAAAMjU3MTQ0LjAqAQAAeyJ3YXNfZmlyc3RfZXZlbnQiOmZhbHNlLCJpbWFnZV9pZCI6WzE2Njg3OTMyODksODQ2NDIwOTI1LDE3NzU3NjM0MywzODM1ODczODYyLDY2MzMzNTUzLDI4OTQ1NjYwMzAsNTk4Mjc1ODE1LDI3MTgyNzg1ODBdLCJxZiI6eyJiIjpbMCwwLDAsMCwwLDAsMCwwLDAsMCwwLDAsMCwwLDAsMCwwLDAsMCwwLDAsMCwwLDAsMCwwLDAsMCwwLDAsMCwwLDAsMCwwLDAsMCwwLDAsMCwwLDAsMCwwLDAsMCwwLDAsMCwwLDAsMCwwLDAsMCwwLDAsMCwwLDAsMCwwLDAsMCwwLDAsMCwwLDAsMCwwLDAsMF0sImwiOjAsInEiOjYsInIiOjd9fQAAAAAAAAAAAAAAAAAAAAAAAAAAAAAAAAAAAAAAAAAAAAA='}}
