;a;b;operation;calculated;cumulative;result;proof_size;seconds;response
prove_0;92;2;Mul;184;184;184.0;841;0.08165254100094899;{'verificationValue': 184.0, 'proof': {'imageId': [235478173, 1426634340, 1724434694, 1269151235, 2299687509, 3333770039, 3761160093, 4005458376], 'receipt': 'AwAAAAAAAAAAAAAAmL4gACyGqXD9SCTqBr57Fe21xvS89IksDAnB7FD2cs3kOUscAAAAAAAAAAAAAAAAAAAAAAAAAAAAAAAAAAAAAAAAAAAAAAAAAAAAAAAAAAAAAAAAAQAAAAAAAAAAAAAAAAAAAAAAAAAAAAAAAAAAAAAAAAAAAAAAAAAAAAEAAAAAQAEAAAAAAAAFAAAAMTg0LjAAAAAtAQAAeyJ3YXNfZmlyc3RfZXZlbnQiOnRydWUsImltYWdlX2lkIjpbMjM1NDc4MTczLDE0MjY2MzQzNDAsMTcyNDQzNDY5NCwxMjY5MTUxMjM1LDIyOTk2ODc1MDksMzMzMzc3MDAzOSwzNzYxMTYwMDkzLDQwMDU0NTgzNzZdLCJxZiI6eyJiIjpbMCwwLDAsMCwwLDAsMCwwLDAsMCwwLDAsMCwwLDAsMCwwLDAsMCwwLDAsMCwwLDAsMCwwLDAsMCwwLDAsMCwwLDAsMCwwLDAsMCwwLDAsMCwwLDAsMCwwLDAsMCwwLDAsMCwwLDAsMCwwLDAsMCwwLDAsMCwwLDAsMCwwLDAsMCwwLDAsMCwwLDAsMCwwLDAsMF0sImwiOjAsInEiOjYsInIiOjd9fQAAAAAAAAAAAAAAAAAAAEABAAAAAAAABQAAADE4NC4wAAAALQEAAHsid2FzX2ZpcnN0X2V2ZW50Ijp0cnVlLCJpbWFnZV9pZCI6WzIzNTQ3ODE3MywxNDI2NjM0MzQwLDE3MjQ0MzQ2OTQsMTI2OTE1MTIzNSwyMjk5Njg3NTA5LDMzMzM3NzAwMzksMzc2MTE2MDA5Myw0MDA1NDU4Mzc2XSwicWYiOnsiYiI6WzAsMCwwLDAsMCwwLDAsMCwwLDAsMCwwLDAsMCwwLDAsMCwwLDAsMCwwLDAsMCwwLDAsMCwwLDAsMCwwLDAsMCwwLDAsMCwwLDAsMCwwLDAsMCwwLDAsMCwwLDAsMCwwLDAsMCwwLDAsMCwwLDAsMCwwLDAsMCwwLDAsMCwwLDAsMCwwLDAsMCwwLDAsMCwwLDBdLCJsIjowLCJxIjo2LCJyIjo3fX0AAAAAAAAAAAAAAAAAAAAAAAAAAAAAAAAAAAAAAAAAAAAAAA=='}}
prove_1;8;9;Mul;72;256;256.0;841;0.06331412500003353;{'verificationValue': 256.0, 'proof': {'imageId': [235478173, 1426634340, 1724434694, 1269151235, 2299687509, 3333770039, 3761160093, 4005458376], 'receipt': 'AwAAAAAAAAAAAAAAmL4gACyGqXD9SCTqBr57Fe21xvS89IksDAnB7FD2cs3kOUscAAAAAAAAAAAAAAAAAAAAAAAAAAAAAAAAAAAAAAAAAAAAAAAAAAAAAAAAAAAAAAAAAQAAAAAAAAAAAAAAAAAAAAAAAAAAAAAAAAAAAAAAAAAAAAAAAAAAAAEAAAAAQAEAAAAAAAAFAAAAMjU2LjAAAAAtAQAAeyJ3YXNfZmlyc3RfZXZlbnQiOnRydWUsImltYWdlX2lkIjpbMjM1NDc4MTczLDE0MjY2MzQzNDAsMTcyNDQzNDY5NCwxMjY5MTUxMjM1LDIyOTk2ODc1MDksMzMzMzc3MDAzOSwzNzYxMTYwMDkzLDQwMDU0NTgzNzZdLCJxZiI6eyJiIjpbMCwwLDAsMCwwLDAsMCwwLDAsMCwwLDAsMCwwLDAsMCwwLDAsMCwwLDAsMCwwLDAsMCwwLDAsMCwwLDAsMCwwLDAsMCwwLDAsMCwwLDAsMCwwLDAsMCwwLDAsMCwwLDAsMCwwLDAsMCwwLDAsMCwwLDAsMCwwLDAsMCwwLDAsMCwwLDAsMCwwLDAsMCwwLDAsMF0sImwiOjAsInEiOjYsInIiOjd9fQAAAAAAAAAAAAAAAAAAAEABAAAAAAAABQAAADI1Ni4wAAAALQEAAHsid2FzX2ZpcnN0X2V2ZW50Ijp0cnVlLCJpbWFnZV9pZCI6WzIzNTQ3ODE3MywxNDI2NjM0MzQwLDE3MjQ0MzQ2OTQsMTI2OTE1MTIzNSwyMjk5Njg3NTA5LDMzMzM3NzAwMzksMzc2MTE2MDA5Myw0MDA1NDU4Mzc2XSwicWYiOnsiYiI6WzAsMCwwLDAsMCwwLDAsMCwwLDAsMCwwLDAsMCwwLDAsMCwwLDAsMCwwLDAsMCwwLDAsMCwwLDAsMCwwLDAsMCwwLDAsMCwwLDAsMCwwLDAsMCwwLDAsMCwwLDAsMCwwLDAsMCwwLDAsMCwwLDAsMCwwLDAsMCwwLDAsMCwwLDAsMCwwLDAsMCwwLDAsMCwwLDBdLCJsIjowLCJxIjo2LCJyIjo3fX0AAAAAAAAAAAAAAAAAAAAAAAAAAAAAAAAAAAAAAAAAAAAAAA=='}}
prove_2;68;16;Mul;1088;1344;1344.0;841;0.06306779199985613;{'verificationValue': 1344.0, 'proof': {'imageId': [235478173, 1426634340, 1724434694, 1269151235, 2299687509, 3333770039, 3761160093, 4005458376], 'receipt': 'AwAAAAAAAAAAAAAAmL4gACyGqXD9SCTqBr57Fe21xvS89IksDAnB7FD2cs3kOUscAAAAAAAAAAAAAAAAAAAAAAAAAAAAAAAAAAAAAAAAAAAAAAAAAAAAAAAAAAAAAAAAAQAAAAAAAAAAAAAAAAAAAAAAAAAAAAAAAAAAAAAAAAAAAAAAAAAAAAEAAAAAQAEAAAAAAAAGAAAAMTM0NC4wAAAtAQAAeyJ3YXNfZmlyc3RfZXZlbnQiOnRydWUsImltYWdlX2lkIjpbMjM1NDc4MTczLDE0MjY2MzQzNDAsMTcyNDQzNDY5NCwxMjY5MTUxMjM1LDIyOTk2ODc1MDksMzMzMzc3MDAzOSwzNzYxMTYwMDkzLDQwMDU0NTgzNzZdLCJxZiI6eyJiIjpbMCwwLDAsMCwwLDAsMCwwLDAsMCwwLDAsMCwwLDAsMCwwLDAsMCwwLDAsMCwwLDAsMCwwLDAsMCwwLDAsMCwwLDAsMCwwLDAsMCwwLDAsMCwwLDAsMCwwLDAsMCwwLDAsMCwwLDAsMCwwLDAsMCwwLDAsMCwwLDAsMCwwLDAsMCwwLDAsMCwwLDAsMCwwLDAsMF0sImwiOjAsInEiOjYsInIiOjd9fQAAAAAAAAAAAAAAAAAAAEABAAAAAAAABgAAADEzNDQuMAAALQEAAHsid2FzX2ZpcnN0X2V2ZW50Ijp0cnVlLCJpbWFnZV9pZCI6WzIzNTQ3ODE3MywxNDI2NjM0MzQwLDE3MjQ0MzQ2OTQsMTI2OTE1MTIzNSwyMjk5Njg3NTA5LDMzMzM3NzAwMzksMzc2MTE2MDA5Myw0MDA1NDU4Mzc2XSwicWYiOnsiYiI6WzAsMCwwLDAsMCwwLDAsMCwwLDAsMCwwLDAsMCwwLDAsMCwwLDAsMCwwLDAsMCwwLDAsMCwwLDAsMCwwLDAsMCwwLDAsMCwwLDAsMCwwLDAsMCwwLDAsMCwwLDAsMCwwLDAsMCwwLDAsMCwwLDAsMCwwLDAsMCwwLDAsMCwwLDAsMCwwLDAsMCwwLDAsMCwwLDBdLCJsIjowLCJxIjo2LCJyIjo3fX0AAAAAAAAAAAAAAAAAAAAAAAAAAAAAAAAAAAAAAAAAAAAAAA=='}}
prove_3;54;58;Mul;3132;4476;4476.0;841;0.06251966699892364;{'verificationValue': 4476.0, 'proof': {'imageId': [235478173, 1426634340, 1724434694, 1269151235, 2299687509, 3333770039, 3761160093, 4005458376], 'receipt': 'AwAAAAAAAAAAAAAAmL4gACyGqXD9SCTqBr57Fe21xvS89IksDAnB7FD2cs3kOUscAAAAAAAAAAAAAAAAAAAAAAAAAAAAAAAAAAAAAAAAAAAAAAAAAAAAAAAAAAAAAAAAAQAAAAAAAAAAAAAAAAAAAAAAAAAAAAAAAAAAAAAAAAAAAAAAAAAAAAEAAAAAQAEAAAAAAAAGAAAANDQ3Ni4wAAAtAQAAeyJ3YXNfZmlyc3RfZXZlbnQiOnRydWUsImltYWdlX2lkIjpbMjM1NDc4MTczLDE0MjY2MzQzNDAsMTcyNDQzNDY5NCwxMjY5MTUxMjM1LDIyOTk2ODc1MDksMzMzMzc3MDAzOSwzNzYxMTYwMDkzLDQwMDU0NTgzNzZdLCJxZiI6eyJiIjpbMCwwLDAsMCwwLDAsMCwwLDAsMCwwLDAsMCwwLDAsMCwwLDAsMCwwLDAsMCwwLDAsMCwwLDAsMCwwLDAsMCwwLDAsMCwwLDAsMCwwLDAsMCwwLDAsMCwwLDAsMCwwLDAsMCwwLDAsMCwwLDAsMCwwLDAsMCwwLDAsMCwwLDAsMCwwLDAsMCwwLDAsMCwwLDAsMF0sImwiOjAsInEiOjYsInIiOjd9fQAAAAAAAAAAAAAAAAAAAEABAAAAAAAABgAAADQ0NzYuMAAALQEAAHsid2FzX2ZpcnN0X2V2ZW50Ijp0cnVlLCJpbWFnZV9pZCI6WzIzNTQ3ODE3MywxNDI2NjM0MzQwLDE3MjQ0MzQ2OTQsMTI2OTE1MTIzNSwyMjk5Njg3NTA5LDMzMzM3NzAwMzksMzc2MTE2MDA5Myw0MDA1NDU4Mzc2XSwicWYiOnsiYiI6WzAsMCwwLDAsMCwwLDAsMCwwLDAsMCwwLDAsMCwwLDAsMCwwLDAsMCwwLDAsMCwwLDAsMCwwLDAsMCwwLDAsMCwwLDAsMCwwLDAsMCwwLDAsMCwwLDAsMCwwLDAsMCwwLDAsMCwwLDAsMCwwLDAsMCwwLDAsMCwwLDAsMCwwLDAsMCwwLDAsMCwwLDAsMCwwLDBdLCJsIjowLCJxIjo2LCJyIjo3fX0AAAAAAAAAAAAAAAAAAAAAAAAAAAAAAAAAAAAAAAAAAAAAAA=='}}
prove_4;20;59;Mul;1180;5656;5656.0;841;0.06309895900085394;{'verificationValue': 5656.0, 'proof': {'imageId': [235478173, 1426634340, 1724434694, 1269151235, 2299687509, 3333770039, 3761160093, 4005458376], 'receipt': 'AwAAAAAAAAAAAAAAmL4gACyGqXD9SCTqBr57Fe21xvS89IksDAnB7FD2cs3kOUscAAAAAAAAAAAAAAAAAAAAAAAAAAAAAAAAAAAAAAAAAAAAAAAAAAAAAAAAAAAAAAAAAQAAAAAAAAAAAAAAAAAAAAAAAAAAAAAAAAAAAAAAAAAAAAAAAAAAAAEAAAAAQAEAAAAAAAAGAAAANTY1Ni4wAAAtAQAAeyJ3YXNfZmlyc3RfZXZlbnQiOnRydWUsImltYWdlX2lkIjpbMjM1NDc4MTczLDE0MjY2MzQzNDAsMTcyNDQzNDY5NCwxMjY5MTUxMjM1LDIyOTk2ODc1MDksMzMzMzc3MDAzOSwzNzYxMTYwMDkzLDQwMDU0NTgzNzZdLCJxZiI6eyJiIjpbMCwwLDAsMCwwLDAsMCwwLDAsMCwwLDAsMCwwLDAsMCwwLDAsMCwwLDAsMCwwLDAsMCwwLDAsMCwwLDAsMCwwLDAsMCwwLDAsMCwwLDAsMCwwLDAsMCwwLDAsMCwwLDAsMCwwLDAsMCwwLDAsMCwwLDAsMCwwLDAsMCwwLDAsMCwwLDAsMCwwLDAsMCwwLDAsMF0sImwiOjAsInEiOjYsInIiOjd9fQAAAAAAAAAAAAAAAAAAAEABAAAAAAAABgAAADU2NTYuMAAALQEAAHsid2FzX2ZpcnN0X2V2ZW50Ijp0cnVlLCJpbWFnZV9pZCI6WzIzNTQ3ODE3MywxNDI2NjM0MzQwLDE3MjQ0MzQ2OTQsMTI2OTE1MTIzNSwyMjk5Njg3NTA5LDMzMzM3NzAwMzksMzc2MTE2MDA5Myw0MDA1NDU4Mzc2XSwicWYiOnsiYiI6WzAsMCwwLDAsMCwwLDAsMCwwLDAsMCwwLDAsMCwwLDAsMCwwLDAsMCwwLDAsMCwwLDAsMCwwLDAsMCwwLDAsMCwwLDAsMCwwLDAsMCwwLDAsMCwwLDAsMCwwLDAsMCwwLDAsMCwwLDAsMCwwLDAsMCwwLDAsMCwwLDAsMCwwLDAsMCwwLDAsMCwwLDAsMCwwLDBdLCJsIjowLCJxIjo2LCJyIjo3fX0AAAAAAAAAAAAAAAAAAAAAAAAAAAAAAAAAAAAAAAAAAAAAAA=='}}
prove_5;52;15;Mul;780;6436;6436.0;841;0.0631405830008589;{'verificationValue': 6436.0, 'proof': {'imageId': [235478173, 1426634340, 1724434694, 1269151235, 2299687509, 3333770039, 3761160093, 4005458376], 'receipt': 'AwAAAAAAAAAAAAAAmL4gACyGqXD9SCTqBr57Fe21xvS89IksDAnB7FD2cs3kOUscAAAAAAAAAAAAAAAAAAAAAAAAAAAAAAAAAAAAAAAAAAAAAAAAAAAAAAAAAAAAAAAAAQAAAAAAAAAAAAAAAAAAAAAAAAAAAAAAAAAAAAAAAAAAAAAAAAAAAAEAAAAAQAEAAAAAAAAGAAAANjQzNi4wAAAtAQAAeyJ3YXNfZmlyc3RfZXZlbnQiOnRydWUsImltYWdlX2lkIjpbMjM1NDc4MTczLDE0MjY2MzQzNDAsMTcyNDQzNDY5NCwxMjY5MTUxMjM1LDIyOTk2ODc1MDksMzMzMzc3MDAzOSwzNzYxMTYwMDkzLDQwMDU0NTgzNzZdLCJxZiI6eyJiIjpbMCwwLDAsMCwwLDAsMCwwLDAsMCwwLDAsMCwwLDAsMCwwLDAsMCwwLDAsMCwwLDAsMCwwLDAsMCwwLDAsMCwwLDAsMCwwLDAsMCwwLDAsMCwwLDAsMCwwLDAsMCwwLDAsMCwwLDAsMCwwLDAsMCwwLDAsMCwwLDAsMCwwLDAsMCwwLDAsMCwwLDAsMCwwLDAsMF0sImwiOjAsInEiOjYsInIiOjd9fQAAAAAAAAAAAAAAAAAAAEABAAAAAAAABgAAADY0MzYuMAAALQEAAHsid2FzX2ZpcnN0X2V2ZW50Ijp0cnVlLCJpbWFnZV9pZCI6WzIzNTQ3ODE3MywxNDI2NjM0MzQwLDE3MjQ0MzQ2OTQsMTI2OTE1MTIzNSwyMjk5Njg3NTA5LDMzMzM3NzAwMzksMzc2MTE2MDA5Myw0MDA1NDU4Mzc2XSwicWYiOnsiYiI6WzAsMCwwLDAsMCwwLDAsMCwwLDAsMCwwLDAsMCwwLDAsMCwwLDAsMCwwLDAsMCwwLDAsMCwwLDAsMCwwLDAsMCwwLDAsMCwwLDAsMCwwLDAsMCwwLDAsMCwwLDAsMCwwLDAsMCwwLDAsMCwwLDAsMCwwLDAsMCwwLDAsMCwwLDAsMCwwLDAsMCwwLDAsMCwwLDBdLCJsIjowLCJxIjo2LCJyIjo3fX0AAAAAAAAAAAAAAAAAAAAAAAAAAAAAAAAAAAAAAAAAAAAAAA=='}}
prove_6;88;38;Mul;3344;9780;9780.0;841;0.06564716699904238;{'verificationValue': 9780.0, 'proof': {'imageId': [235478173, 1426634340, 1724434694, 1269151235, 2299687509, 3333770039, 3761160093, 4005458376], 'receipt': 'AwAAAAAAAAAAAAAAmL4gACyGqXD9SCTqBr57Fe21xvS89IksDAnB7FD2cs3kOUscAAAAAAAAAAAAAAAAAAAAAAAAAAAAAAAAAAAAAAAAAAAAAAAAAAAAAAAAAAAAAAAAAQAAAAAAAAAAAAAAAAAAAAAAAAAAAAAAAAAAAAAAAAAAAAAAAAAAAAEAAAAAQAEAAAAAAAAGAAAAOTc4MC4wAAAtAQAAeyJ3YXNfZmlyc3RfZXZlbnQiOnRydWUsImltYWdlX2lkIjpbMjM1NDc4MTczLDE0MjY2MzQzNDAsMTcyNDQzNDY5NCwxMjY5MTUxMjM1LDIyOTk2ODc1MDksMzMzMzc3MDAzOSwzNzYxMTYwMDkzLDQwMDU0NTgzNzZdLCJxZiI6eyJiIjpbMCwwLDAsMCwwLDAsMCwwLDAsMCwwLDAsMCwwLDAsMCwwLDAsMCwwLDAsMCwwLDAsMCwwLDAsMCwwLDAsMCwwLDAsMCwwLDAsMCwwLDAsMCwwLDAsMCwwLDAsMCwwLDAsMCwwLDAsMCwwLDAsMCwwLDAsMCwwLDAsMCwwLDAsMCwwLDAsMCwwLDAsMCwwLDAsMF0sImwiOjAsInEiOjYsInIiOjd9fQAAAAAAAAAAAAAAAAAAAEABAAAAAAAABgAAADk3ODAuMAAALQEAAHsid2FzX2ZpcnN0X2V2ZW50Ijp0cnVlLCJpbWFnZV9pZCI6WzIzNTQ3ODE3MywxNDI2NjM0MzQwLDE3MjQ0MzQ2OTQsMTI2OTE1MTIzNSwyMjk5Njg3NTA5LDMzMzM3NzAwMzksMzc2MTE2MDA5Myw0MDA1NDU4Mzc2XSwicWYiOnsiYiI6WzAsMCwwLDAsMCwwLDAsMCwwLDAsMCwwLDAsMCwwLDAsMCwwLDAsMCwwLDAsMCwwLDAsMCwwLDAsMCwwLDAsMCwwLDAsMCwwLDAsMCwwLDAsMCwwLDAsMCwwLDAsMCwwLDAsMCwwLDAsMCwwLDAsMCwwLDAsMCwwLDAsMCwwLDAsMCwwLDAsMCwwLDAsMCwwLDBdLCJsIjowLCJxIjo2LCJyIjo3fX0AAAAAAAAAAAAAAAAAAAAAAAAAAAAAAAAAAAAAAAAAAAAAAA=='}}
prove_7;89;61;Mul;5429;15209;15209.0;841;0.06469937499969092;{'verificationValue': 15209.0, 'proof': {'imageId': [235478173, 1426634340, 1724434694, 1269151235, 2299687509, 3333770039, 3761160093, 4005458376], 'receipt': 'AwAAAAAAAAAAAAAAmL4gACyGqXD9SCTqBr57Fe21xvS89IksDAnB7FD2cs3kOUscAAAAAAAAAAAAAAAAAAAAAAAAAAAAAAAAAAAAAAAAAAAAAAAAAAAAAAAAAAAAAAAAAQAAAAAAAAAAAAAAAAAAAAAAAAAAAAAAAAAAAAAAAAAAAAAAAAAAAAEAAAAAQAEAAAAAAAAHAAAAMTUyMDkuMAAtAQAAeyJ3YXNfZmlyc3RfZXZlbnQiOnRydWUsImltYWdlX2lkIjpbMjM1NDc4MTczLDE0MjY2MzQzNDAsMTcyNDQzNDY5NCwxMjY5MTUxMjM1LDIyOTk2ODc1MDksMzMzMzc3MDAzOSwzNzYxMTYwMDkzLDQwMDU0NTgzNzZdLCJxZiI6eyJiIjpbMCwwLDAsMCwwLDAsMCwwLDAsMCwwLDAsMCwwLDAsMCwwLDAsMCwwLDAsMCwwLDAsMCwwLDAsMCwwLDAsMCwwLDAsMCwwLDAsMCwwLDAsMCwwLDAsMCwwLDAsMCwwLDAsMCwwLDAsMCwwLDAsMCwwLDAsMCwwLDAsMCwwLDAsMCwwLDAsMCwwLDAsMCwwLDAsMF0sImwiOjAsInEiOjYsInIiOjd9fQAAAAAAAAAAAAAAAAAAAEABAAAAAAAABwAAADE1MjA5LjAALQEAAHsid2FzX2ZpcnN0X2V2ZW50Ijp0cnVlLCJpbWFnZV9pZCI6WzIzNTQ3ODE3MywxNDI2NjM0MzQwLDE3MjQ0MzQ2OTQsMTI2OTE1MTIzNSwyMjk5Njg3NTA5LDMzMzM3NzAwMzksMzc2MTE2MDA5Myw0MDA1NDU4Mzc2XSwicWYiOnsiYiI6WzAsMCwwLDAsMCwwLDAsMCwwLDAsMCwwLDAsMCwwLDAsMCwwLDAsMCwwLDAsMCwwLDAsMCwwLDAsMCwwLDAsMCwwLDAsMCwwLDAsMCwwLDAsMCwwLDAsMCwwLDAsMCwwLDAsMCwwLDAsMCwwLDAsMCwwLDAsMCwwLDAsMCwwLDAsMCwwLDAsMCwwLDAsMCwwLDBdLCJsIjowLCJxIjo2LCJyIjo3fX0AAAAAAAAAAAAAAAAAAAAAAAAAAAAAAAAAAAAAAAAAAAAAAA=='}}
prove_8;3;72;Mul;216;15425;15425.0;841;0.06412762500076497;{'verificationValue': 15425.0, 'proof': {'imageId': [235478173, 1426634340, 1724434694, 1269151235, 2299687509, 3333770039, 3761160093, 4005458376], 'receipt': 'AwAAAAAAAAAAAAAAmL4gACyGqXD9SCTqBr57Fe21xvS89IksDAnB7FD2cs3kOUscAAAAAAAAAAAAAAAAAAAAAAAAAAAAAAAAAAAAAAAAAAAAAAAAAAAAAAAAAAAAAAAAAQAAAAAAAAAAAAAAAAAAAAAAAAAAAAAAAAAAAAAAAAAAAAAAAAAAAAEAAAAAQAEAAAAAAAAHAAAAMTU0MjUuMAAtAQAAeyJ3YXNfZmlyc3RfZXZlbnQiOnRydWUsImltYWdlX2lkIjpbMjM1NDc4MTczLDE0MjY2MzQzNDAsMTcyNDQzNDY5NCwxMjY5MTUxMjM1LDIyOTk2ODc1MDksMzMzMzc3MDAzOSwzNzYxMTYwMDkzLDQwMDU0NTgzNzZdLCJxZiI6eyJiIjpbMCwwLDAsMCwwLDAsMCwwLDAsMCwwLDAsMCwwLDAsMCwwLDAsMCwwLDAsMCwwLDAsMCwwLDAsMCwwLDAsMCwwLDAsMCwwLDAsMCwwLDAsMCwwLDAsMCwwLDAsMCwwLDAsMCwwLDAsMCwwLDAsMCwwLDAsMCwwLDAsMCwwLDAsMCwwLDAsMCwwLDAsMCwwLDAsMF0sImwiOjAsInEiOjYsInIiOjd9fQAAAAAAAAAAAAAAAAAAAEABAAAAAAAABwAAADE1NDI1LjAALQEAAHsid2FzX2ZpcnN0X2V2ZW50Ijp0cnVlLCJpbWFnZV9pZCI6WzIzNTQ3ODE3MywxNDI2NjM0MzQwLDE3MjQ0MzQ2OTQsMTI2OTE1MTIzNSwyMjk5Njg3NTA5LDMzMzM3NzAwMzksMzc2MTE2MDA5Myw0MDA1NDU4Mzc2XSwicWYiOnsiYiI6WzAsMCwwLDAsMCwwLDAsMCwwLDAsMCwwLDAsMCwwLDAsMCwwLDAsMCwwLDAsMCwwLDAsMCwwLDAsMCwwLDAsMCwwLDAsMCwwLDAsMCwwLDAsMCwwLDAsMCwwLDAsMCwwLDAsMCwwLDAsMCwwLDAsMCwwLDAsMCwwLDAsMCwwLDAsMCwwLDAsMCwwLDAsMCwwLDBdLCJsIjowLCJxIjo2LCJyIjo3fX0AAAAAAAAAAAAAAAAAAAAAAAAAAAAAAAAAAAAAAAAAAAAAAA=='}}
prove_9;2;77;Mul;154;15579;15579.0;841;0.06360516600034316;{'verificationValue': 15579.0, 'proof': {'imageId': [235478173, 1426634340, 1724434694, 1269151235, 2299687509, 3333770039, 3761160093, 4005458376], 'receipt': 'AwAAAAAAAAAAAAAAmL4gACyGqXD9SCTqBr57Fe21xvS89IksDAnB7FD2cs3kOUscAAAAAAAAAAAAAAAAAAAAAAAAAAAAAAAAAAAAAAAAAAAAAAAAAAAAAAAAAAAAAAAAAQAAAAAAAAAAAAAAAAAAAAAAAAAAAAAAAAAAAAAAAAAAAAAAAAAAAAEAAAAAQAEAAAAAAAAHAAAAMTU1NzkuMAAtAQAAeyJ3YXNfZmlyc3RfZXZlbnQiOnRydWUsImltYWdlX2lkIjpbMjM1NDc4MTczLDE0MjY2MzQzNDAsMTcyNDQzNDY5NCwxMjY5MTUxMjM1LDIyOTk2ODc1MDksMzMzMzc3MDAzOSwzNzYxMTYwMDkzLDQwMDU0NTgzNzZdLCJxZiI6eyJiIjpbMCwwLDAsMCwwLDAsMCwwLDAsMCwwLDAsMCwwLDAsMCwwLDAsMCwwLDAsMCwwLDAsMCwwLDAsMCwwLDAsMCwwLDAsMCwwLDAsMCwwLDAsMCwwLDAsMCwwLDAsMCwwLDAsMCwwLDAsMCwwLDAsMCwwLDAsMCwwLDAsMCwwLDAsMCwwLDAsMCwwLDAsMCwwLDAsMF0sImwiOjAsInEiOjYsInIiOjd9fQAAAAAAAAAAAAAAAAAAAEABAAAAAAAABwAAADE1NTc5LjAALQEAAHsid2FzX2ZpcnN0X2V2ZW50Ijp0cnVlLCJpbWFnZV9pZCI6WzIzNTQ3ODE3MywxNDI2NjM0MzQwLDE3MjQ0MzQ2OTQsMTI2OTE1MTIzNSwyMjk5Njg3NTA5LDMzMzM3NzAwMzksMzc2MTE2MDA5Myw0MDA1NDU4Mzc2XSwicWYiOnsiYiI6WzAsMCwwLDAsMCwwLDAsMCwwLDAsMCwwLDAsMCwwLDAsMCwwLDAsMCwwLDAsMCwwLDAsMCwwLDAsMCwwLDAsMCwwLDAsMCwwLDAsMCwwLDAsMCwwLDAsMCwwLDAsMCwwLDAsMCwwLDAsMCwwLDAsMCwwLDAsMCwwLDAsMCwwLDAsMCwwLDAsMCwwLDAsMCwwLDBdLCJsIjowLCJxIjo2LCJyIjo3fX0AAAAAAAAAAAAAAAAAAAAAAAAAAAAAAAAAAAAAAAAAAAAAAA=='}}
prove_10;91;38;Mul;3458;19037;19037.0;841;0.0643124580001313;{'verificationValue': 19037.0, 'proof': {'imageId': [235478173, 1426634340, 1724434694, 1269151235, 2299687509, 3333770039, 3761160093, 4005458376], 'receipt': 'AwAAAAAAAAAAAAAAmL4gACyGqXD9SCTqBr57Fe21xvS89IksDAnB7FD2cs3kOUscAAAAAAAAAAAAAAAAAAAAAAAAAAAAAAAAAAAAAAAAAAAAAAAAAAAAAAAAAAAAAAAAAQAAAAAAAAAAAAAAAAAAAAAAAAAAAAAAAAAAAAAAAAAAAAAAAAAAAAEAAAAAQAEAAAAAAAAHAAAAMTkwMzcuMAAtAQAAeyJ3YXNfZmlyc3RfZXZlbnQiOnRydWUsImltYWdlX2lkIjpbMjM1NDc4MTczLDE0MjY2MzQzNDAsMTcyNDQzNDY5NCwxMjY5MTUxMjM1LDIyOTk2ODc1MDksMzMzMzc3MDAzOSwzNzYxMTYwMDkzLDQwMDU0NTgzNzZdLCJxZiI6eyJiIjpbMCwwLDAsMCwwLDAsMCwwLDAsMCwwLDAsMCwwLDAsMCwwLDAsMCwwLDAsMCwwLDAsMCwwLDAsMCwwLDAsMCwwLDAsMCwwLDAsMCwwLDAsMCwwLDAsMCwwLDAsMCwwLDAsMCwwLDAsMCwwLDAsMCwwLDAsMCwwLDAsMCwwLDAsMCwwLDAsMCwwLDAsMCwwLDAsMF0sImwiOjAsInEiOjYsInIiOjd9fQAAAAAAAAAAAAAAAAAAAEABAAAAAAAABwAAADE5MDM3LjAALQEAAHsid2FzX2ZpcnN0X2V2ZW50Ijp0cnVlLCJpbWFnZV9pZCI6WzIzNTQ3ODE3MywxNDI2NjM0MzQwLDE3MjQ0MzQ2OTQsMTI2OTE1MTIzNSwyMjk5Njg3NTA5LDMzMzM3NzAwMzksMzc2MTE2MDA5Myw0MDA1NDU4Mzc2XSwicWYiOnsiYiI6WzAsMCwwLDAsMCwwLDAsMCwwLDAsMCwwLDAsMCwwLDAsMCwwLDAsMCwwLDAsMCwwLDAsMCwwLDAsMCwwLDAsMCwwLDAsMCwwLDAsMCwwLDAsMCwwLDAsMCwwLDAsMCwwLDAsMCwwLDAsMCwwLDAsMCwwLDAsMCwwLDAsMCwwLDAsMCwwLDAsMCwwLDAsMCwwLDBdLCJsIjowLCJxIjo2LCJyIjo3fX0AAAAAAAAAAAAAAAAAAAAAAAAAAAAAAAAAAAAAAAAAAAAAAA=='}}
prove_11;30;19;Mul;570;19607;19607.0;841;0.06420129199977964;{'verificationValue': 19607.0, 'proof': {'imageId': [235478173, 1426634340, 1724434694, 1269151235, 2299687509, 3333770039, 3761160093, 4005458376], 'receipt': 'AwAAAAAAAAAAAAAAmL4gACyGqXD9SCTqBr57Fe21xvS89IksDAnB7FD2cs3kOUscAAAAAAAAAAAAAAAAAAAAAAAAAAAAAAAAAAAAAAAAAAAAAAAAAAAAAAAAAAAAAAAAAQAAAAAAAAAAAAAAAAAAAAAAAAAAAAAAAAAAAAAAAAAAAAAAAAAAAAEAAAAAQAEAAAAAAAAHAAAAMTk2MDcuMAAtAQAAeyJ3YXNfZmlyc3RfZXZlbnQiOnRydWUsImltYWdlX2lkIjpbMjM1NDc4MTczLDE0MjY2MzQzNDAsMTcyNDQzNDY5NCwxMjY5MTUxMjM1LDIyOTk2ODc1MDksMzMzMzc3MDAzOSwzNzYxMTYwMDkzLDQwMDU0NTgzNzZdLCJxZiI6eyJiIjpbMCwwLDAsMCwwLDAsMCwwLDAsMCwwLDAsMCwwLDAsMCwwLDAsMCwwLDAsMCwwLDAsMCwwLDAsMCwwLDAsMCwwLDAsMCwwLDAsMCwwLDAsMCwwLDAsMCwwLDAsMCwwLDAsMCwwLDAsMCwwLDAsMCwwLDAsMCwwLDAsMCwwLDAsMCwwLDAsMCwwLDAsMCwwLDAsMF0sImwiOjAsInEiOjYsInIiOjd9fQAAAAAAAAAAAAAAAAAAAEABAAAAAAAABwAAADE5NjA3LjAALQEAAHsid2FzX2ZpcnN0X2V2ZW50Ijp0cnVlLCJpbWFnZV9pZCI6WzIzNTQ3ODE3MywxNDI2NjM0MzQwLDE3MjQ0MzQ2OTQsMTI2OTE1MTIzNSwyMjk5Njg3NTA5LDMzMzM3NzAwMzksMzc2MTE2MDA5Myw0MDA1NDU4Mzc2XSwicWYiOnsiYiI6WzAsMCwwLDAsMCwwLDAsMCwwLDAsMCwwLDAsMCwwLDAsMCwwLDAsMCwwLDAsMCwwLDAsMCwwLDAsMCwwLDAsMCwwLDAsMCwwLDAsMCwwLDAsMCwwLDAsMCwwLDAsMCwwLDAsMCwwLDAsMCwwLDAsMCwwLDAsMCwwLDAsMCwwLDAsMCwwLDAsMCwwLDAsMCwwLDBdLCJsIjowLCJxIjo2LCJyIjo3fX0AAAAAAAAAAAAAAAAAAAAAAAAAAAAAAAAAAAAAAAAAAAAAAA=='}}
prove_12;6;75;Mul;450;20057;20057.0;841;0.06347375000041211;{'verificationValue': 20057.0, 'proof': {'imageId': [235478173, 1426634340, 1724434694, 1269151235, 2299687509, 3333770039, 3761160093, 4005458376], 'receipt': 'AwAAAAAAAAAAAAAAmL4gACyGqXD9SCTqBr57Fe21xvS89IksDAnB7FD2cs3kOUscAAAAAAAAAAAAAAAAAAAAAAAAAAAAAAAAAAAAAAAAAAAAAAAAAAAAAAAAAAAAAAAAAQAAAAAAAAAAAAAAAAAAAAAAAAAAAAAAAAAAAAAAAAAAAAAAAAAAAAEAAAAAQAEAAAAAAAAHAAAAMjAwNTcuMAAtAQAAeyJ3YXNfZmlyc3RfZXZlbnQiOnRydWUsImltYWdlX2lkIjpbMjM1NDc4MTczLDE0MjY2MzQzNDAsMTcyNDQzNDY5NCwxMjY5MTUxMjM1LDIyOTk2ODc1MDksMzMzMzc3MDAzOSwzNzYxMTYwMDkzLDQwMDU0NTgzNzZdLCJxZiI6eyJiIjpbMCwwLDAsMCwwLDAsMCwwLDAsMCwwLDAsMCwwLDAsMCwwLDAsMCwwLDAsMCwwLDAsMCwwLDAsMCwwLDAsMCwwLDAsMCwwLDAsMCwwLDAsMCwwLDAsMCwwLDAsMCwwLDAsMCwwLDAsMCwwLDAsMCwwLDAsMCwwLDAsMCwwLDAsMCwwLDAsMCwwLDAsMCwwLDAsMF0sImwiOjAsInEiOjYsInIiOjd9fQAAAAAAAAAAAAAAAAAAAEABAAAAAAAABwAAADIwMDU3LjAALQEAAHsid2FzX2ZpcnN0X2V2ZW50Ijp0cnVlLCJpbWFnZV9pZCI6WzIzNTQ3ODE3MywxNDI2NjM0MzQwLDE3MjQ0MzQ2OTQsMTI2OTE1MTIzNSwyMjk5Njg3NTA5LDMzMzM3NzAwMzksMzc2MTE2MDA5Myw0MDA1NDU4Mzc2XSwicWYiOnsiYiI6WzAsMCwwLDAsMCwwLDAsMCwwLDAsMCwwLDAsMCwwLDAsMCwwLDAsMCwwLDAsMCwwLDAsMCwwLDAsMCwwLDAsMCwwLDAsMCwwLDAsMCwwLDAsMCwwLDAsMCwwLDAsMCwwLDAsMCwwLDAsMCwwLDAsMCwwLDAsMCwwLDAsMCwwLDAsMCwwLDAsMCwwLDAsMCwwLDBdLCJsIjowLCJxIjo2LCJyIjo3fX0AAAAAAAAAAAAAAAAAAAAAAAAAAAAAAAAAAAAAAAAAAAAAAA=='}}
prove_13;40;8;Mul;320;20377;20377.0;841;0.06428683299964177;{'verificationValue': 20377.0, 'proof': {'imageId': [235478173, 1426634340, 1724434694, 1269151235, 2299687509, 3333770039, 3761160093, 4005458376], 'receipt': 'AwAAAAAAAAAAAAAAmL4gACyGqXD9SCTqBr57Fe21xvS89IksDAnB7FD2cs3kOUscAAAAAAAAAAAAAAAAAAAAAAAAAAAAAAAAAAAAAAAAAAAAAAAAAAAAAAAAAAAAAAAAAQAAAAAAAAAAAAAAAAAAAAAAAAAAAAAAAAAAAAAAAAAAAAAAAAAAAAEAAAAAQAEAAAAAAAAHAAAAMjAzNzcuMAAtAQAAeyJ3YXNfZmlyc3RfZXZlbnQiOnRydWUsImltYWdlX2lkIjpbMjM1NDc4MTczLDE0MjY2MzQzNDAsMTcyNDQzNDY5NCwxMjY5MTUxMjM1LDIyOTk2ODc1MDksMzMzMzc3MDAzOSwzNzYxMTYwMDkzLDQwMDU0NTgzNzZdLCJxZiI6eyJiIjpbMCwwLDAsMCwwLDAsMCwwLDAsMCwwLDAsMCwwLDAsMCwwLDAsMCwwLDAsMCwwLDAsMCwwLDAsMCwwLDAsMCwwLDAsMCwwLDAsMCwwLDAsMCwwLDAsMCwwLDAsMCwwLDAsMCwwLDAsMCwwLDAsMCwwLDAsMCwwLDAsMCwwLDAsMCwwLDAsMCwwLDAsMCwwLDAsMF0sImwiOjAsInEiOjYsInIiOjd9fQAAAAAAAAAAAAAAAAAAAEABAAAAAAAABwAAADIwMzc3LjAALQEAAHsid2FzX2ZpcnN0X2V2ZW50Ijp0cnVlLCJpbWFnZV9pZCI6WzIzNTQ3ODE3MywxNDI2NjM0MzQwLDE3MjQ0MzQ2OTQsMTI2OTE1MTIzNSwyMjk5Njg3NTA5LDMzMzM3NzAwMzksMzc2MTE2MDA5Myw0MDA1NDU4Mzc2XSwicWYiOnsiYiI6WzAsMCwwLDAsMCwwLDAsMCwwLDAsMCwwLDAsMCwwLDAsMCwwLDAsMCwwLDAsMCwwLDAsMCwwLDAsMCwwLDAsMCwwLDAsMCwwLDAsMCwwLDAsMCwwLDAsMCwwLDAsMCwwLDAsMCwwLDAsMCwwLDAsMCwwLDAsMCwwLDAsMCwwLDAsMCwwLDAsMCwwLDAsMCwwLDBdLCJsIjowLCJxIjo2LCJyIjo3fX0AAAAAAAAAAAAAAAAAAAAAAAAAAAAAAAAAAAAAAAAAAAAAAA=='}}
prove_14;79;5;Mul;395;20772;20772.0;841;0.06403175000014016;{'verificationValue': 20772.0, 'proof': {'imageId': [235478173, 1426634340, 1724434694, 1269151235, 2299687509, 3333770039, 3761160093, 4005458376], 'receipt': 'AwAAAAAAAAAAAAAAmL4gACyGqXD9SCTqBr57Fe21xvS89IksDAnB7FD2cs3kOUscAAAAAAAAAAAAAAAAAAAAAAAAAAAAAAAAAAAAAAAAAAAAAAAAAAAAAAAAAAAAAAAAAQAAAAAAAAAAAAAAAAAAAAAAAAAAAAAAAAAAAAAAAAAAAAAAAAAAAAEAAAAAQAEAAAAAAAAHAAAAMjA3NzIuMAAtAQAAeyJ3YXNfZmlyc3RfZXZlbnQiOnRydWUsImltYWdlX2lkIjpbMjM1NDc4MTczLDE0MjY2MzQzNDAsMTcyNDQzNDY5NCwxMjY5MTUxMjM1LDIyOTk2ODc1MDksMzMzMzc3MDAzOSwzNzYxMTYwMDkzLDQwMDU0NTgzNzZdLCJxZiI6eyJiIjpbMCwwLDAsMCwwLDAsMCwwLDAsMCwwLDAsMCwwLDAsMCwwLDAsMCwwLDAsMCwwLDAsMCwwLDAsMCwwLDAsMCwwLDAsMCwwLDAsMCwwLDAsMCwwLDAsMCwwLDAsMCwwLDAsMCwwLDAsMCwwLDAsMCwwLDAsMCwwLDAsMCwwLDAsMCwwLDAsMCwwLDAsMCwwLDAsMF0sImwiOjAsInEiOjYsInIiOjd9fQAAAAAAAAAAAAAAAAAAAEABAAAAAAAABwAAADIwNzcyLjAALQEAAHsid2FzX2ZpcnN0X2V2ZW50Ijp0cnVlLCJpbWFnZV9pZCI6WzIzNTQ3ODE3MywxNDI2NjM0MzQwLDE3MjQ0MzQ2OTQsMTI2OTE1MTIzNSwyMjk5Njg3NTA5LDMzMzM3NzAwMzksMzc2MTE2MDA5Myw0MDA1NDU4Mzc2XSwicWYiOnsiYiI6WzAsMCwwLDAsMCwwLDAsMCwwLDAsMCwwLDAsMCwwLDAsMCwwLDAsMCwwLDAsMCwwLDAsMCwwLDAsMCwwLDAsMCwwLDAsMCwwLDAsMCwwLDAsMCwwLDAsMCwwLDAsMCwwLDAsMCwwLDAsMCwwLDAsMCwwLDAsMCwwLDAsMCwwLDAsMCwwLDAsMCwwLDAsMCwwLDBdLCJsIjowLCJxIjo2LCJyIjo3fX0AAAAAAAAAAAAAAAAAAAAAAAAAAAAAAAAAAAAAAAAAAAAAAA=='}}
prove_15;17;73;Mul;1241;22013;22013.0;841;0.06460783300099138;{'verificationValue': 22013.0, 'proof': {'imageId': [235478173, 1426634340, 1724434694, 1269151235, 2299687509, 3333770039, 3761160093, 4005458376], 'receipt': 'AwAAAAAAAAAAAAAAmL4gACyGqXD9SCTqBr57Fe21xvS89IksDAnB7FD2cs3kOUscAAAAAAAAAAAAAAAAAAAAAAAAAAAAAAAAAAAAAAAAAAAAAAAAAAAAAAAAAAAAAAAAAQAAAAAAAAAAAAAAAAAAAAAAAAAAAAAAAAAAAAAAAAAAAAAAAAAAAAEAAAAAQAEAAAAAAAAHAAAAMjIwMTMuMAAtAQAAeyJ3YXNfZmlyc3RfZXZlbnQiOnRydWUsImltYWdlX2lkIjpbMjM1NDc4MTczLDE0MjY2MzQzNDAsMTcyNDQzNDY5NCwxMjY5MTUxMjM1LDIyOTk2ODc1MDksMzMzMzc3MDAzOSwzNzYxMTYwMDkzLDQwMDU0NTgzNzZdLCJxZiI6eyJiIjpbMCwwLDAsMCwwLDAsMCwwLDAsMCwwLDAsMCwwLDAsMCwwLDAsMCwwLDAsMCwwLDAsMCwwLDAsMCwwLDAsMCwwLDAsMCwwLDAsMCwwLDAsMCwwLDAsMCwwLDAsMCwwLDAsMCwwLDAsMCwwLDAsMCwwLDAsMCwwLDAsMCwwLDAsMCwwLDAsMCwwLDAsMCwwLDAsMF0sImwiOjAsInEiOjYsInIiOjd9fQAAAAAAAAAAAAAAAAAAAEABAAAAAAAABwAAADIyMDEzLjAALQEAAHsid2FzX2ZpcnN0X2V2ZW50Ijp0cnVlLCJpbWFnZV9pZCI6WzIzNTQ3ODE3MywxNDI2NjM0MzQwLDE3MjQ0MzQ2OTQsMTI2OTE1MTIzNSwyMjk5Njg3NTA5LDMzMzM3NzAwMzksMzc2MTE2MDA5Myw0MDA1NDU4Mzc2XSwicWYiOnsiYiI6WzAsMCwwLDAsMCwwLDAsMCwwLDAsMCwwLDAsMCwwLDAsMCwwLDAsMCwwLDAsMCwwLDAsMCwwLDAsMCwwLDAsMCwwLDAsMCwwLDAsMCwwLDAsMCwwLDAsMCwwLDAsMCwwLDAsMCwwLDAsMCwwLDAsMCwwLDAsMCwwLDAsMCwwLDAsMCwwLDAsMCwwLDAsMCwwLDBdLCJsIjowLCJxIjo2LCJyIjo3fX0AAAAAAAAAAAAAAAAAAAAAAAAAAAAAAAAAAAAAAAAAAAAAAA=='}}
prove_16;19;9;Mul;171;22184;22184.0;841;0.06320587499976682;{'verificationValue': 22184.0, 'proof': {'imageId': [235478173, 1426634340, 1724434694, 1269151235, 2299687509, 3333770039, 3761160093, 4005458376], 'receipt': 'AwAAAAAAAAAAAAAAmL4gACyGqXD9SCTqBr57Fe21xvS89IksDAnB7FD2cs3kOUscAAAAAAAAAAAAAAAAAAAAAAAAAAAAAAAAAAAAAAAAAAAAAAAAAAAAAAAAAAAAAAAAAQAAAAAAAAAAAAAAAAAAAAAAAAAAAAAAAAAAAAAAAAAAAAAAAAAAAAEAAAAAQAEAAAAAAAAHAAAAMjIxODQuMAAtAQAAeyJ3YXNfZmlyc3RfZXZlbnQiOnRydWUsImltYWdlX2lkIjpbMjM1NDc4MTczLDE0MjY2MzQzNDAsMTcyNDQzNDY5NCwxMjY5MTUxMjM1LDIyOTk2ODc1MDksMzMzMzc3MDAzOSwzNzYxMTYwMDkzLDQwMDU0NTgzNzZdLCJxZiI6eyJiIjpbMCwwLDAsMCwwLDAsMCwwLDAsMCwwLDAsMCwwLDAsMCwwLDAsMCwwLDAsMCwwLDAsMCwwLDAsMCwwLDAsMCwwLDAsMCwwLDAsMCwwLDAsMCwwLDAsMCwwLDAsMCwwLDAsMCwwLDAsMCwwLDAsMCwwLDAsMCwwLDAsMCwwLDAsMCwwLDAsMCwwLDAsMCwwLDAsMF0sImwiOjAsInEiOjYsInIiOjd9fQAAAAAAAAAAAAAAAAAAAEABAAAAAAAABwAAADIyMTg0LjAALQEAAHsid2FzX2ZpcnN0X2V2ZW50Ijp0cnVlLCJpbWFnZV9pZCI6WzIzNTQ3ODE3MywxNDI2NjM0MzQwLDE3MjQ0MzQ2OTQsMTI2OTE1MTIzNSwyMjk5Njg3NTA5LDMzMzM3NzAwMzksMzc2MTE2MDA5Myw0MDA1NDU4Mzc2XSwicWYiOnsiYiI6WzAsMCwwLDAsMCwwLDAsMCwwLDAsMCwwLDAsMCwwLDAsMCwwLDAsMCwwLDAsMCwwLDAsMCwwLDAsMCwwLDAsMCwwLDAsMCwwLDAsMCwwLDAsMCwwLDAsMCwwLDAsMCwwLDAsMCwwLDAsMCwwLDAsMCwwLDAsMCwwLDAsMCwwLDAsMCwwLDAsMCwwLDAsMCwwLDBdLCJsIjowLCJxIjo2LCJyIjo3fX0AAAAAAAAAAAAAAAAAAAAAAAAAAAAAAAAAAAAAAAAAAAAAAA=='}}
prove_17;73;5;Mul;365;22549;22549.0;841;0.06299274999946647;{'verificationValue': 22549.0, 'proof': {'imageId': [235478173, 1426634340, 1724434694, 1269151235, 2299687509, 3333770039, 3761160093, 4005458376], 'receipt': 'AwAAAAAAAAAAAAAAmL4gACyGqXD9SCTqBr57Fe21xvS89IksDAnB7FD2cs3kOUscAAAAAAAAAAAAAAAAAAAAAAAAAAAAAAAAAAAAAAAAAAAAAAAAAAAAAAAAAAAAAAAAAQAAAAAAAAAAAAAAAAAAAAAAAAAAAAAAAAAAAAAAAAAAAAAAAAAAAAEAAAAAQAEAAAAAAAAHAAAAMjI1NDkuMAAtAQAAeyJ3YXNfZmlyc3RfZXZlbnQiOnRydWUsImltYWdlX2lkIjpbMjM1NDc4MTczLDE0MjY2MzQzNDAsMTcyNDQzNDY5NCwxMjY5MTUxMjM1LDIyOTk2ODc1MDksMzMzMzc3MDAzOSwzNzYxMTYwMDkzLDQwMDU0NTgzNzZdLCJxZiI6eyJiIjpbMCwwLDAsMCwwLDAsMCwwLDAsMCwwLDAsMCwwLDAsMCwwLDAsMCwwLDAsMCwwLDAsMCwwLDAsMCwwLDAsMCwwLDAsMCwwLDAsMCwwLDAsMCwwLDAsMCwwLDAsMCwwLDAsMCwwLDAsMCwwLDAsMCwwLDAsMCwwLDAsMCwwLDAsMCwwLDAsMCwwLDAsMCwwLDAsMF0sImwiOjAsInEiOjYsInIiOjd9fQAAAAAAAAAAAAAAAAAAAEABAAAAAAAABwAAADIyNTQ5LjAALQEAAHsid2FzX2ZpcnN0X2V2ZW50Ijp0cnVlLCJpbWFnZV9pZCI6WzIzNTQ3ODE3MywxNDI2NjM0MzQwLDE3MjQ0MzQ2OTQsMTI2OTE1MTIzNSwyMjk5Njg3NTA5LDMzMzM3NzAwMzksMzc2MTE2MDA5Myw0MDA1NDU4Mzc2XSwicWYiOnsiYiI6WzAsMCwwLDAsMCwwLDAsMCwwLDAsMCwwLDAsMCwwLDAsMCwwLDAsMCwwLDAsMCwwLDAsMCwwLDAsMCwwLDAsMCwwLDAsMCwwLDAsMCwwLDAsMCwwLDAsMCwwLDAsMCwwLDAsMCwwLDAsMCwwLDAsMCwwLDAsMCwwLDAsMCwwLDAsMCwwLDAsMCwwLDAsMCwwLDBdLCJsIjowLCJxIjo2LCJyIjo3fX0AAAAAAAAAAAAAAAAAAAAAAAAAAAAAAAAAAAAAAAAAAAAAAA=='}}
prove_18;93;14;Mul;1302;23851;23851.0;841;0.06362491700019746;{'verificationValue': 23851.0, 'proof': {'imageId': [235478173, 1426634340, 1724434694, 1269151235, 2299687509, 3333770039, 3761160093, 4005458376], 'receipt': 'AwAAAAAAAAAAAAAAmL4gACyGqXD9SCTqBr57Fe21xvS89IksDAnB7FD2cs3kOUscAAAAAAAAAAAAAAAAAAAAAAAAAAAAAAAAAAAAAAAAAAAAAAAAAAAAAAAAAAAAAAAAAQAAAAAAAAAAAAAAAAAAAAAAAAAAAAAAAAAAAAAAAAAAAAAAAAAAAAEAAAAAQAEAAAAAAAAHAAAAMjM4NTEuMAAtAQAAeyJ3YXNfZmlyc3RfZXZlbnQiOnRydWUsImltYWdlX2lkIjpbMjM1NDc4MTczLDE0MjY2MzQzNDAsMTcyNDQzNDY5NCwxMjY5MTUxMjM1LDIyOTk2ODc1MDksMzMzMzc3MDAzOSwzNzYxMTYwMDkzLDQwMDU0NTgzNzZdLCJxZiI6eyJiIjpbMCwwLDAsMCwwLDAsMCwwLDAsMCwwLDAsMCwwLDAsMCwwLDAsMCwwLDAsMCwwLDAsMCwwLDAsMCwwLDAsMCwwLDAsMCwwLDAsMCwwLDAsMCwwLDAsMCwwLDAsMCwwLDAsMCwwLDAsMCwwLDAsMCwwLDAsMCwwLDAsMCwwLDAsMCwwLDAsMCwwLDAsMCwwLDAsMF0sImwiOjAsInEiOjYsInIiOjd9fQAAAAAAAAAAAAAAAAAAAEABAAAAAAAABwAAADIzODUxLjAALQEAAHsid2FzX2ZpcnN0X2V2ZW50Ijp0cnVlLCJpbWFnZV9pZCI6WzIzNTQ3ODE3MywxNDI2NjM0MzQwLDE3MjQ0MzQ2OTQsMTI2OTE1MTIzNSwyMjk5Njg3NTA5LDMzMzM3NzAwMzksMzc2MTE2MDA5Myw0MDA1NDU4Mzc2XSwicWYiOnsiYiI6WzAsMCwwLDAsMCwwLDAsMCwwLDAsMCwwLDAsMCwwLDAsMCwwLDAsMCwwLDAsMCwwLDAsMCwwLDAsMCwwLDAsMCwwLDAsMCwwLDAsMCwwLDAsMCwwLDAsMCwwLDAsMCwwLDAsMCwwLDAsMCwwLDAsMCwwLDAsMCwwLDAsMCwwLDAsMCwwLDAsMCwwLDAsMCwwLDBdLCJsIjowLCJxIjo2LCJyIjo3fX0AAAAAAAAAAAAAAAAAAAAAAAAAAAAAAAAAAAAAAAAAAAAAAA=='}}
prove_19;90;100;Mul;9000;32851;32851.0;841;0.06298375000005763;{'verificationValue': 32851.0, 'proof': {'imageId': [235478173, 1426634340, 1724434694, 1269151235, 2299687509, 3333770039, 3761160093, 4005458376], 'receipt': 'AwAAAAAAAAAAAAAAmL4gACyGqXD9SCTqBr57Fe21xvS89IksDAnB7FD2cs3kOUscAAAAAAAAAAAAAAAAAAAAAAAAAAAAAAAAAAAAAAAAAAAAAAAAAAAAAAAAAAAAAAAAAQAAAAAAAAAAAAAAAAAAAAAAAAAAAAAAAAAAAAAAAAAAAAAAAAAAAAEAAAAAQAEAAAAAAAAHAAAAMzI4NTEuMAAtAQAAeyJ3YXNfZmlyc3RfZXZlbnQiOnRydWUsImltYWdlX2lkIjpbMjM1NDc4MTczLDE0MjY2MzQzNDAsMTcyNDQzNDY5NCwxMjY5MTUxMjM1LDIyOTk2ODc1MDksMzMzMzc3MDAzOSwzNzYxMTYwMDkzLDQwMDU0NTgzNzZdLCJxZiI6eyJiIjpbMCwwLDAsMCwwLDAsMCwwLDAsMCwwLDAsMCwwLDAsMCwwLDAsMCwwLDAsMCwwLDAsMCwwLDAsMCwwLDAsMCwwLDAsMCwwLDAsMCwwLDAsMCwwLDAsMCwwLDAsMCwwLDAsMCwwLDAsMCwwLDAsMCwwLDAsMCwwLDAsMCwwLDAsMCwwLDAsMCwwLDAsMCwwLDAsMF0sImwiOjAsInEiOjYsInIiOjd9fQAAAAAAAAAAAAAAAAAAAEABAAAAAAAABwAAADMyODUxLjAALQEAAHsid2FzX2ZpcnN0X2V2ZW50Ijp0cnVlLCJpbWFnZV9pZCI6WzIzNTQ3ODE3MywxNDI2NjM0MzQwLDE3MjQ0MzQ2OTQsMTI2OTE1MTIzNSwyMjk5Njg3NTA5LDMzMzM3NzAwMzksMzc2MTE2MDA5Myw0MDA1NDU4Mzc2XSwicWYiOnsiYiI6WzAsMCwwLDAsMCwwLDAsMCwwLDAsMCwwLDAsMCwwLDAsMCwwLDAsMCwwLDAsMCwwLDAsMCwwLDAsMCwwLDAsMCwwLDAsMCwwLDAsMCwwLDAsMCwwLDAsMCwwLDAsMCwwLDAsMCwwLDAsMCwwLDAsMCwwLDAsMCwwLDAsMCwwLDAsMCwwLDAsMCwwLDAsMCwwLDBdLCJsIjowLCJxIjo2LCJyIjo3fX0AAAAAAAAAAAAAAAAAAAAAAAAAAAAAAAAAAAAAAAAAAAAAAA=='}}
prove_20;70;90;Mul;6300;39151;39151.0;841;0.06394974999966507;{'verificationValue': 39151.0, 'proof': {'imageId': [235478173, 1426634340, 1724434694, 1269151235, 2299687509, 3333770039, 3761160093, 4005458376], 'receipt': 'AwAAAAAAAAAAAAAAmL4gACyGqXD9SCTqBr57Fe21xvS89IksDAnB7FD2cs3kOUscAAAAAAAAAAAAAAAAAAAAAAAAAAAAAAAAAAAAAAAAAAAAAAAAAAAAAAAAAAAAAAAAAQAAAAAAAAAAAAAAAAAAAAAAAAAAAAAAAAAAAAAAAAAAAAAAAAAAAAEAAAAAQAEAAAAAAAAHAAAAMzkxNTEuMAAtAQAAeyJ3YXNfZmlyc3RfZXZlbnQiOnRydWUsImltYWdlX2lkIjpbMjM1NDc4MTczLDE0MjY2MzQzNDAsMTcyNDQzNDY5NCwxMjY5MTUxMjM1LDIyOTk2ODc1MDksMzMzMzc3MDAzOSwzNzYxMTYwMDkzLDQwMDU0NTgzNzZdLCJxZiI6eyJiIjpbMCwwLDAsMCwwLDAsMCwwLDAsMCwwLDAsMCwwLDAsMCwwLDAsMCwwLDAsMCwwLDAsMCwwLDAsMCwwLDAsMCwwLDAsMCwwLDAsMCwwLDAsMCwwLDAsMCwwLDAsMCwwLDAsMCwwLDAsMCwwLDAsMCwwLDAsMCwwLDAsMCwwLDAsMCwwLDAsMCwwLDAsMCwwLDAsMF0sImwiOjAsInEiOjYsInIiOjd9fQAAAAAAAAAAAAAAAAAAAEABAAAAAAAABwAAADM5MTUxLjAALQEAAHsid2FzX2ZpcnN0X2V2ZW50Ijp0cnVlLCJpbWFnZV9pZCI6WzIzNTQ3ODE3MywxNDI2NjM0MzQwLDE3MjQ0MzQ2OTQsMTI2OTE1MTIzNSwyMjk5Njg3NTA5LDMzMzM3NzAwMzksMzc2MTE2MDA5Myw0MDA1NDU4Mzc2XSwicWYiOnsiYiI6WzAsMCwwLDAsMCwwLDAsMCwwLDAsMCwwLDAsMCwwLDAsMCwwLDAsMCwwLDAsMCwwLDAsMCwwLDAsMCwwLDAsMCwwLDAsMCwwLDAsMCwwLDAsMCwwLDAsMCwwLDAsMCwwLDAsMCwwLDAsMCwwLDAsMCwwLDAsMCwwLDAsMCwwLDAsMCwwLDAsMCwwLDAsMCwwLDBdLCJsIjowLCJxIjo2LCJyIjo3fX0AAAAAAAAAAAAAAAAAAAAAAAAAAAAAAAAAAAAAAAAAAAAAAA=='}}
prove_21;83;87;Mul;7221;46372;46372.0;841;0.06321141599983093;{'verificationValue': 46372.0, 'proof': {'imageId': [235478173, 1426634340, 1724434694, 1269151235, 2299687509, 3333770039, 3761160093, 4005458376], 'receipt': 'AwAAAAAAAAAAAAAAmL4gACyGqXD9SCTqBr57Fe21xvS89IksDAnB7FD2cs3kOUscAAAAAAAAAAAAAAAAAAAAAAAAAAAAAAAAAAAAAAAAAAAAAAAAAAAAAAAAAAAAAAAAAQAAAAAAAAAAAAAAAAAAAAAAAAAAAAAAAAAAAAAAAAAAAAAAAAAAAAEAAAAAQAEAAAAAAAAHAAAANDYzNzIuMAAtAQAAeyJ3YXNfZmlyc3RfZXZlbnQiOnRydWUsImltYWdlX2lkIjpbMjM1NDc4MTczLDE0MjY2MzQzNDAsMTcyNDQzNDY5NCwxMjY5MTUxMjM1LDIyOTk2ODc1MDksMzMzMzc3MDAzOSwzNzYxMTYwMDkzLDQwMDU0NTgzNzZdLCJxZiI6eyJiIjpbMCwwLDAsMCwwLDAsMCwwLDAsMCwwLDAsMCwwLDAsMCwwLDAsMCwwLDAsMCwwLDAsMCwwLDAsMCwwLDAsMCwwLDAsMCwwLDAsMCwwLDAsMCwwLDAsMCwwLDAsMCwwLDAsMCwwLDAsMCwwLDAsMCwwLDAsMCwwLDAsMCwwLDAsMCwwLDAsMCwwLDAsMCwwLDAsMF0sImwiOjAsInEiOjYsInIiOjd9fQAAAAAAAAAAAAAAAAAAAEABAAAAAAAABwAAADQ2MzcyLjAALQEAAHsid2FzX2ZpcnN0X2V2ZW50Ijp0cnVlLCJpbWFnZV9pZCI6WzIzNTQ3ODE3MywxNDI2NjM0MzQwLDE3MjQ0MzQ2OTQsMTI2OTE1MTIzNSwyMjk5Njg3NTA5LDMzMzM3NzAwMzksMzc2MTE2MDA5Myw0MDA1NDU4Mzc2XSwicWYiOnsiYiI6WzAsMCwwLDAsMCwwLDAsMCwwLDAsMCwwLDAsMCwwLDAsMCwwLDAsMCwwLDAsMCwwLDAsMCwwLDAsMCwwLDAsMCwwLDAsMCwwLDAsMCwwLDAsMCwwLDAsMCwwLDAsMCwwLDAsMCwwLDAsMCwwLDAsMCwwLDAsMCwwLDAsMCwwLDAsMCwwLDAsMCwwLDAsMCwwLDBdLCJsIjowLCJxIjo2LCJyIjo3fX0AAAAAAAAAAAAAAAAAAAAAAAAAAAAAAAAAAAAAAAAAAAAAAA=='}}
prove_22;45;42;Mul;1890;48262;48262.0;841;0.06393033299900708;{'verificationValue': 48262.0, 'proof': {'imageId': [235478173, 1426634340, 1724434694, 1269151235, 2299687509, 3333770039, 3761160093, 4005458376], 'receipt': 'AwAAAAAAAAAAAAAAmL4gACyGqXD9SCTqBr57Fe21xvS89IksDAnB7FD2cs3kOUscAAAAAAAAAAAAAAAAAAAAAAAAAAAAAAAAAAAAAAAAAAAAAAAAAAAAAAAAAAAAAAAAAQAAAAAAAAAAAAAAAAAAAAAAAAAAAAAAAAAAAAAAAAAAAAAAAAAAAAEAAAAAQAEAAAAAAAAHAAAANDgyNjIuMAAtAQAAeyJ3YXNfZmlyc3RfZXZlbnQiOnRydWUsImltYWdlX2lkIjpbMjM1NDc4MTczLDE0MjY2MzQzNDAsMTcyNDQzNDY5NCwxMjY5MTUxMjM1LDIyOTk2ODc1MDksMzMzMzc3MDAzOSwzNzYxMTYwMDkzLDQwMDU0NTgzNzZdLCJxZiI6eyJiIjpbMCwwLDAsMCwwLDAsMCwwLDAsMCwwLDAsMCwwLDAsMCwwLDAsMCwwLDAsMCwwLDAsMCwwLDAsMCwwLDAsMCwwLDAsMCwwLDAsMCwwLDAsMCwwLDAsMCwwLDAsMCwwLDAsMCwwLDAsMCwwLDAsMCwwLDAsMCwwLDAsMCwwLDAsMCwwLDAsMCwwLDAsMCwwLDAsMF0sImwiOjAsInEiOjYsInIiOjd9fQAAAAAAAAAAAAAAAAAAAEABAAAAAAAABwAAADQ4MjYyLjAALQEAAHsid2FzX2ZpcnN0X2V2ZW50Ijp0cnVlLCJpbWFnZV9pZCI6WzIzNTQ3ODE3MywxNDI2NjM0MzQwLDE3MjQ0MzQ2OTQsMTI2OTE1MTIzNSwyMjk5Njg3NTA5LDMzMzM3NzAwMzksMzc2MTE2MDA5Myw0MDA1NDU4Mzc2XSwicWYiOnsiYiI6WzAsMCwwLDAsMCwwLDAsMCwwLDAsMCwwLDAsMCwwLDAsMCwwLDAsMCwwLDAsMCwwLDAsMCwwLDAsMCwwLDAsMCwwLDAsMCwwLDAsMCwwLDAsMCwwLDAsMCwwLDAsMCwwLDAsMCwwLDAsMCwwLDAsMCwwLDAsMCwwLDAsMCwwLDAsMCwwLDAsMCwwLDAsMCwwLDBdLCJsIjowLCJxIjo2LCJyIjo3fX0AAAAAAAAAAAAAAAAAAAAAAAAAAAAAAAAAAAAAAAAAAAAAAA=='}}
prove_23;72;68;Mul;4896;53158;53158.0;841;0.06339620799917611;{'verificationValue': 53158.0, 'proof': {'imageId': [235478173, 1426634340, 1724434694, 1269151235, 2299687509, 3333770039, 3761160093, 4005458376], 'receipt': 'AwAAAAAAAAAAAAAAmL4gACyGqXD9SCTqBr57Fe21xvS89IksDAnB7FD2cs3kOUscAAAAAAAAAAAAAAAAAAAAAAAAAAAAAAAAAAAAAAAAAAAAAAAAAAAAAAAAAAAAAAAAAQAAAAAAAAAAAAAAAAAAAAAAAAAAAAAAAAAAAAAAAAAAAAAAAAAAAAEAAAAAQAEAAAAAAAAHAAAANTMxNTguMAAtAQAAeyJ3YXNfZmlyc3RfZXZlbnQiOnRydWUsImltYWdlX2lkIjpbMjM1NDc4MTczLDE0MjY2MzQzNDAsMTcyNDQzNDY5NCwxMjY5MTUxMjM1LDIyOTk2ODc1MDksMzMzMzc3MDAzOSwzNzYxMTYwMDkzLDQwMDU0NTgzNzZdLCJxZiI6eyJiIjpbMCwwLDAsMCwwLDAsMCwwLDAsMCwwLDAsMCwwLDAsMCwwLDAsMCwwLDAsMCwwLDAsMCwwLDAsMCwwLDAsMCwwLDAsMCwwLDAsMCwwLDAsMCwwLDAsMCwwLDAsMCwwLDAsMCwwLDAsMCwwLDAsMCwwLDAsMCwwLDAsMCwwLDAsMCwwLDAsMCwwLDAsMCwwLDAsMF0sImwiOjAsInEiOjYsInIiOjd9fQAAAAAAAAAAAAAAAAAAAEABAAAAAAAABwAAADUzMTU4LjAALQEAAHsid2FzX2ZpcnN0X2V2ZW50Ijp0cnVlLCJpbWFnZV9pZCI6WzIzNTQ3ODE3MywxNDI2NjM0MzQwLDE3MjQ0MzQ2OTQsMTI2OTE1MTIzNSwyMjk5Njg3NTA5LDMzMzM3NzAwMzksMzc2MTE2MDA5Myw0MDA1NDU4Mzc2XSwicWYiOnsiYiI6WzAsMCwwLDAsMCwwLDAsMCwwLDAsMCwwLDAsMCwwLDAsMCwwLDAsMCwwLDAsMCwwLDAsMCwwLDAsMCwwLDAsMCwwLDAsMCwwLDAsMCwwLDAsMCwwLDAsMCwwLDAsMCwwLDAsMCwwLDAsMCwwLDAsMCwwLDAsMCwwLDAsMCwwLDAsMCwwLDAsMCwwLDAsMCwwLDBdLCJsIjowLCJxIjo2LCJyIjo3fX0AAAAAAAAAAAAAAAAAAAAAAAAAAAAAAAAAAAAAAAAAAAAAAA=='}}
prove_24;48;75;Mul;3600;56758;56758.0;841;0.06367608400069003;{'verificationValue': 56758.0, 'proof': {'imageId': [235478173, 1426634340, 1724434694, 1269151235, 2299687509, 3333770039, 3761160093, 4005458376], 'receipt': 'AwAAAAAAAAAAAAAAmL4gACyGqXD9SCTqBr57Fe21xvS89IksDAnB7FD2cs3kOUscAAAAAAAAAAAAAAAAAAAAAAAAAAAAAAAAAAAAAAAAAAAAAAAAAAAAAAAAAAAAAAAAAQAAAAAAAAAAAAAAAAAAAAAAAAAAAAAAAAAAAAAAAAAAAAAAAAAAAAEAAAAAQAEAAAAAAAAHAAAANTY3NTguMAAtAQAAeyJ3YXNfZmlyc3RfZXZlbnQiOnRydWUsImltYWdlX2lkIjpbMjM1NDc4MTczLDE0MjY2MzQzNDAsMTcyNDQzNDY5NCwxMjY5MTUxMjM1LDIyOTk2ODc1MDksMzMzMzc3MDAzOSwzNzYxMTYwMDkzLDQwMDU0NTgzNzZdLCJxZiI6eyJiIjpbMCwwLDAsMCwwLDAsMCwwLDAsMCwwLDAsMCwwLDAsMCwwLDAsMCwwLDAsMCwwLDAsMCwwLDAsMCwwLDAsMCwwLDAsMCwwLDAsMCwwLDAsMCwwLDAsMCwwLDAsMCwwLDAsMCwwLDAsMCwwLDAsMCwwLDAsMCwwLDAsMCwwLDAsMCwwLDAsMCwwLDAsMCwwLDAsMF0sImwiOjAsInEiOjYsInIiOjd9fQAAAAAAAAAAAAAAAAAAAEABAAAAAAAABwAAADU2NzU4LjAALQEAAHsid2FzX2ZpcnN0X2V2ZW50Ijp0cnVlLCJpbWFnZV9pZCI6WzIzNTQ3ODE3MywxNDI2NjM0MzQwLDE3MjQ0MzQ2OTQsMTI2OTE1MTIzNSwyMjk5Njg3NTA5LDMzMzM3NzAwMzksMzc2MTE2MDA5Myw0MDA1NDU4Mzc2XSwicWYiOnsiYiI6WzAsMCwwLDAsMCwwLDAsMCwwLDAsMCwwLDAsMCwwLDAsMCwwLDAsMCwwLDAsMCwwLDAsMCwwLDAsMCwwLDAsMCwwLDAsMCwwLDAsMCwwLDAsMCwwLDAsMCwwLDAsMCwwLDAsMCwwLDAsMCwwLDAsMCwwLDAsMCwwLDAsMCwwLDAsMCwwLDAsMCwwLDAsMCwwLDBdLCJsIjowLCJxIjo2LCJyIjo3fX0AAAAAAAAAAAAAAAAAAAAAAAAAAAAAAAAAAAAAAAAAAAAAAA=='}}
prove_25;23;45;Mul;1035;57793;57793.0;841;0.06331529199997021;{'verificationValue': 57793.0, 'proof': {'imageId': [235478173, 1426634340, 1724434694, 1269151235, 2299687509, 3333770039, 3761160093, 4005458376], 'receipt': 'AwAAAAAAAAAAAAAAmL4gACyGqXD9SCTqBr57Fe21xvS89IksDAnB7FD2cs3kOUscAAAAAAAAAAAAAAAAAAAAAAAAAAAAAAAAAAAAAAAAAAAAAAAAAAAAAAAAAAAAAAAAAQAAAAAAAAAAAAAAAAAAAAAAAAAAAAAAAAAAAAAAAAAAAAAAAAAAAAEAAAAAQAEAAAAAAAAHAAAANTc3OTMuMAAtAQAAeyJ3YXNfZmlyc3RfZXZlbnQiOnRydWUsImltYWdlX2lkIjpbMjM1NDc4MTczLDE0MjY2MzQzNDAsMTcyNDQzNDY5NCwxMjY5MTUxMjM1LDIyOTk2ODc1MDksMzMzMzc3MDAzOSwzNzYxMTYwMDkzLDQwMDU0NTgzNzZdLCJxZiI6eyJiIjpbMCwwLDAsMCwwLDAsMCwwLDAsMCwwLDAsMCwwLDAsMCwwLDAsMCwwLDAsMCwwLDAsMCwwLDAsMCwwLDAsMCwwLDAsMCwwLDAsMCwwLDAsMCwwLDAsMCwwLDAsMCwwLDAsMCwwLDAsMCwwLDAsMCwwLDAsMCwwLDAsMCwwLDAsMCwwLDAsMCwwLDAsMCwwLDAsMF0sImwiOjAsInEiOjYsInIiOjd9fQAAAAAAAAAAAAAAAAAAAEABAAAAAAAABwAAADU3NzkzLjAALQEAAHsid2FzX2ZpcnN0X2V2ZW50Ijp0cnVlLCJpbWFnZV9pZCI6WzIzNTQ3ODE3MywxNDI2NjM0MzQwLDE3MjQ0MzQ2OTQsMTI2OTE1MTIzNSwyMjk5Njg3NTA5LDMzMzM3NzAwMzksMzc2MTE2MDA5Myw0MDA1NDU4Mzc2XSwicWYiOnsiYiI6WzAsMCwwLDAsMCwwLDAsMCwwLDAsMCwwLDAsMCwwLDAsMCwwLDAsMCwwLDAsMCwwLDAsMCwwLDAsMCwwLDAsMCwwLDAsMCwwLDAsMCwwLDAsMCwwLDAsMCwwLDAsMCwwLDAsMCwwLDAsMCwwLDAsMCwwLDAsMCwwLDAsMCwwLDAsMCwwLDAsMCwwLDAsMCwwLDBdLCJsIjowLCJxIjo2LCJyIjo3fX0AAAAAAAAAAAAAAAAAAAAAAAAAAAAAAAAAAAAAAAAAAAAAAA=='}}
prove_26;37;31;Mul;1147;58940;58940.0;841;0.06430454200017266;{'verificationValue': 58940.0, 'proof': {'imageId': [235478173, 1426634340, 1724434694, 1269151235, 2299687509, 3333770039, 3761160093, 4005458376], 'receipt': 'AwAAAAAAAAAAAAAAmL4gACyGqXD9SCTqBr57Fe21xvS89IksDAnB7FD2cs3kOUscAAAAAAAAAAAAAAAAAAAAAAAAAAAAAAAAAAAAAAAAAAAAAAAAAAAAAAAAAAAAAAAAAQAAAAAAAAAAAAAAAAAAAAAAAAAAAAAAAAAAAAAAAAAAAAAAAAAAAAEAAAAAQAEAAAAAAAAHAAAANTg5NDAuMAAtAQAAeyJ3YXNfZmlyc3RfZXZlbnQiOnRydWUsImltYWdlX2lkIjpbMjM1NDc4MTczLDE0MjY2MzQzNDAsMTcyNDQzNDY5NCwxMjY5MTUxMjM1LDIyOTk2ODc1MDksMzMzMzc3MDAzOSwzNzYxMTYwMDkzLDQwMDU0NTgzNzZdLCJxZiI6eyJiIjpbMCwwLDAsMCwwLDAsMCwwLDAsMCwwLDAsMCwwLDAsMCwwLDAsMCwwLDAsMCwwLDAsMCwwLDAsMCwwLDAsMCwwLDAsMCwwLDAsMCwwLDAsMCwwLDAsMCwwLDAsMCwwLDAsMCwwLDAsMCwwLDAsMCwwLDAsMCwwLDAsMCwwLDAsMCwwLDAsMCwwLDAsMCwwLDAsMF0sImwiOjAsInEiOjYsInIiOjd9fQAAAAAAAAAAAAAAAAAAAEABAAAAAAAABwAAADU4OTQwLjAALQEAAHsid2FzX2ZpcnN0X2V2ZW50Ijp0cnVlLCJpbWFnZV9pZCI6WzIzNTQ3ODE3MywxNDI2NjM0MzQwLDE3MjQ0MzQ2OTQsMTI2OTE1MTIzNSwyMjk5Njg3NTA5LDMzMzM3NzAwMzksMzc2MTE2MDA5Myw0MDA1NDU4Mzc2XSwicWYiOnsiYiI6WzAsMCwwLDAsMCwwLDAsMCwwLDAsMCwwLDAsMCwwLDAsMCwwLDAsMCwwLDAsMCwwLDAsMCwwLDAsMCwwLDAsMCwwLDAsMCwwLDAsMCwwLDAsMCwwLDAsMCwwLDAsMCwwLDAsMCwwLDAsMCwwLDAsMCwwLDAsMCwwLDAsMCwwLDAsMCwwLDAsMCwwLDAsMCwwLDBdLCJsIjowLCJxIjo2LCJyIjo3fX0AAAAAAAAAAAAAAAAAAAAAAAAAAAAAAAAAAAAAAAAAAAAAAA=='}}
prove_27;16;16;Mul;256;59196;59196.0;841;0.06396733399924415;{'verificationValue': 59196.0, 'proof': {'imageId': [235478173, 1426634340, 1724434694, 1269151235, 2299687509, 3333770039, 3761160093, 4005458376], 'receipt': 'AwAAAAAAAAAAAAAAmL4gACyGqXD9SCTqBr57Fe21xvS89IksDAnB7FD2cs3kOUscAAAAAAAAAAAAAAAAAAAAAAAAAAAAAAAAAAAAAAAAAAAAAAAAAAAAAAAAAAAAAAAAAQAAAAAAAAAAAAAAAAAAAAAAAAAAAAAAAAAAAAAAAAAAAAAAAAAAAAEAAAAAQAEAAAAAAAAHAAAANTkxOTYuMAAtAQAAeyJ3YXNfZmlyc3RfZXZlbnQiOnRydWUsImltYWdlX2lkIjpbMjM1NDc4MTczLDE0MjY2MzQzNDAsMTcyNDQzNDY5NCwxMjY5MTUxMjM1LDIyOTk2ODc1MDksMzMzMzc3MDAzOSwzNzYxMTYwMDkzLDQwMDU0NTgzNzZdLCJxZiI6eyJiIjpbMCwwLDAsMCwwLDAsMCwwLDAsMCwwLDAsMCwwLDAsMCwwLDAsMCwwLDAsMCwwLDAsMCwwLDAsMCwwLDAsMCwwLDAsMCwwLDAsMCwwLDAsMCwwLDAsMCwwLDAsMCwwLDAsMCwwLDAsMCwwLDAsMCwwLDAsMCwwLDAsMCwwLDAsMCwwLDAsMCwwLDAsMCwwLDAsMF0sImwiOjAsInEiOjYsInIiOjd9fQAAAAAAAAAAAAAAAAAAAEABAAAAAAAABwAAADU5MTk2LjAALQEAAHsid2FzX2ZpcnN0X2V2ZW50Ijp0cnVlLCJpbWFnZV9pZCI6WzIzNTQ3ODE3MywxNDI2NjM0MzQwLDE3MjQ0MzQ2OTQsMTI2OTE1MTIzNSwyMjk5Njg3NTA5LDMzMzM3NzAwMzksMzc2MTE2MDA5Myw0MDA1NDU4Mzc2XSwicWYiOnsiYiI6WzAsMCwwLDAsMCwwLDAsMCwwLDAsMCwwLDAsMCwwLDAsMCwwLDAsMCwwLDAsMCwwLDAsMCwwLDAsMCwwLDAsMCwwLDAsMCwwLDAsMCwwLDAsMCwwLDAsMCwwLDAsMCwwLDAsMCwwLDAsMCwwLDAsMCwwLDAsMCwwLDAsMCwwLDAsMCwwLDAsMCwwLDAsMCwwLDBdLCJsIjowLCJxIjo2LCJyIjo3fX0AAAAAAAAAAAAAAAAAAAAAAAAAAAAAAAAAAAAAAAAAAAAAAA=='}}
prove_28;39;37;Mul;1443;60639;60639.0;841;0.0635472080011823;{'verificationValue': 60639.0, 'proof': {'imageId': [235478173, 1426634340, 1724434694, 1269151235, 2299687509, 3333770039, 3761160093, 4005458376], 'receipt': 'AwAAAAAAAAAAAAAAmL4gACyGqXD9SCTqBr57Fe21xvS89IksDAnB7FD2cs3kOUscAAAAAAAAAAAAAAAAAAAAAAAAAAAAAAAAAAAAAAAAAAAAAAAAAAAAAAAAAAAAAAAAAQAAAAAAAAAAAAAAAAAAAAAAAAAAAAAAAAAAAAAAAAAAAAAAAAAAAAEAAAAAQAEAAAAAAAAHAAAANjA2MzkuMAAtAQAAeyJ3YXNfZmlyc3RfZXZlbnQiOnRydWUsImltYWdlX2lkIjpbMjM1NDc4MTczLDE0MjY2MzQzNDAsMTcyNDQzNDY5NCwxMjY5MTUxMjM1LDIyOTk2ODc1MDksMzMzMzc3MDAzOSwzNzYxMTYwMDkzLDQwMDU0NTgzNzZdLCJxZiI6eyJiIjpbMCwwLDAsMCwwLDAsMCwwLDAsMCwwLDAsMCwwLDAsMCwwLDAsMCwwLDAsMCwwLDAsMCwwLDAsMCwwLDAsMCwwLDAsMCwwLDAsMCwwLDAsMCwwLDAsMCwwLDAsMCwwLDAsMCwwLDAsMCwwLDAsMCwwLDAsMCwwLDAsMCwwLDAsMCwwLDAsMCwwLDAsMCwwLDAsMF0sImwiOjAsInEiOjYsInIiOjd9fQAAAAAAAAAAAAAAAAAAAEABAAAAAAAABwAAADYwNjM5LjAALQEAAHsid2FzX2ZpcnN0X2V2ZW50Ijp0cnVlLCJpbWFnZV9pZCI6WzIzNTQ3ODE3MywxNDI2NjM0MzQwLDE3MjQ0MzQ2OTQsMTI2OTE1MTIzNSwyMjk5Njg3NTA5LDMzMzM3NzAwMzksMzc2MTE2MDA5Myw0MDA1NDU4Mzc2XSwicWYiOnsiYiI6WzAsMCwwLDAsMCwwLDAsMCwwLDAsMCwwLDAsMCwwLDAsMCwwLDAsMCwwLDAsMCwwLDAsMCwwLDAsMCwwLDAsMCwwLDAsMCwwLDAsMCwwLDAsMCwwLDAsMCwwLDAsMCwwLDAsMCwwLDAsMCwwLDAsMCwwLDAsMCwwLDAsMCwwLDAsMCwwLDAsMCwwLDAsMCwwLDBdLCJsIjowLCJxIjo2LCJyIjo3fX0AAAAAAAAAAAAAAAAAAAAAAAAAAAAAAAAAAAAAAAAAAAAAAA=='}}
prove_29;84;18;Mul;1512;62151;62151.0;841;0.06555637500059674;{'verificationValue': 62151.0, 'proof': {'imageId': [235478173, 1426634340, 1724434694, 1269151235, 2299687509, 3333770039, 3761160093, 4005458376], 'receipt': 'AwAAAAAAAAAAAAAAmL4gACyGqXD9SCTqBr57Fe21xvS89IksDAnB7FD2cs3kOUscAAAAAAAAAAAAAAAAAAAAAAAAAAAAAAAAAAAAAAAAAAAAAAAAAAAAAAAAAAAAAAAAAQAAAAAAAAAAAAAAAAAAAAAAAAAAAAAAAAAAAAAAAAAAAAAAAAAAAAEAAAAAQAEAAAAAAAAHAAAANjIxNTEuMAAtAQAAeyJ3YXNfZmlyc3RfZXZlbnQiOnRydWUsImltYWdlX2lkIjpbMjM1NDc4MTczLDE0MjY2MzQzNDAsMTcyNDQzNDY5NCwxMjY5MTUxMjM1LDIyOTk2ODc1MDksMzMzMzc3MDAzOSwzNzYxMTYwMDkzLDQwMDU0NTgzNzZdLCJxZiI6eyJiIjpbMCwwLDAsMCwwLDAsMCwwLDAsMCwwLDAsMCwwLDAsMCwwLDAsMCwwLDAsMCwwLDAsMCwwLDAsMCwwLDAsMCwwLDAsMCwwLDAsMCwwLDAsMCwwLDAsMCwwLDAsMCwwLDAsMCwwLDAsMCwwLDAsMCwwLDAsMCwwLDAsMCwwLDAsMCwwLDAsMCwwLDAsMCwwLDAsMF0sImwiOjAsInEiOjYsInIiOjd9fQAAAAAAAAAAAAAAAAAAAEABAAAAAAAABwAAADYyMTUxLjAALQEAAHsid2FzX2ZpcnN0X2V2ZW50Ijp0cnVlLCJpbWFnZV9pZCI6WzIzNTQ3ODE3MywxNDI2NjM0MzQwLDE3MjQ0MzQ2OTQsMTI2OTE1MTIzNSwyMjk5Njg3NTA5LDMzMzM3NzAwMzksMzc2MTE2MDA5Myw0MDA1NDU4Mzc2XSwicWYiOnsiYiI6WzAsMCwwLDAsMCwwLDAsMCwwLDAsMCwwLDAsMCwwLDAsMCwwLDAsMCwwLDAsMCwwLDAsMCwwLDAsMCwwLDAsMCwwLDAsMCwwLDAsMCwwLDAsMCwwLDAsMCwwLDAsMCwwLDAsMCwwLDAsMCwwLDAsMCwwLDAsMCwwLDAsMCwwLDAsMCwwLDAsMCwwLDAsMCwwLDBdLCJsIjowLCJxIjo2LCJyIjo3fX0AAAAAAAAAAAAAAAAAAAAAAAAAAAAAAAAAAAAAAAAAAAAAAA=='}}
prove_30;14;59;Mul;826;62977;62977.0;841;0.06451574999846343;{'verificationValue': 62977.0, 'proof': {'imageId': [235478173, 1426634340, 1724434694, 1269151235, 2299687509, 3333770039, 3761160093, 4005458376], 'receipt': 'AwAAAAAAAAAAAAAAmL4gACyGqXD9SCTqBr57Fe21xvS89IksDAnB7FD2cs3kOUscAAAAAAAAAAAAAAAAAAAAAAAAAAAAAAAAAAAAAAAAAAAAAAAAAAAAAAAAAAAAAAAAAQAAAAAAAAAAAAAAAAAAAAAAAAAAAAAAAAAAAAAAAAAAAAAAAAAAAAEAAAAAQAEAAAAAAAAHAAAANjI5NzcuMAAtAQAAeyJ3YXNfZmlyc3RfZXZlbnQiOnRydWUsImltYWdlX2lkIjpbMjM1NDc4MTczLDE0MjY2MzQzNDAsMTcyNDQzNDY5NCwxMjY5MTUxMjM1LDIyOTk2ODc1MDksMzMzMzc3MDAzOSwzNzYxMTYwMDkzLDQwMDU0NTgzNzZdLCJxZiI6eyJiIjpbMCwwLDAsMCwwLDAsMCwwLDAsMCwwLDAsMCwwLDAsMCwwLDAsMCwwLDAsMCwwLDAsMCwwLDAsMCwwLDAsMCwwLDAsMCwwLDAsMCwwLDAsMCwwLDAsMCwwLDAsMCwwLDAsMCwwLDAsMCwwLDAsMCwwLDAsMCwwLDAsMCwwLDAsMCwwLDAsMCwwLDAsMCwwLDAsMF0sImwiOjAsInEiOjYsInIiOjd9fQAAAAAAAAAAAAAAAAAAAEABAAAAAAAABwAAADYyOTc3LjAALQEAAHsid2FzX2ZpcnN0X2V2ZW50Ijp0cnVlLCJpbWFnZV9pZCI6WzIzNTQ3ODE3MywxNDI2NjM0MzQwLDE3MjQ0MzQ2OTQsMTI2OTE1MTIzNSwyMjk5Njg3NTA5LDMzMzM3NzAwMzksMzc2MTE2MDA5Myw0MDA1NDU4Mzc2XSwicWYiOnsiYiI6WzAsMCwwLDAsMCwwLDAsMCwwLDAsMCwwLDAsMCwwLDAsMCwwLDAsMCwwLDAsMCwwLDAsMCwwLDAsMCwwLDAsMCwwLDAsMCwwLDAsMCwwLDAsMCwwLDAsMCwwLDAsMCwwLDAsMCwwLDAsMCwwLDAsMCwwLDAsMCwwLDAsMCwwLDAsMCwwLDAsMCwwLDAsMCwwLDBdLCJsIjowLCJxIjo2LCJyIjo3fX0AAAAAAAAAAAAAAAAAAAAAAAAAAAAAAAAAAAAAAAAAAAAAAA=='}}
prove_31;26;59;Mul;1534;64511;64511.0;841;0.06484445800015237;{'verificationValue': 64511.0, 'proof': {'imageId': [235478173, 1426634340, 1724434694, 1269151235, 2299687509, 3333770039, 3761160093, 4005458376], 'receipt': 'AwAAAAAAAAAAAAAAmL4gACyGqXD9SCTqBr57Fe21xvS89IksDAnB7FD2cs3kOUscAAAAAAAAAAAAAAAAAAAAAAAAAAAAAAAAAAAAAAAAAAAAAAAAAAAAAAAAAAAAAAAAAQAAAAAAAAAAAAAAAAAAAAAAAAAAAAAAAAAAAAAAAAAAAAAAAAAAAAEAAAAAQAEAAAAAAAAHAAAANjQ1MTEuMAAtAQAAeyJ3YXNfZmlyc3RfZXZlbnQiOnRydWUsImltYWdlX2lkIjpbMjM1NDc4MTczLDE0MjY2MzQzNDAsMTcyNDQzNDY5NCwxMjY5MTUxMjM1LDIyOTk2ODc1MDksMzMzMzc3MDAzOSwzNzYxMTYwMDkzLDQwMDU0NTgzNzZdLCJxZiI6eyJiIjpbMCwwLDAsMCwwLDAsMCwwLDAsMCwwLDAsMCwwLDAsMCwwLDAsMCwwLDAsMCwwLDAsMCwwLDAsMCwwLDAsMCwwLDAsMCwwLDAsMCwwLDAsMCwwLDAsMCwwLDAsMCwwLDAsMCwwLDAsMCwwLDAsMCwwLDAsMCwwLDAsMCwwLDAsMCwwLDAsMCwwLDAsMCwwLDAsMF0sImwiOjAsInEiOjYsInIiOjd9fQAAAAAAAAAAAAAAAAAAAEABAAAAAAAABwAAADY0NTExLjAALQEAAHsid2FzX2ZpcnN0X2V2ZW50Ijp0cnVlLCJpbWFnZV9pZCI6WzIzNTQ3ODE3MywxNDI2NjM0MzQwLDE3MjQ0MzQ2OTQsMTI2OTE1MTIzNSwyMjk5Njg3NTA5LDMzMzM3NzAwMzksMzc2MTE2MDA5Myw0MDA1NDU4Mzc2XSwicWYiOnsiYiI6WzAsMCwwLDAsMCwwLDAsMCwwLDAsMCwwLDAsMCwwLDAsMCwwLDAsMCwwLDAsMCwwLDAsMCwwLDAsMCwwLDAsMCwwLDAsMCwwLDAsMCwwLDAsMCwwLDAsMCwwLDAsMCwwLDAsMCwwLDAsMCwwLDAsMCwwLDAsMCwwLDAsMCwwLDAsMCwwLDAsMCwwLDAsMCwwLDBdLCJsIjowLCJxIjo2LCJyIjo3fX0AAAAAAAAAAAAAAAAAAAAAAAAAAAAAAAAAAAAAAAAAAAAAAA=='}}
prove_32;40;54;Mul;2160;66671;66671.0;841;0.06425333299921476;{'verificationValue': 66671.0, 'proof': {'imageId': [235478173, 1426634340, 1724434694, 1269151235, 2299687509, 3333770039, 3761160093, 4005458376], 'receipt': 'AwAAAAAAAAAAAAAAmL4gACyGqXD9SCTqBr57Fe21xvS89IksDAnB7FD2cs3kOUscAAAAAAAAAAAAAAAAAAAAAAAAAAAAAAAAAAAAAAAAAAAAAAAAAAAAAAAAAAAAAAAAAQAAAAAAAAAAAAAAAAAAAAAAAAAAAAAAAAAAAAAAAAAAAAAAAAAAAAEAAAAAQAEAAAAAAAAHAAAANjY2NzEuMAAtAQAAeyJ3YXNfZmlyc3RfZXZlbnQiOnRydWUsImltYWdlX2lkIjpbMjM1NDc4MTczLDE0MjY2MzQzNDAsMTcyNDQzNDY5NCwxMjY5MTUxMjM1LDIyOTk2ODc1MDksMzMzMzc3MDAzOSwzNzYxMTYwMDkzLDQwMDU0NTgzNzZdLCJxZiI6eyJiIjpbMCwwLDAsMCwwLDAsMCwwLDAsMCwwLDAsMCwwLDAsMCwwLDAsMCwwLDAsMCwwLDAsMCwwLDAsMCwwLDAsMCwwLDAsMCwwLDAsMCwwLDAsMCwwLDAsMCwwLDAsMCwwLDAsMCwwLDAsMCwwLDAsMCwwLDAsMCwwLDAsMCwwLDAsMCwwLDAsMCwwLDAsMCwwLDAsMF0sImwiOjAsInEiOjYsInIiOjd9fQAAAAAAAAAAAAAAAAAAAEABAAAAAAAABwAAADY2NjcxLjAALQEAAHsid2FzX2ZpcnN0X2V2ZW50Ijp0cnVlLCJpbWFnZV9pZCI6WzIzNTQ3ODE3MywxNDI2NjM0MzQwLDE3MjQ0MzQ2OTQsMTI2OTE1MTIzNSwyMjk5Njg3NTA5LDMzMzM3NzAwMzksMzc2MTE2MDA5Myw0MDA1NDU4Mzc2XSwicWYiOnsiYiI6WzAsMCwwLDAsMCwwLDAsMCwwLDAsMCwwLDAsMCwwLDAsMCwwLDAsMCwwLDAsMCwwLDAsMCwwLDAsMCwwLDAsMCwwLDAsMCwwLDAsMCwwLDAsMCwwLDAsMCwwLDAsMCwwLDAsMCwwLDAsMCwwLDAsMCwwLDAsMCwwLDAsMCwwLDAsMCwwLDAsMCwwLDAsMCwwLDBdLCJsIjowLCJxIjo2LCJyIjo3fX0AAAAAAAAAAAAAAAAAAAAAAAAAAAAAAAAAAAAAAAAAAAAAAA=='}}
prove_33;27;83;Mul;2241;68912;68912.0;841;0.06477829199866392;{'verificationValue': 68912.0, 'proof': {'imageId': [235478173, 1426634340, 1724434694, 1269151235, 2299687509, 3333770039, 3761160093, 4005458376], 'receipt': 'AwAAAAAAAAAAAAAAmL4gACyGqXD9SCTqBr57Fe21xvS89IksDAnB7FD2cs3kOUscAAAAAAAAAAAAAAAAAAAAAAAAAAAAAAAAAAAAAAAAAAAAAAAAAAAAAAAAAAAAAAAAAQAAAAAAAAAAAAAAAAAAAAAAAAAAAAAAAAAAAAAAAAAAAAAAAAAAAAEAAAAAQAEAAAAAAAAHAAAANjg5MTIuMAAtAQAAeyJ3YXNfZmlyc3RfZXZlbnQiOnRydWUsImltYWdlX2lkIjpbMjM1NDc4MTczLDE0MjY2MzQzNDAsMTcyNDQzNDY5NCwxMjY5MTUxMjM1LDIyOTk2ODc1MDksMzMzMzc3MDAzOSwzNzYxMTYwMDkzLDQwMDU0NTgzNzZdLCJxZiI6eyJiIjpbMCwwLDAsMCwwLDAsMCwwLDAsMCwwLDAsMCwwLDAsMCwwLDAsMCwwLDAsMCwwLDAsMCwwLDAsMCwwLDAsMCwwLDAsMCwwLDAsMCwwLDAsMCwwLDAsMCwwLDAsMCwwLDAsMCwwLDAsMCwwLDAsMCwwLDAsMCwwLDAsMCwwLDAsMCwwLDAsMCwwLDAsMCwwLDAsMF0sImwiOjAsInEiOjYsInIiOjd9fQAAAAAAAAAAAAAAAAAAAEABAAAAAAAABwAAADY4OTEyLjAALQEAAHsid2FzX2ZpcnN0X2V2ZW50Ijp0cnVlLCJpbWFnZV9pZCI6WzIzNTQ3ODE3MywxNDI2NjM0MzQwLDE3MjQ0MzQ2OTQsMTI2OTE1MTIzNSwyMjk5Njg3NTA5LDMzMzM3NzAwMzksMzc2MTE2MDA5Myw0MDA1NDU4Mzc2XSwicWYiOnsiYiI6WzAsMCwwLDAsMCwwLDAsMCwwLDAsMCwwLDAsMCwwLDAsMCwwLDAsMCwwLDAsMCwwLDAsMCwwLDAsMCwwLDAsMCwwLDAsMCwwLDAsMCwwLDAsMCwwLDAsMCwwLDAsMCwwLDAsMCwwLDAsMCwwLDAsMCwwLDAsMCwwLDAsMCwwLDAsMCwwLDAsMCwwLDAsMCwwLDBdLCJsIjowLCJxIjo2LCJyIjo3fX0AAAAAAAAAAAAAAAAAAAAAAAAAAAAAAAAAAAAAAAAAAAAAAA=='}}
prove_34;55;20;Mul;1100;70012;70012.0;841;0.0645299170009821;{'verificationValue': 70012.0, 'proof': {'imageId': [235478173, 1426634340, 1724434694, 1269151235, 2299687509, 3333770039, 3761160093, 4005458376], 'receipt': 'AwAAAAAAAAAAAAAAmL4gACyGqXD9SCTqBr57Fe21xvS89IksDAnB7FD2cs3kOUscAAAAAAAAAAAAAAAAAAAAAAAAAAAAAAAAAAAAAAAAAAAAAAAAAAAAAAAAAAAAAAAAAQAAAAAAAAAAAAAAAAAAAAAAAAAAAAAAAAAAAAAAAAAAAAAAAAAAAAEAAAAAQAEAAAAAAAAHAAAANzAwMTIuMAAtAQAAeyJ3YXNfZmlyc3RfZXZlbnQiOnRydWUsImltYWdlX2lkIjpbMjM1NDc4MTczLDE0MjY2MzQzNDAsMTcyNDQzNDY5NCwxMjY5MTUxMjM1LDIyOTk2ODc1MDksMzMzMzc3MDAzOSwzNzYxMTYwMDkzLDQwMDU0NTgzNzZdLCJxZiI6eyJiIjpbMCwwLDAsMCwwLDAsMCwwLDAsMCwwLDAsMCwwLDAsMCwwLDAsMCwwLDAsMCwwLDAsMCwwLDAsMCwwLDAsMCwwLDAsMCwwLDAsMCwwLDAsMCwwLDAsMCwwLDAsMCwwLDAsMCwwLDAsMCwwLDAsMCwwLDAsMCwwLDAsMCwwLDAsMCwwLDAsMCwwLDAsMCwwLDAsMF0sImwiOjAsInEiOjYsInIiOjd9fQAAAAAAAAAAAAAAAAAAAEABAAAAAAAABwAAADcwMDEyLjAALQEAAHsid2FzX2ZpcnN0X2V2ZW50Ijp0cnVlLCJpbWFnZV9pZCI6WzIzNTQ3ODE3MywxNDI2NjM0MzQwLDE3MjQ0MzQ2OTQsMTI2OTE1MTIzNSwyMjk5Njg3NTA5LDMzMzM3NzAwMzksMzc2MTE2MDA5Myw0MDA1NDU4Mzc2XSwicWYiOnsiYiI6WzAsMCwwLDAsMCwwLDAsMCwwLDAsMCwwLDAsMCwwLDAsMCwwLDAsMCwwLDAsMCwwLDAsMCwwLDAsMCwwLDAsMCwwLDAsMCwwLDAsMCwwLDAsMCwwLDAsMCwwLDAsMCwwLDAsMCwwLDAsMCwwLDAsMCwwLDAsMCwwLDAsMCwwLDAsMCwwLDAsMCwwLDAsMCwwLDBdLCJsIjowLCJxIjo2LCJyIjo3fX0AAAAAAAAAAAAAAAAAAAAAAAAAAAAAAAAAAAAAAAAAAAAAAA=='}}
prove_35;26;98;Mul;2548;72560;72560.0;841;0.06643774999974994;{'verificationValue': 72560.0, 'proof': {'imageId': [235478173, 1426634340, 1724434694, 1269151235, 2299687509, 3333770039, 3761160093, 4005458376], 'receipt': 'AwAAAAAAAAAAAAAAmL4gACyGqXD9SCTqBr57Fe21xvS89IksDAnB7FD2cs3kOUscAAAAAAAAAAAAAAAAAAAAAAAAAAAAAAAAAAAAAAAAAAAAAAAAAAAAAAAAAAAAAAAAAQAAAAAAAAAAAAAAAAAAAAAAAAAAAAAAAAAAAAAAAAAAAAAAAAAAAAEAAAAAQAEAAAAAAAAHAAAANzI1NjAuMAAtAQAAeyJ3YXNfZmlyc3RfZXZlbnQiOnRydWUsImltYWdlX2lkIjpbMjM1NDc4MTczLDE0MjY2MzQzNDAsMTcyNDQzNDY5NCwxMjY5MTUxMjM1LDIyOTk2ODc1MDksMzMzMzc3MDAzOSwzNzYxMTYwMDkzLDQwMDU0NTgzNzZdLCJxZiI6eyJiIjpbMCwwLDAsMCwwLDAsMCwwLDAsMCwwLDAsMCwwLDAsMCwwLDAsMCwwLDAsMCwwLDAsMCwwLDAsMCwwLDAsMCwwLDAsMCwwLDAsMCwwLDAsMCwwLDAsMCwwLDAsMCwwLDAsMCwwLDAsMCwwLDAsMCwwLDAsMCwwLDAsMCwwLDAsMCwwLDAsMCwwLDAsMCwwLDAsMF0sImwiOjAsInEiOjYsInIiOjd9fQAAAAAAAAAAAAAAAAAAAEABAAAAAAAABwAAADcyNTYwLjAALQEAAHsid2FzX2ZpcnN0X2V2ZW50Ijp0cnVlLCJpbWFnZV9pZCI6WzIzNTQ3ODE3MywxNDI2NjM0MzQwLDE3MjQ0MzQ2OTQsMTI2OTE1MTIzNSwyMjk5Njg3NTA5LDMzMzM3NzAwMzksMzc2MTE2MDA5Myw0MDA1NDU4Mzc2XSwicWYiOnsiYiI6WzAsMCwwLDAsMCwwLDAsMCwwLDAsMCwwLDAsMCwwLDAsMCwwLDAsMCwwLDAsMCwwLDAsMCwwLDAsMCwwLDAsMCwwLDAsMCwwLDAsMCwwLDAsMCwwLDAsMCwwLDAsMCwwLDAsMCwwLDAsMCwwLDAsMCwwLDAsMCwwLDAsMCwwLDAsMCwwLDAsMCwwLDAsMCwwLDBdLCJsIjowLCJxIjo2LCJyIjo3fX0AAAAAAAAAAAAAAAAAAAAAAAAAAAAAAAAAAAAAAAAAAAAAAA=='}}
prove_36;32;60;Mul;1920;74480;74480.0;841;0.0650002910006151;{'verificationValue': 74480.0, 'proof': {'imageId': [235478173, 1426634340, 1724434694, 1269151235, 2299687509, 3333770039, 3761160093, 4005458376], 'receipt': 'AwAAAAAAAAAAAAAAmL4gACyGqXD9SCTqBr57Fe21xvS89IksDAnB7FD2cs3kOUscAAAAAAAAAAAAAAAAAAAAAAAAAAAAAAAAAAAAAAAAAAAAAAAAAAAAAAAAAAAAAAAAAQAAAAAAAAAAAAAAAAAAAAAAAAAAAAAAAAAAAAAAAAAAAAAAAAAAAAEAAAAAQAEAAAAAAAAHAAAANzQ0ODAuMAAtAQAAeyJ3YXNfZmlyc3RfZXZlbnQiOnRydWUsImltYWdlX2lkIjpbMjM1NDc4MTczLDE0MjY2MzQzNDAsMTcyNDQzNDY5NCwxMjY5MTUxMjM1LDIyOTk2ODc1MDksMzMzMzc3MDAzOSwzNzYxMTYwMDkzLDQwMDU0NTgzNzZdLCJxZiI6eyJiIjpbMCwwLDAsMCwwLDAsMCwwLDAsMCwwLDAsMCwwLDAsMCwwLDAsMCwwLDAsMCwwLDAsMCwwLDAsMCwwLDAsMCwwLDAsMCwwLDAsMCwwLDAsMCwwLDAsMCwwLDAsMCwwLDAsMCwwLDAsMCwwLDAsMCwwLDAsMCwwLDAsMCwwLDAsMCwwLDAsMCwwLDAsMCwwLDAsMF0sImwiOjAsInEiOjYsInIiOjd9fQAAAAAAAAAAAAAAAAAAAEABAAAAAAAABwAAADc0NDgwLjAALQEAAHsid2FzX2ZpcnN0X2V2ZW50Ijp0cnVlLCJpbWFnZV9pZCI6WzIzNTQ3ODE3MywxNDI2NjM0MzQwLDE3MjQ0MzQ2OTQsMTI2OTE1MTIzNSwyMjk5Njg3NTA5LDMzMzM3NzAwMzksMzc2MTE2MDA5Myw0MDA1NDU4Mzc2XSwicWYiOnsiYiI6WzAsMCwwLDAsMCwwLDAsMCwwLDAsMCwwLDAsMCwwLDAsMCwwLDAsMCwwLDAsMCwwLDAsMCwwLDAsMCwwLDAsMCwwLDAsMCwwLDAsMCwwLDAsMCwwLDAsMCwwLDAsMCwwLDAsMCwwLDAsMCwwLDAsMCwwLDAsMCwwLDAsMCwwLDAsMCwwLDAsMCwwLDAsMCwwLDBdLCJsIjowLCJxIjo2LCJyIjo3fX0AAAAAAAAAAAAAAAAAAAAAAAAAAAAAAAAAAAAAAAAAAAAAAA=='}}
prove_37;75;92;Mul;6900;81380;81380.0;841;0.08103275000030408;{'verificationValue': 81380.0, 'proof': {'imageId': [235478173, 1426634340, 1724434694, 1269151235, 2299687509, 3333770039, 3761160093, 4005458376], 'receipt': 'AwAAAAAAAAAAAAAAmL4gACyGqXD9SCTqBr57Fe21xvS89IksDAnB7FD2cs3kOUscAAAAAAAAAAAAAAAAAAAAAAAAAAAAAAAAAAAAAAAAAAAAAAAAAAAAAAAAAAAAAAAAAQAAAAAAAAAAAAAAAAAAAAAAAAAAAAAAAAAAAAAAAAAAAAAAAAAAAAEAAAAAQAEAAAAAAAAHAAAAODEzODAuMAAtAQAAeyJ3YXNfZmlyc3RfZXZlbnQiOnRydWUsImltYWdlX2lkIjpbMjM1NDc4MTczLDE0MjY2MzQzNDAsMTcyNDQzNDY5NCwxMjY5MTUxMjM1LDIyOTk2ODc1MDksMzMzMzc3MDAzOSwzNzYxMTYwMDkzLDQwMDU0NTgzNzZdLCJxZiI6eyJiIjpbMCwwLDAsMCwwLDAsMCwwLDAsMCwwLDAsMCwwLDAsMCwwLDAsMCwwLDAsMCwwLDAsMCwwLDAsMCwwLDAsMCwwLDAsMCwwLDAsMCwwLDAsMCwwLDAsMCwwLDAsMCwwLDAsMCwwLDAsMCwwLDAsMCwwLDAsMCwwLDAsMCwwLDAsMCwwLDAsMCwwLDAsMCwwLDAsMF0sImwiOjAsInEiOjYsInIiOjd9fQAAAAAAAAAAAAAAAAAAAEABAAAAAAAABwAAADgxMzgwLjAALQEAAHsid2FzX2ZpcnN0X2V2ZW50Ijp0cnVlLCJpbWFnZV9pZCI6WzIzNTQ3ODE3MywxNDI2NjM0MzQwLDE3MjQ0MzQ2OTQsMTI2OTE1MTIzNSwyMjk5Njg3NTA5LDMzMzM3NzAwMzksMzc2MTE2MDA5Myw0MDA1NDU4Mzc2XSwicWYiOnsiYiI6WzAsMCwwLDAsMCwwLDAsMCwwLDAsMCwwLDAsMCwwLDAsMCwwLDAsMCwwLDAsMCwwLDAsMCwwLDAsMCwwLDAsMCwwLDAsMCwwLDAsMCwwLDAsMCwwLDAsMCwwLDAsMCwwLDAsMCwwLDAsMCwwLDAsMCwwLDAsMCwwLDAsMCwwLDAsMCwwLDAsMCwwLDAsMCwwLDBdLCJsIjowLCJxIjo2LCJyIjo3fX0AAAAAAAAAAAAAAAAAAAAAAAAAAAAAAAAAAAAAAAAAAAAAAA=='}}
prove_38;99;40;Mul;3960;85340;85340.0;841;0.06584383399967919;{'verificationValue': 85340.0, 'proof': {'imageId': [235478173, 1426634340, 1724434694, 1269151235, 2299687509, 3333770039, 3761160093, 4005458376], 'receipt': 'AwAAAAAAAAAAAAAAmL4gACyGqXD9SCTqBr57Fe21xvS89IksDAnB7FD2cs3kOUscAAAAAAAAAAAAAAAAAAAAAAAAAAAAAAAAAAAAAAAAAAAAAAAAAAAAAAAAAAAAAAAAAQAAAAAAAAAAAAAAAAAAAAAAAAAAAAAAAAAAAAAAAAAAAAAAAAAAAAEAAAAAQAEAAAAAAAAHAAAAODUzNDAuMAAtAQAAeyJ3YXNfZmlyc3RfZXZlbnQiOnRydWUsImltYWdlX2lkIjpbMjM1NDc4MTczLDE0MjY2MzQzNDAsMTcyNDQzNDY5NCwxMjY5MTUxMjM1LDIyOTk2ODc1MDksMzMzMzc3MDAzOSwzNzYxMTYwMDkzLDQwMDU0NTgzNzZdLCJxZiI6eyJiIjpbMCwwLDAsMCwwLDAsMCwwLDAsMCwwLDAsMCwwLDAsMCwwLDAsMCwwLDAsMCwwLDAsMCwwLDAsMCwwLDAsMCwwLDAsMCwwLDAsMCwwLDAsMCwwLDAsMCwwLDAsMCwwLDAsMCwwLDAsMCwwLDAsMCwwLDAsMCwwLDAsMCwwLDAsMCwwLDAsMCwwLDAsMCwwLDAsMF0sImwiOjAsInEiOjYsInIiOjd9fQAAAAAAAAAAAAAAAAAAAEABAAAAAAAABwAAADg1MzQwLjAALQEAAHsid2FzX2ZpcnN0X2V2ZW50Ijp0cnVlLCJpbWFnZV9pZCI6WzIzNTQ3ODE3MywxNDI2NjM0MzQwLDE3MjQ0MzQ2OTQsMTI2OTE1MTIzNSwyMjk5Njg3NTA5LDMzMzM3NzAwMzksMzc2MTE2MDA5Myw0MDA1NDU4Mzc2XSwicWYiOnsiYiI6WzAsMCwwLDAsMCwwLDAsMCwwLDAsMCwwLDAsMCwwLDAsMCwwLDAsMCwwLDAsMCwwLDAsMCwwLDAsMCwwLDAsMCwwLDAsMCwwLDAsMCwwLDAsMCwwLDAsMCwwLDAsMCwwLDAsMCwwLDAsMCwwLDAsMCwwLDAsMCwwLDAsMCwwLDAsMCwwLDAsMCwwLDAsMCwwLDBdLCJsIjowLCJxIjo2LCJyIjo3fX0AAAAAAAAAAAAAAAAAAAAAAAAAAAAAAAAAAAAAAAAAAAAAAA=='}}
prove_39;66;75;Mul;4950;90290;90290.0;841;0.06480437500067637;{'verificationValue': 90290.0, 'proof': {'imageId': [235478173, 1426634340, 1724434694, 1269151235, 2299687509, 3333770039, 3761160093, 4005458376], 'receipt': 'AwAAAAAAAAAAAAAAmL4gACyGqXD9SCTqBr57Fe21xvS89IksDAnB7FD2cs3kOUscAAAAAAAAAAAAAAAAAAAAAAAAAAAAAAAAAAAAAAAAAAAAAAAAAAAAAAAAAAAAAAAAAQAAAAAAAAAAAAAAAAAAAAAAAAAAAAAAAAAAAAAAAAAAAAAAAAAAAAEAAAAAQAEAAAAAAAAHAAAAOTAyOTAuMAAtAQAAeyJ3YXNfZmlyc3RfZXZlbnQiOnRydWUsImltYWdlX2lkIjpbMjM1NDc4MTczLDE0MjY2MzQzNDAsMTcyNDQzNDY5NCwxMjY5MTUxMjM1LDIyOTk2ODc1MDksMzMzMzc3MDAzOSwzNzYxMTYwMDkzLDQwMDU0NTgzNzZdLCJxZiI6eyJiIjpbMCwwLDAsMCwwLDAsMCwwLDAsMCwwLDAsMCwwLDAsMCwwLDAsMCwwLDAsMCwwLDAsMCwwLDAsMCwwLDAsMCwwLDAsMCwwLDAsMCwwLDAsMCwwLDAsMCwwLDAsMCwwLDAsMCwwLDAsMCwwLDAsMCwwLDAsMCwwLDAsMCwwLDAsMCwwLDAsMCwwLDAsMCwwLDAsMF0sImwiOjAsInEiOjYsInIiOjd9fQAAAAAAAAAAAAAAAAAAAEABAAAAAAAABwAAADkwMjkwLjAALQEAAHsid2FzX2ZpcnN0X2V2ZW50Ijp0cnVlLCJpbWFnZV9pZCI6WzIzNTQ3ODE3MywxNDI2NjM0MzQwLDE3MjQ0MzQ2OTQsMTI2OTE1MTIzNSwyMjk5Njg3NTA5LDMzMzM3NzAwMzksMzc2MTE2MDA5Myw0MDA1NDU4Mzc2XSwicWYiOnsiYiI6WzAsMCwwLDAsMCwwLDAsMCwwLDAsMCwwLDAsMCwwLDAsMCwwLDAsMCwwLDAsMCwwLDAsMCwwLDAsMCwwLDAsMCwwLDAsMCwwLDAsMCwwLDAsMCwwLDAsMCwwLDAsMCwwLDAsMCwwLDAsMCwwLDAsMCwwLDAsMCwwLDAsMCwwLDAsMCwwLDAsMCwwLDAsMCwwLDBdLCJsIjowLCJxIjo2LCJyIjo3fX0AAAAAAAAAAAAAAAAAAAAAAAAAAAAAAAAAAAAAAAAAAAAAAA=='}}
prove_40;54;53;Mul;2862;93152;93152.0;841;0.06581824999921082;{'verificationValue': 93152.0, 'proof': {'imageId': [235478173, 1426634340, 1724434694, 1269151235, 2299687509, 3333770039, 3761160093, 4005458376], 'receipt': 'AwAAAAAAAAAAAAAAmL4gACyGqXD9SCTqBr57Fe21xvS89IksDAnB7FD2cs3kOUscAAAAAAAAAAAAAAAAAAAAAAAAAAAAAAAAAAAAAAAAAAAAAAAAAAAAAAAAAAAAAAAAAQAAAAAAAAAAAAAAAAAAAAAAAAAAAAAAAAAAAAAAAAAAAAAAAAAAAAEAAAAAQAEAAAAAAAAHAAAAOTMxNTIuMAAtAQAAeyJ3YXNfZmlyc3RfZXZlbnQiOnRydWUsImltYWdlX2lkIjpbMjM1NDc4MTczLDE0MjY2MzQzNDAsMTcyNDQzNDY5NCwxMjY5MTUxMjM1LDIyOTk2ODc1MDksMzMzMzc3MDAzOSwzNzYxMTYwMDkzLDQwMDU0NTgzNzZdLCJxZiI6eyJiIjpbMCwwLDAsMCwwLDAsMCwwLDAsMCwwLDAsMCwwLDAsMCwwLDAsMCwwLDAsMCwwLDAsMCwwLDAsMCwwLDAsMCwwLDAsMCwwLDAsMCwwLDAsMCwwLDAsMCwwLDAsMCwwLDAsMCwwLDAsMCwwLDAsMCwwLDAsMCwwLDAsMCwwLDAsMCwwLDAsMCwwLDAsMCwwLDAsMF0sImwiOjAsInEiOjYsInIiOjd9fQAAAAAAAAAAAAAAAAAAAEABAAAAAAAABwAAADkzMTUyLjAALQEAAHsid2FzX2ZpcnN0X2V2ZW50Ijp0cnVlLCJpbWFnZV9pZCI6WzIzNTQ3ODE3MywxNDI2NjM0MzQwLDE3MjQ0MzQ2OTQsMTI2OTE1MTIzNSwyMjk5Njg3NTA5LDMzMzM3NzAwMzksMzc2MTE2MDA5Myw0MDA1NDU4Mzc2XSwicWYiOnsiYiI6WzAsMCwwLDAsMCwwLDAsMCwwLDAsMCwwLDAsMCwwLDAsMCwwLDAsMCwwLDAsMCwwLDAsMCwwLDAsMCwwLDAsMCwwLDAsMCwwLDAsMCwwLDAsMCwwLDAsMCwwLDAsMCwwLDAsMCwwLDAsMCwwLDAsMCwwLDAsMCwwLDAsMCwwLDAsMCwwLDAsMCwwLDAsMCwwLDBdLCJsIjowLCJxIjo2LCJyIjo3fX0AAAAAAAAAAAAAAAAAAAAAAAAAAAAAAAAAAAAAAAAAAAAAAA=='}}
prove_41;8;43;Mul;344;93496;93496.0;841;0.06552124999871012;{'verificationValue': 93496.0, 'proof': {'imageId': [235478173, 1426634340, 1724434694, 1269151235, 2299687509, 3333770039, 3761160093, 4005458376], 'receipt': 'AwAAAAAAAAAAAAAAmL4gACyGqXD9SCTqBr57Fe21xvS89IksDAnB7FD2cs3kOUscAAAAAAAAAAAAAAAAAAAAAAAAAAAAAAAAAAAAAAAAAAAAAAAAAAAAAAAAAAAAAAAAAQAAAAAAAAAAAAAAAAAAAAAAAAAAAAAAAAAAAAAAAAAAAAAAAAAAAAEAAAAAQAEAAAAAAAAHAAAAOTM0OTYuMAAtAQAAeyJ3YXNfZmlyc3RfZXZlbnQiOnRydWUsImltYWdlX2lkIjpbMjM1NDc4MTczLDE0MjY2MzQzNDAsMTcyNDQzNDY5NCwxMjY5MTUxMjM1LDIyOTk2ODc1MDksMzMzMzc3MDAzOSwzNzYxMTYwMDkzLDQwMDU0NTgzNzZdLCJxZiI6eyJiIjpbMCwwLDAsMCwwLDAsMCwwLDAsMCwwLDAsMCwwLDAsMCwwLDAsMCwwLDAsMCwwLDAsMCwwLDAsMCwwLDAsMCwwLDAsMCwwLDAsMCwwLDAsMCwwLDAsMCwwLDAsMCwwLDAsMCwwLDAsMCwwLDAsMCwwLDAsMCwwLDAsMCwwLDAsMCwwLDAsMCwwLDAsMCwwLDAsMF0sImwiOjAsInEiOjYsInIiOjd9fQAAAAAAAAAAAAAAAAAAAEABAAAAAAAABwAAADkzNDk2LjAALQEAAHsid2FzX2ZpcnN0X2V2ZW50Ijp0cnVlLCJpbWFnZV9pZCI6WzIzNTQ3ODE3MywxNDI2NjM0MzQwLDE3MjQ0MzQ2OTQsMTI2OTE1MTIzNSwyMjk5Njg3NTA5LDMzMzM3NzAwMzksMzc2MTE2MDA5Myw0MDA1NDU4Mzc2XSwicWYiOnsiYiI6WzAsMCwwLDAsMCwwLDAsMCwwLDAsMCwwLDAsMCwwLDAsMCwwLDAsMCwwLDAsMCwwLDAsMCwwLDAsMCwwLDAsMCwwLDAsMCwwLDAsMCwwLDAsMCwwLDAsMCwwLDAsMCwwLDAsMCwwLDAsMCwwLDAsMCwwLDAsMCwwLDAsMCwwLDAsMCwwLDAsMCwwLDAsMCwwLDBdLCJsIjowLCJxIjo2LCJyIjo3fX0AAAAAAAAAAAAAAAAAAAAAAAAAAAAAAAAAAAAAAAAAAAAAAA=='}}
prove_42;83;49;Mul;4067;97563;97563.0;841;0.06534166599885793;{'verificationValue': 97563.0, 'proof': {'imageId': [235478173, 1426634340, 1724434694, 1269151235, 2299687509, 3333770039, 3761160093, 4005458376], 'receipt': 'AwAAAAAAAAAAAAAAmL4gACyGqXD9SCTqBr57Fe21xvS89IksDAnB7FD2cs3kOUscAAAAAAAAAAAAAAAAAAAAAAAAAAAAAAAAAAAAAAAAAAAAAAAAAAAAAAAAAAAAAAAAAQAAAAAAAAAAAAAAAAAAAAAAAAAAAAAAAAAAAAAAAAAAAAAAAAAAAAEAAAAAQAEAAAAAAAAHAAAAOTc1NjMuMAAtAQAAeyJ3YXNfZmlyc3RfZXZlbnQiOnRydWUsImltYWdlX2lkIjpbMjM1NDc4MTczLDE0MjY2MzQzNDAsMTcyNDQzNDY5NCwxMjY5MTUxMjM1LDIyOTk2ODc1MDksMzMzMzc3MDAzOSwzNzYxMTYwMDkzLDQwMDU0NTgzNzZdLCJxZiI6eyJiIjpbMCwwLDAsMCwwLDAsMCwwLDAsMCwwLDAsMCwwLDAsMCwwLDAsMCwwLDAsMCwwLDAsMCwwLDAsMCwwLDAsMCwwLDAsMCwwLDAsMCwwLDAsMCwwLDAsMCwwLDAsMCwwLDAsMCwwLDAsMCwwLDAsMCwwLDAsMCwwLDAsMCwwLDAsMCwwLDAsMCwwLDAsMCwwLDAsMF0sImwiOjAsInEiOjYsInIiOjd9fQAAAAAAAAAAAAAAAAAAAEABAAAAAAAABwAAADk3NTYzLjAALQEAAHsid2FzX2ZpcnN0X2V2ZW50Ijp0cnVlLCJpbWFnZV9pZCI6WzIzNTQ3ODE3MywxNDI2NjM0MzQwLDE3MjQ0MzQ2OTQsMTI2OTE1MTIzNSwyMjk5Njg3NTA5LDMzMzM3NzAwMzksMzc2MTE2MDA5Myw0MDA1NDU4Mzc2XSwicWYiOnsiYiI6WzAsMCwwLDAsMCwwLDAsMCwwLDAsMCwwLDAsMCwwLDAsMCwwLDAsMCwwLDAsMCwwLDAsMCwwLDAsMCwwLDAsMCwwLDAsMCwwLDAsMCwwLDAsMCwwLDAsMCwwLDAsMCwwLDAsMCwwLDAsMCwwLDAsMCwwLDAsMCwwLDAsMCwwLDAsMCwwLDAsMCwwLDAsMCwwLDBdLCJsIjowLCJxIjo2LCJyIjo3fX0AAAAAAAAAAAAAAAAAAAAAAAAAAAAAAAAAAAAAAAAAAAAAAA=='}}
prove_43;85;26;Mul;2210;99773;99773.0;841;0.06687254200005555;{'verificationValue': 99773.0, 'proof': {'imageId': [235478173, 1426634340, 1724434694, 1269151235, 2299687509, 3333770039, 3761160093, 4005458376], 'receipt': 'AwAAAAAAAAAAAAAAmL4gACyGqXD9SCTqBr57Fe21xvS89IksDAnB7FD2cs3kOUscAAAAAAAAAAAAAAAAAAAAAAAAAAAAAAAAAAAAAAAAAAAAAAAAAAAAAAAAAAAAAAAAAQAAAAAAAAAAAAAAAAAAAAAAAAAAAAAAAAAAAAAAAAAAAAAAAAAAAAEAAAAAQAEAAAAAAAAHAAAAOTk3NzMuMAAtAQAAeyJ3YXNfZmlyc3RfZXZlbnQiOnRydWUsImltYWdlX2lkIjpbMjM1NDc4MTczLDE0MjY2MzQzNDAsMTcyNDQzNDY5NCwxMjY5MTUxMjM1LDIyOTk2ODc1MDksMzMzMzc3MDAzOSwzNzYxMTYwMDkzLDQwMDU0NTgzNzZdLCJxZiI6eyJiIjpbMCwwLDAsMCwwLDAsMCwwLDAsMCwwLDAsMCwwLDAsMCwwLDAsMCwwLDAsMCwwLDAsMCwwLDAsMCwwLDAsMCwwLDAsMCwwLDAsMCwwLDAsMCwwLDAsMCwwLDAsMCwwLDAsMCwwLDAsMCwwLDAsMCwwLDAsMCwwLDAsMCwwLDAsMCwwLDAsMCwwLDAsMCwwLDAsMF0sImwiOjAsInEiOjYsInIiOjd9fQAAAAAAAAAAAAAAAAAAAEABAAAAAAAABwAAADk5NzczLjAALQEAAHsid2FzX2ZpcnN0X2V2ZW50Ijp0cnVlLCJpbWFnZV9pZCI6WzIzNTQ3ODE3MywxNDI2NjM0MzQwLDE3MjQ0MzQ2OTQsMTI2OTE1MTIzNSwyMjk5Njg3NTA5LDMzMzM3NzAwMzksMzc2MTE2MDA5Myw0MDA1NDU4Mzc2XSwicWYiOnsiYiI6WzAsMCwwLDAsMCwwLDAsMCwwLDAsMCwwLDAsMCwwLDAsMCwwLDAsMCwwLDAsMCwwLDAsMCwwLDAsMCwwLDAsMCwwLDAsMCwwLDAsMCwwLDAsMCwwLDAsMCwwLDAsMCwwLDAsMCwwLDAsMCwwLDAsMCwwLDAsMCwwLDAsMCwwLDAsMCwwLDAsMCwwLDAsMCwwLDBdLCJsIjowLCJxIjo2LCJyIjo3fX0AAAAAAAAAAAAAAAAAAAAAAAAAAAAAAAAAAAAAAAAAAAAAAA=='}}
prove_44;66;94;Mul;6204;105977;105977.0;841;0.06683066699952178;{'verificationValue': 105977.0, 'proof': {'imageId': [235478173, 1426634340, 1724434694, 1269151235, 2299687509, 3333770039, 3761160093, 4005458376], 'receipt': 'AwAAAAAAAAAAAAAAmL4gACyGqXD9SCTqBr57Fe21xvS89IksDAnB7FD2cs3kOUscAAAAAAAAAAAAAAAAAAAAAAAAAAAAAAAAAAAAAAAAAAAAAAAAAAAAAAAAAAAAAAAAAQAAAAAAAAAAAAAAAAAAAAAAAAAAAAAAAAAAAAAAAAAAAAAAAAAAAAEAAAAAQAEAAAAAAAAIAAAAMTA1OTc3LjAtAQAAeyJ3YXNfZmlyc3RfZXZlbnQiOnRydWUsImltYWdlX2lkIjpbMjM1NDc4MTczLDE0MjY2MzQzNDAsMTcyNDQzNDY5NCwxMjY5MTUxMjM1LDIyOTk2ODc1MDksMzMzMzc3MDAzOSwzNzYxMTYwMDkzLDQwMDU0NTgzNzZdLCJxZiI6eyJiIjpbMCwwLDAsMCwwLDAsMCwwLDAsMCwwLDAsMCwwLDAsMCwwLDAsMCwwLDAsMCwwLDAsMCwwLDAsMCwwLDAsMCwwLDAsMCwwLDAsMCwwLDAsMCwwLDAsMCwwLDAsMCwwLDAsMCwwLDAsMCwwLDAsMCwwLDAsMCwwLDAsMCwwLDAsMCwwLDAsMCwwLDAsMCwwLDAsMF0sImwiOjAsInEiOjYsInIiOjd9fQAAAAAAAAAAAAAAAAAAAEABAAAAAAAACAAAADEwNTk3Ny4wLQEAAHsid2FzX2ZpcnN0X2V2ZW50Ijp0cnVlLCJpbWFnZV9pZCI6WzIzNTQ3ODE3MywxNDI2NjM0MzQwLDE3MjQ0MzQ2OTQsMTI2OTE1MTIzNSwyMjk5Njg3NTA5LDMzMzM3NzAwMzksMzc2MTE2MDA5Myw0MDA1NDU4Mzc2XSwicWYiOnsiYiI6WzAsMCwwLDAsMCwwLDAsMCwwLDAsMCwwLDAsMCwwLDAsMCwwLDAsMCwwLDAsMCwwLDAsMCwwLDAsMCwwLDAsMCwwLDAsMCwwLDAsMCwwLDAsMCwwLDAsMCwwLDAsMCwwLDAsMCwwLDAsMCwwLDAsMCwwLDAsMCwwLDAsMCwwLDAsMCwwLDAsMCwwLDAsMCwwLDBdLCJsIjowLCJxIjo2LCJyIjo3fX0AAAAAAAAAAAAAAAAAAAAAAAAAAAAAAAAAAAAAAAAAAAAAAA=='}}
prove_45;61;49;Mul;2989;108966;108966.0;841;0.06590616699941165;{'verificationValue': 108966.0, 'proof': {'imageId': [235478173, 1426634340, 1724434694, 1269151235, 2299687509, 3333770039, 3761160093, 4005458376], 'receipt': 'AwAAAAAAAAAAAAAAmL4gACyGqXD9SCTqBr57Fe21xvS89IksDAnB7FD2cs3kOUscAAAAAAAAAAAAAAAAAAAAAAAAAAAAAAAAAAAAAAAAAAAAAAAAAAAAAAAAAAAAAAAAAQAAAAAAAAAAAAAAAAAAAAAAAAAAAAAAAAAAAAAAAAAAAAAAAAAAAAEAAAAAQAEAAAAAAAAIAAAAMTA4OTY2LjAtAQAAeyJ3YXNfZmlyc3RfZXZlbnQiOnRydWUsImltYWdlX2lkIjpbMjM1NDc4MTczLDE0MjY2MzQzNDAsMTcyNDQzNDY5NCwxMjY5MTUxMjM1LDIyOTk2ODc1MDksMzMzMzc3MDAzOSwzNzYxMTYwMDkzLDQwMDU0NTgzNzZdLCJxZiI6eyJiIjpbMCwwLDAsMCwwLDAsMCwwLDAsMCwwLDAsMCwwLDAsMCwwLDAsMCwwLDAsMCwwLDAsMCwwLDAsMCwwLDAsMCwwLDAsMCwwLDAsMCwwLDAsMCwwLDAsMCwwLDAsMCwwLDAsMCwwLDAsMCwwLDAsMCwwLDAsMCwwLDAsMCwwLDAsMCwwLDAsMCwwLDAsMCwwLDAsMF0sImwiOjAsInEiOjYsInIiOjd9fQAAAAAAAAAAAAAAAAAAAEABAAAAAAAACAAAADEwODk2Ni4wLQEAAHsid2FzX2ZpcnN0X2V2ZW50Ijp0cnVlLCJpbWFnZV9pZCI6WzIzNTQ3ODE3MywxNDI2NjM0MzQwLDE3MjQ0MzQ2OTQsMTI2OTE1MTIzNSwyMjk5Njg3NTA5LDMzMzM3NzAwMzksMzc2MTE2MDA5Myw0MDA1NDU4Mzc2XSwicWYiOnsiYiI6WzAsMCwwLDAsMCwwLDAsMCwwLDAsMCwwLDAsMCwwLDAsMCwwLDAsMCwwLDAsMCwwLDAsMCwwLDAsMCwwLDAsMCwwLDAsMCwwLDAsMCwwLDAsMCwwLDAsMCwwLDAsMCwwLDAsMCwwLDAsMCwwLDAsMCwwLDAsMCwwLDAsMCwwLDAsMCwwLDAsMCwwLDAsMCwwLDBdLCJsIjowLCJxIjo2LCJyIjo3fX0AAAAAAAAAAAAAAAAAAAAAAAAAAAAAAAAAAAAAAAAAAAAAAA=='}}
prove_46;20;7;Mul;140;109106;109106.0;841;0.06623866699919745;{'verificationValue': 109106.0, 'proof': {'imageId': [235478173, 1426634340, 1724434694, 1269151235, 2299687509, 3333770039, 3761160093, 4005458376], 'receipt': 'AwAAAAAAAAAAAAAAmL4gACyGqXD9SCTqBr57Fe21xvS89IksDAnB7FD2cs3kOUscAAAAAAAAAAAAAAAAAAAAAAAAAAAAAAAAAAAAAAAAAAAAAAAAAAAAAAAAAAAAAAAAAQAAAAAAAAAAAAAAAAAAAAAAAAAAAAAAAAAAAAAAAAAAAAAAAAAAAAEAAAAAQAEAAAAAAAAIAAAAMTA5MTA2LjAtAQAAeyJ3YXNfZmlyc3RfZXZlbnQiOnRydWUsImltYWdlX2lkIjpbMjM1NDc4MTczLDE0MjY2MzQzNDAsMTcyNDQzNDY5NCwxMjY5MTUxMjM1LDIyOTk2ODc1MDksMzMzMzc3MDAzOSwzNzYxMTYwMDkzLDQwMDU0NTgzNzZdLCJxZiI6eyJiIjpbMCwwLDAsMCwwLDAsMCwwLDAsMCwwLDAsMCwwLDAsMCwwLDAsMCwwLDAsMCwwLDAsMCwwLDAsMCwwLDAsMCwwLDAsMCwwLDAsMCwwLDAsMCwwLDAsMCwwLDAsMCwwLDAsMCwwLDAsMCwwLDAsMCwwLDAsMCwwLDAsMCwwLDAsMCwwLDAsMCwwLDAsMCwwLDAsMF0sImwiOjAsInEiOjYsInIiOjd9fQAAAAAAAAAAAAAAAAAAAEABAAAAAAAACAAAADEwOTEwNi4wLQEAAHsid2FzX2ZpcnN0X2V2ZW50Ijp0cnVlLCJpbWFnZV9pZCI6WzIzNTQ3ODE3MywxNDI2NjM0MzQwLDE3MjQ0MzQ2OTQsMTI2OTE1MTIzNSwyMjk5Njg3NTA5LDMzMzM3NzAwMzksMzc2MTE2MDA5Myw0MDA1NDU4Mzc2XSwicWYiOnsiYiI6WzAsMCwwLDAsMCwwLDAsMCwwLDAsMCwwLDAsMCwwLDAsMCwwLDAsMCwwLDAsMCwwLDAsMCwwLDAsMCwwLDAsMCwwLDAsMCwwLDAsMCwwLDAsMCwwLDAsMCwwLDAsMCwwLDAsMCwwLDAsMCwwLDAsMCwwLDAsMCwwLDAsMCwwLDAsMCwwLDAsMCwwLDAsMCwwLDBdLCJsIjowLCJxIjo2LCJyIjo3fX0AAAAAAAAAAAAAAAAAAAAAAAAAAAAAAAAAAAAAAAAAAAAAAA=='}}
prove_47;95;79;Mul;7505;116611;116611.0;841;0.06547900000077789;{'verificationValue': 116611.0, 'proof': {'imageId': [235478173, 1426634340, 1724434694, 1269151235, 2299687509, 3333770039, 3761160093, 4005458376], 'receipt': 'AwAAAAAAAAAAAAAAmL4gACyGqXD9SCTqBr57Fe21xvS89IksDAnB7FD2cs3kOUscAAAAAAAAAAAAAAAAAAAAAAAAAAAAAAAAAAAAAAAAAAAAAAAAAAAAAAAAAAAAAAAAAQAAAAAAAAAAAAAAAAAAAAAAAAAAAAAAAAAAAAAAAAAAAAAAAAAAAAEAAAAAQAEAAAAAAAAIAAAAMTE2NjExLjAtAQAAeyJ3YXNfZmlyc3RfZXZlbnQiOnRydWUsImltYWdlX2lkIjpbMjM1NDc4MTczLDE0MjY2MzQzNDAsMTcyNDQzNDY5NCwxMjY5MTUxMjM1LDIyOTk2ODc1MDksMzMzMzc3MDAzOSwzNzYxMTYwMDkzLDQwMDU0NTgzNzZdLCJxZiI6eyJiIjpbMCwwLDAsMCwwLDAsMCwwLDAsMCwwLDAsMCwwLDAsMCwwLDAsMCwwLDAsMCwwLDAsMCwwLDAsMCwwLDAsMCwwLDAsMCwwLDAsMCwwLDAsMCwwLDAsMCwwLDAsMCwwLDAsMCwwLDAsMCwwLDAsMCwwLDAsMCwwLDAsMCwwLDAsMCwwLDAsMCwwLDAsMCwwLDAsMF0sImwiOjAsInEiOjYsInIiOjd9fQAAAAAAAAAAAAAAAAAAAEABAAAAAAAACAAAADExNjYxMS4wLQEAAHsid2FzX2ZpcnN0X2V2ZW50Ijp0cnVlLCJpbWFnZV9pZCI6WzIzNTQ3ODE3MywxNDI2NjM0MzQwLDE3MjQ0MzQ2OTQsMTI2OTE1MTIzNSwyMjk5Njg3NTA5LDMzMzM3NzAwMzksMzc2MTE2MDA5Myw0MDA1NDU4Mzc2XSwicWYiOnsiYiI6WzAsMCwwLDAsMCwwLDAsMCwwLDAsMCwwLDAsMCwwLDAsMCwwLDAsMCwwLDAsMCwwLDAsMCwwLDAsMCwwLDAsMCwwLDAsMCwwLDAsMCwwLDAsMCwwLDAsMCwwLDAsMCwwLDAsMCwwLDAsMCwwLDAsMCwwLDAsMCwwLDAsMCwwLDAsMCwwLDAsMCwwLDAsMCwwLDBdLCJsIjowLCJxIjo2LCJyIjo3fX0AAAAAAAAAAAAAAAAAAAAAAAAAAAAAAAAAAAAAAAAAAAAAAA=='}}
prove_48;27;60;Mul;1620;118231;118231.0;841;0.06597879200126044;{'verificationValue': 118231.0, 'proof': {'imageId': [235478173, 1426634340, 1724434694, 1269151235, 2299687509, 3333770039, 3761160093, 4005458376], 'receipt': 'AwAAAAAAAAAAAAAAmL4gACyGqXD9SCTqBr57Fe21xvS89IksDAnB7FD2cs3kOUscAAAAAAAAAAAAAAAAAAAAAAAAAAAAAAAAAAAAAAAAAAAAAAAAAAAAAAAAAAAAAAAAAQAAAAAAAAAAAAAAAAAAAAAAAAAAAAAAAAAAAAAAAAAAAAAAAAAAAAEAAAAAQAEAAAAAAAAIAAAAMTE4MjMxLjAtAQAAeyJ3YXNfZmlyc3RfZXZlbnQiOnRydWUsImltYWdlX2lkIjpbMjM1NDc4MTczLDE0MjY2MzQzNDAsMTcyNDQzNDY5NCwxMjY5MTUxMjM1LDIyOTk2ODc1MDksMzMzMzc3MDAzOSwzNzYxMTYwMDkzLDQwMDU0NTgzNzZdLCJxZiI6eyJiIjpbMCwwLDAsMCwwLDAsMCwwLDAsMCwwLDAsMCwwLDAsMCwwLDAsMCwwLDAsMCwwLDAsMCwwLDAsMCwwLDAsMCwwLDAsMCwwLDAsMCwwLDAsMCwwLDAsMCwwLDAsMCwwLDAsMCwwLDAsMCwwLDAsMCwwLDAsMCwwLDAsMCwwLDAsMCwwLDAsMCwwLDAsMCwwLDAsMF0sImwiOjAsInEiOjYsInIiOjd9fQAAAAAAAAAAAAAAAAAAAEABAAAAAAAACAAAADExODIzMS4wLQEAAHsid2FzX2ZpcnN0X2V2ZW50Ijp0cnVlLCJpbWFnZV9pZCI6WzIzNTQ3ODE3MywxNDI2NjM0MzQwLDE3MjQ0MzQ2OTQsMTI2OTE1MTIzNSwyMjk5Njg3NTA5LDMzMzM3NzAwMzksMzc2MTE2MDA5Myw0MDA1NDU4Mzc2XSwicWYiOnsiYiI6WzAsMCwwLDAsMCwwLDAsMCwwLDAsMCwwLDAsMCwwLDAsMCwwLDAsMCwwLDAsMCwwLDAsMCwwLDAsMCwwLDAsMCwwLDAsMCwwLDAsMCwwLDAsMCwwLDAsMCwwLDAsMCwwLDAsMCwwLDAsMCwwLDAsMCwwLDAsMCwwLDAsMCwwLDAsMCwwLDAsMCwwLDAsMCwwLDBdLCJsIjowLCJxIjo2LCJyIjo3fX0AAAAAAAAAAAAAAAAAAAAAAAAAAAAAAAAAAAAAAAAAAAAAAA=='}}
prove_49;91;61;Mul;5551;123782;123782.0;841;0.0662914999993518;{'verificationValue': 123782.0, 'proof': {'imageId': [235478173, 1426634340, 1724434694, 1269151235, 2299687509, 3333770039, 3761160093, 4005458376], 'receipt': 'AwAAAAAAAAAAAAAAmL4gACyGqXD9SCTqBr57Fe21xvS89IksDAnB7FD2cs3kOUscAAAAAAAAAAAAAAAAAAAAAAAAAAAAAAAAAAAAAAAAAAAAAAAAAAAAAAAAAAAAAAAAAQAAAAAAAAAAAAAAAAAAAAAAAAAAAAAAAAAAAAAAAAAAAAAAAAAAAAEAAAAAQAEAAAAAAAAIAAAAMTIzNzgyLjAtAQAAeyJ3YXNfZmlyc3RfZXZlbnQiOnRydWUsImltYWdlX2lkIjpbMjM1NDc4MTczLDE0MjY2MzQzNDAsMTcyNDQzNDY5NCwxMjY5MTUxMjM1LDIyOTk2ODc1MDksMzMzMzc3MDAzOSwzNzYxMTYwMDkzLDQwMDU0NTgzNzZdLCJxZiI6eyJiIjpbMCwwLDAsMCwwLDAsMCwwLDAsMCwwLDAsMCwwLDAsMCwwLDAsMCwwLDAsMCwwLDAsMCwwLDAsMCwwLDAsMCwwLDAsMCwwLDAsMCwwLDAsMCwwLDAsMCwwLDAsMCwwLDAsMCwwLDAsMCwwLDAsMCwwLDAsMCwwLDAsMCwwLDAsMCwwLDAsMCwwLDAsMCwwLDAsMF0sImwiOjAsInEiOjYsInIiOjd9fQAAAAAAAAAAAAAAAAAAAEABAAAAAAAACAAAADEyMzc4Mi4wLQEAAHsid2FzX2ZpcnN0X2V2ZW50Ijp0cnVlLCJpbWFnZV9pZCI6WzIzNTQ3ODE3MywxNDI2NjM0MzQwLDE3MjQ0MzQ2OTQsMTI2OTE1MTIzNSwyMjk5Njg3NTA5LDMzMzM3NzAwMzksMzc2MTE2MDA5Myw0MDA1NDU4Mzc2XSwicWYiOnsiYiI6WzAsMCwwLDAsMCwwLDAsMCwwLDAsMCwwLDAsMCwwLDAsMCwwLDAsMCwwLDAsMCwwLDAsMCwwLDAsMCwwLDAsMCwwLDAsMCwwLDAsMCwwLDAsMCwwLDAsMCwwLDAsMCwwLDAsMCwwLDAsMCwwLDAsMCwwLDAsMCwwLDAsMCwwLDAsMCwwLDAsMCwwLDAsMCwwLDBdLCJsIjowLCJxIjo2LCJyIjo3fX0AAAAAAAAAAAAAAAAAAAAAAAAAAAAAAAAAAAAAAAAAAAAAAA=='}}
prove_50;28;57;Mul;1596;125378;125378.0;841;0.06569291699997848;{'verificationValue': 125378.0, 'proof': {'imageId': [235478173, 1426634340, 1724434694, 1269151235, 2299687509, 3333770039, 3761160093, 4005458376], 'receipt': 'AwAAAAAAAAAAAAAAmL4gACyGqXD9SCTqBr57Fe21xvS89IksDAnB7FD2cs3kOUscAAAAAAAAAAAAAAAAAAAAAAAAAAAAAAAAAAAAAAAAAAAAAAAAAAAAAAAAAAAAAAAAAQAAAAAAAAAAAAAAAAAAAAAAAAAAAAAAAAAAAAAAAAAAAAAAAAAAAAEAAAAAQAEAAAAAAAAIAAAAMTI1Mzc4LjAtAQAAeyJ3YXNfZmlyc3RfZXZlbnQiOnRydWUsImltYWdlX2lkIjpbMjM1NDc4MTczLDE0MjY2MzQzNDAsMTcyNDQzNDY5NCwxMjY5MTUxMjM1LDIyOTk2ODc1MDksMzMzMzc3MDAzOSwzNzYxMTYwMDkzLDQwMDU0NTgzNzZdLCJxZiI6eyJiIjpbMCwwLDAsMCwwLDAsMCwwLDAsMCwwLDAsMCwwLDAsMCwwLDAsMCwwLDAsMCwwLDAsMCwwLDAsMCwwLDAsMCwwLDAsMCwwLDAsMCwwLDAsMCwwLDAsMCwwLDAsMCwwLDAsMCwwLDAsMCwwLDAsMCwwLDAsMCwwLDAsMCwwLDAsMCwwLDAsMCwwLDAsMCwwLDAsMF0sImwiOjAsInEiOjYsInIiOjd9fQAAAAAAAAAAAAAAAAAAAEABAAAAAAAACAAAADEyNTM3OC4wLQEAAHsid2FzX2ZpcnN0X2V2ZW50Ijp0cnVlLCJpbWFnZV9pZCI6WzIzNTQ3ODE3MywxNDI2NjM0MzQwLDE3MjQ0MzQ2OTQsMTI2OTE1MTIzNSwyMjk5Njg3NTA5LDMzMzM3NzAwMzksMzc2MTE2MDA5Myw0MDA1NDU4Mzc2XSwicWYiOnsiYiI6WzAsMCwwLDAsMCwwLDAsMCwwLDAsMCwwLDAsMCwwLDAsMCwwLDAsMCwwLDAsMCwwLDAsMCwwLDAsMCwwLDAsMCwwLDAsMCwwLDAsMCwwLDAsMCwwLDAsMCwwLDAsMCwwLDAsMCwwLDAsMCwwLDAsMCwwLDAsMCwwLDAsMCwwLDAsMCwwLDAsMCwwLDAsMCwwLDBdLCJsIjowLCJxIjo2LCJyIjo3fX0AAAAAAAAAAAAAAAAAAAAAAAAAAAAAAAAAAAAAAAAAAAAAAA=='}}
prove_51;11;17;Mul;187;125565;125565.0;841;0.06601991699972132;{'verificationValue': 125565.0, 'proof': {'imageId': [235478173, 1426634340, 1724434694, 1269151235, 2299687509, 3333770039, 3761160093, 4005458376], 'receipt': 'AwAAAAAAAAAAAAAAmL4gACyGqXD9SCTqBr57Fe21xvS89IksDAnB7FD2cs3kOUscAAAAAAAAAAAAAAAAAAAAAAAAAAAAAAAAAAAAAAAAAAAAAAAAAAAAAAAAAAAAAAAAAQAAAAAAAAAAAAAAAAAAAAAAAAAAAAAAAAAAAAAAAAAAAAAAAAAAAAEAAAAAQAEAAAAAAAAIAAAAMTI1NTY1LjAtAQAAeyJ3YXNfZmlyc3RfZXZlbnQiOnRydWUsImltYWdlX2lkIjpbMjM1NDc4MTczLDE0MjY2MzQzNDAsMTcyNDQzNDY5NCwxMjY5MTUxMjM1LDIyOTk2ODc1MDksMzMzMzc3MDAzOSwzNzYxMTYwMDkzLDQwMDU0NTgzNzZdLCJxZiI6eyJiIjpbMCwwLDAsMCwwLDAsMCwwLDAsMCwwLDAsMCwwLDAsMCwwLDAsMCwwLDAsMCwwLDAsMCwwLDAsMCwwLDAsMCwwLDAsMCwwLDAsMCwwLDAsMCwwLDAsMCwwLDAsMCwwLDAsMCwwLDAsMCwwLDAsMCwwLDAsMCwwLDAsMCwwLDAsMCwwLDAsMCwwLDAsMCwwLDAsMF0sImwiOjAsInEiOjYsInIiOjd9fQAAAAAAAAAAAAAAAAAAAEABAAAAAAAACAAAADEyNTU2NS4wLQEAAHsid2FzX2ZpcnN0X2V2ZW50Ijp0cnVlLCJpbWFnZV9pZCI6WzIzNTQ3ODE3MywxNDI2NjM0MzQwLDE3MjQ0MzQ2OTQsMTI2OTE1MTIzNSwyMjk5Njg3NTA5LDMzMzM3NzAwMzksMzc2MTE2MDA5Myw0MDA1NDU4Mzc2XSwicWYiOnsiYiI6WzAsMCwwLDAsMCwwLDAsMCwwLDAsMCwwLDAsMCwwLDAsMCwwLDAsMCwwLDAsMCwwLDAsMCwwLDAsMCwwLDAsMCwwLDAsMCwwLDAsMCwwLDAsMCwwLDAsMCwwLDAsMCwwLDAsMCwwLDAsMCwwLDAsMCwwLDAsMCwwLDAsMCwwLDAsMCwwLDAsMCwwLDAsMCwwLDBdLCJsIjowLCJxIjo2LCJyIjo3fX0AAAAAAAAAAAAAAAAAAAAAAAAAAAAAAAAAAAAAAAAAAAAAAA=='}}
prove_52;88;71;Mul;6248;131813;131813.0;841;0.06593354200049362;{'verificationValue': 131813.0, 'proof': {'imageId': [235478173, 1426634340, 1724434694, 1269151235, 2299687509, 3333770039, 3761160093, 4005458376], 'receipt': 'AwAAAAAAAAAAAAAAmL4gACyGqXD9SCTqBr57Fe21xvS89IksDAnB7FD2cs3kOUscAAAAAAAAAAAAAAAAAAAAAAAAAAAAAAAAAAAAAAAAAAAAAAAAAAAAAAAAAAAAAAAAAQAAAAAAAAAAAAAAAAAAAAAAAAAAAAAAAAAAAAAAAAAAAAAAAAAAAAEAAAAAQAEAAAAAAAAIAAAAMTMxODEzLjAtAQAAeyJ3YXNfZmlyc3RfZXZlbnQiOnRydWUsImltYWdlX2lkIjpbMjM1NDc4MTczLDE0MjY2MzQzNDAsMTcyNDQzNDY5NCwxMjY5MTUxMjM1LDIyOTk2ODc1MDksMzMzMzc3MDAzOSwzNzYxMTYwMDkzLDQwMDU0NTgzNzZdLCJxZiI6eyJiIjpbMCwwLDAsMCwwLDAsMCwwLDAsMCwwLDAsMCwwLDAsMCwwLDAsMCwwLDAsMCwwLDAsMCwwLDAsMCwwLDAsMCwwLDAsMCwwLDAsMCwwLDAsMCwwLDAsMCwwLDAsMCwwLDAsMCwwLDAsMCwwLDAsMCwwLDAsMCwwLDAsMCwwLDAsMCwwLDAsMCwwLDAsMCwwLDAsMF0sImwiOjAsInEiOjYsInIiOjd9fQAAAAAAAAAAAAAAAAAAAEABAAAAAAAACAAAADEzMTgxMy4wLQEAAHsid2FzX2ZpcnN0X2V2ZW50Ijp0cnVlLCJpbWFnZV9pZCI6WzIzNTQ3ODE3MywxNDI2NjM0MzQwLDE3MjQ0MzQ2OTQsMTI2OTE1MTIzNSwyMjk5Njg3NTA5LDMzMzM3NzAwMzksMzc2MTE2MDA5Myw0MDA1NDU4Mzc2XSwicWYiOnsiYiI6WzAsMCwwLDAsMCwwLDAsMCwwLDAsMCwwLDAsMCwwLDAsMCwwLDAsMCwwLDAsMCwwLDAsMCwwLDAsMCwwLDAsMCwwLDAsMCwwLDAsMCwwLDAsMCwwLDAsMCwwLDAsMCwwLDAsMCwwLDAsMCwwLDAsMCwwLDAsMCwwLDAsMCwwLDAsMCwwLDAsMCwwLDAsMCwwLDBdLCJsIjowLCJxIjo2LCJyIjo3fX0AAAAAAAAAAAAAAAAAAAAAAAAAAAAAAAAAAAAAAAAAAAAAAA=='}}
prove_53;13;13;Mul;169;131982;131982.0;841;0.06585758299843292;{'verificationValue': 131982.0, 'proof': {'imageId': [235478173, 1426634340, 1724434694, 1269151235, 2299687509, 3333770039, 3761160093, 4005458376], 'receipt': 'AwAAAAAAAAAAAAAAmL4gACyGqXD9SCTqBr57Fe21xvS89IksDAnB7FD2cs3kOUscAAAAAAAAAAAAAAAAAAAAAAAAAAAAAAAAAAAAAAAAAAAAAAAAAAAAAAAAAAAAAAAAAQAAAAAAAAAAAAAAAAAAAAAAAAAAAAAAAAAAAAAAAAAAAAAAAAAAAAEAAAAAQAEAAAAAAAAIAAAAMTMxOTgyLjAtAQAAeyJ3YXNfZmlyc3RfZXZlbnQiOnRydWUsImltYWdlX2lkIjpbMjM1NDc4MTczLDE0MjY2MzQzNDAsMTcyNDQzNDY5NCwxMjY5MTUxMjM1LDIyOTk2ODc1MDksMzMzMzc3MDAzOSwzNzYxMTYwMDkzLDQwMDU0NTgzNzZdLCJxZiI6eyJiIjpbMCwwLDAsMCwwLDAsMCwwLDAsMCwwLDAsMCwwLDAsMCwwLDAsMCwwLDAsMCwwLDAsMCwwLDAsMCwwLDAsMCwwLDAsMCwwLDAsMCwwLDAsMCwwLDAsMCwwLDAsMCwwLDAsMCwwLDAsMCwwLDAsMCwwLDAsMCwwLDAsMCwwLDAsMCwwLDAsMCwwLDAsMCwwLDAsMF0sImwiOjAsInEiOjYsInIiOjd9fQAAAAAAAAAAAAAAAAAAAEABAAAAAAAACAAAADEzMTk4Mi4wLQEAAHsid2FzX2ZpcnN0X2V2ZW50Ijp0cnVlLCJpbWFnZV9pZCI6WzIzNTQ3ODE3MywxNDI2NjM0MzQwLDE3MjQ0MzQ2OTQsMTI2OTE1MTIzNSwyMjk5Njg3NTA5LDMzMzM3NzAwMzksMzc2MTE2MDA5Myw0MDA1NDU4Mzc2XSwicWYiOnsiYiI6WzAsMCwwLDAsMCwwLDAsMCwwLDAsMCwwLDAsMCwwLDAsMCwwLDAsMCwwLDAsMCwwLDAsMCwwLDAsMCwwLDAsMCwwLDAsMCwwLDAsMCwwLDAsMCwwLDAsMCwwLDAsMCwwLDAsMCwwLDAsMCwwLDAsMCwwLDAsMCwwLDAsMCwwLDAsMCwwLDAsMCwwLDAsMCwwLDBdLCJsIjowLCJxIjo2LCJyIjo3fX0AAAAAAAAAAAAAAAAAAAAAAAAAAAAAAAAAAAAAAAAAAAAAAA=='}}
prove_54;94;68;Mul;6392;138374;138374.0;841;0.06620933299927856;{'verificationValue': 138374.0, 'proof': {'imageId': [235478173, 1426634340, 1724434694, 1269151235, 2299687509, 3333770039, 3761160093, 4005458376], 'receipt': 'AwAAAAAAAAAAAAAAmL4gACyGqXD9SCTqBr57Fe21xvS89IksDAnB7FD2cs3kOUscAAAAAAAAAAAAAAAAAAAAAAAAAAAAAAAAAAAAAAAAAAAAAAAAAAAAAAAAAAAAAAAAAQAAAAAAAAAAAAAAAAAAAAAAAAAAAAAAAAAAAAAAAAAAAAAAAAAAAAEAAAAAQAEAAAAAAAAIAAAAMTM4Mzc0LjAtAQAAeyJ3YXNfZmlyc3RfZXZlbnQiOnRydWUsImltYWdlX2lkIjpbMjM1NDc4MTczLDE0MjY2MzQzNDAsMTcyNDQzNDY5NCwxMjY5MTUxMjM1LDIyOTk2ODc1MDksMzMzMzc3MDAzOSwzNzYxMTYwMDkzLDQwMDU0NTgzNzZdLCJxZiI6eyJiIjpbMCwwLDAsMCwwLDAsMCwwLDAsMCwwLDAsMCwwLDAsMCwwLDAsMCwwLDAsMCwwLDAsMCwwLDAsMCwwLDAsMCwwLDAsMCwwLDAsMCwwLDAsMCwwLDAsMCwwLDAsMCwwLDAsMCwwLDAsMCwwLDAsMCwwLDAsMCwwLDAsMCwwLDAsMCwwLDAsMCwwLDAsMCwwLDAsMF0sImwiOjAsInEiOjYsInIiOjd9fQAAAAAAAAAAAAAAAAAAAEABAAAAAAAACAAAADEzODM3NC4wLQEAAHsid2FzX2ZpcnN0X2V2ZW50Ijp0cnVlLCJpbWFnZV9pZCI6WzIzNTQ3ODE3MywxNDI2NjM0MzQwLDE3MjQ0MzQ2OTQsMTI2OTE1MTIzNSwyMjk5Njg3NTA5LDMzMzM3NzAwMzksMzc2MTE2MDA5Myw0MDA1NDU4Mzc2XSwicWYiOnsiYiI6WzAsMCwwLDAsMCwwLDAsMCwwLDAsMCwwLDAsMCwwLDAsMCwwLDAsMCwwLDAsMCwwLDAsMCwwLDAsMCwwLDAsMCwwLDAsMCwwLDAsMCwwLDAsMCwwLDAsMCwwLDAsMCwwLDAsMCwwLDAsMCwwLDAsMCwwLDAsMCwwLDAsMCwwLDAsMCwwLDAsMCwwLDAsMCwwLDBdLCJsIjowLCJxIjo2LCJyIjo3fX0AAAAAAAAAAAAAAAAAAAAAAAAAAAAAAAAAAAAAAAAAAAAAAA=='}}
prove_55;68;52;Mul;3536;141910;141910.0;841;0.06638137499976438;{'verificationValue': 141910.0, 'proof': {'imageId': [235478173, 1426634340, 1724434694, 1269151235, 2299687509, 3333770039, 3761160093, 4005458376], 'receipt': 'AwAAAAAAAAAAAAAAmL4gACyGqXD9SCTqBr57Fe21xvS89IksDAnB7FD2cs3kOUscAAAAAAAAAAAAAAAAAAAAAAAAAAAAAAAAAAAAAAAAAAAAAAAAAAAAAAAAAAAAAAAAAQAAAAAAAAAAAAAAAAAAAAAAAAAAAAAAAAAAAAAAAAAAAAAAAAAAAAEAAAAAQAEAAAAAAAAIAAAAMTQxOTEwLjAtAQAAeyJ3YXNfZmlyc3RfZXZlbnQiOnRydWUsImltYWdlX2lkIjpbMjM1NDc4MTczLDE0MjY2MzQzNDAsMTcyNDQzNDY5NCwxMjY5MTUxMjM1LDIyOTk2ODc1MDksMzMzMzc3MDAzOSwzNzYxMTYwMDkzLDQwMDU0NTgzNzZdLCJxZiI6eyJiIjpbMCwwLDAsMCwwLDAsMCwwLDAsMCwwLDAsMCwwLDAsMCwwLDAsMCwwLDAsMCwwLDAsMCwwLDAsMCwwLDAsMCwwLDAsMCwwLDAsMCwwLDAsMCwwLDAsMCwwLDAsMCwwLDAsMCwwLDAsMCwwLDAsMCwwLDAsMCwwLDAsMCwwLDAsMCwwLDAsMCwwLDAsMCwwLDAsMF0sImwiOjAsInEiOjYsInIiOjd9fQAAAAAAAAAAAAAAAAAAAEABAAAAAAAACAAAADE0MTkxMC4wLQEAAHsid2FzX2ZpcnN0X2V2ZW50Ijp0cnVlLCJpbWFnZV9pZCI6WzIzNTQ3ODE3MywxNDI2NjM0MzQwLDE3MjQ0MzQ2OTQsMTI2OTE1MTIzNSwyMjk5Njg3NTA5LDMzMzM3NzAwMzksMzc2MTE2MDA5Myw0MDA1NDU4Mzc2XSwicWYiOnsiYiI6WzAsMCwwLDAsMCwwLDAsMCwwLDAsMCwwLDAsMCwwLDAsMCwwLDAsMCwwLDAsMCwwLDAsMCwwLDAsMCwwLDAsMCwwLDAsMCwwLDAsMCwwLDAsMCwwLDAsMCwwLDAsMCwwLDAsMCwwLDAsMCwwLDAsMCwwLDAsMCwwLDAsMCwwLDAsMCwwLDAsMCwwLDAsMCwwLDBdLCJsIjowLCJxIjo2LCJyIjo3fX0AAAAAAAAAAAAAAAAAAAAAAAAAAAAAAAAAAAAAAAAAAAAAAA=='}}
prove_56;44;75;Mul;3300;145210;145210.0;841;0.06678354200084868;{'verificationValue': 145210.0, 'proof': {'imageId': [235478173, 1426634340, 1724434694, 1269151235, 2299687509, 3333770039, 3761160093, 4005458376], 'receipt': 'AwAAAAAAAAAAAAAAmL4gACyGqXD9SCTqBr57Fe21xvS89IksDAnB7FD2cs3kOUscAAAAAAAAAAAAAAAAAAAAAAAAAAAAAAAAAAAAAAAAAAAAAAAAAAAAAAAAAAAAAAAAAQAAAAAAAAAAAAAAAAAAAAAAAAAAAAAAAAAAAAAAAAAAAAAAAAAAAAEAAAAAQAEAAAAAAAAIAAAAMTQ1MjEwLjAtAQAAeyJ3YXNfZmlyc3RfZXZlbnQiOnRydWUsImltYWdlX2lkIjpbMjM1NDc4MTczLDE0MjY2MzQzNDAsMTcyNDQzNDY5NCwxMjY5MTUxMjM1LDIyOTk2ODc1MDksMzMzMzc3MDAzOSwzNzYxMTYwMDkzLDQwMDU0NTgzNzZdLCJxZiI6eyJiIjpbMCwwLDAsMCwwLDAsMCwwLDAsMCwwLDAsMCwwLDAsMCwwLDAsMCwwLDAsMCwwLDAsMCwwLDAsMCwwLDAsMCwwLDAsMCwwLDAsMCwwLDAsMCwwLDAsMCwwLDAsMCwwLDAsMCwwLDAsMCwwLDAsMCwwLDAsMCwwLDAsMCwwLDAsMCwwLDAsMCwwLDAsMCwwLDAsMF0sImwiOjAsInEiOjYsInIiOjd9fQAAAAAAAAAAAAAAAAAAAEABAAAAAAAACAAAADE0NTIxMC4wLQEAAHsid2FzX2ZpcnN0X2V2ZW50Ijp0cnVlLCJpbWFnZV9pZCI6WzIzNTQ3ODE3MywxNDI2NjM0MzQwLDE3MjQ0MzQ2OTQsMTI2OTE1MTIzNSwyMjk5Njg3NTA5LDMzMzM3NzAwMzksMzc2MTE2MDA5Myw0MDA1NDU4Mzc2XSwicWYiOnsiYiI6WzAsMCwwLDAsMCwwLDAsMCwwLDAsMCwwLDAsMCwwLDAsMCwwLDAsMCwwLDAsMCwwLDAsMCwwLDAsMCwwLDAsMCwwLDAsMCwwLDAsMCwwLDAsMCwwLDAsMCwwLDAsMCwwLDAsMCwwLDAsMCwwLDAsMCwwLDAsMCwwLDAsMCwwLDAsMCwwLDAsMCwwLDAsMCwwLDBdLCJsIjowLCJxIjo2LCJyIjo3fX0AAAAAAAAAAAAAAAAAAAAAAAAAAAAAAAAAAAAAAAAAAAAAAA=='}}
prove_57;57;47;Mul;2679;147889;147889.0;841;0.06761158299923409;{'verificationValue': 147889.0, 'proof': {'imageId': [235478173, 1426634340, 1724434694, 1269151235, 2299687509, 3333770039, 3761160093, 4005458376], 'receipt': 'AwAAAAAAAAAAAAAAmL4gACyGqXD9SCTqBr57Fe21xvS89IksDAnB7FD2cs3kOUscAAAAAAAAAAAAAAAAAAAAAAAAAAAAAAAAAAAAAAAAAAAAAAAAAAAAAAAAAAAAAAAAAQAAAAAAAAAAAAAAAAAAAAAAAAAAAAAAAAAAAAAAAAAAAAAAAAAAAAEAAAAAQAEAAAAAAAAIAAAAMTQ3ODg5LjAtAQAAeyJ3YXNfZmlyc3RfZXZlbnQiOnRydWUsImltYWdlX2lkIjpbMjM1NDc4MTczLDE0MjY2MzQzNDAsMTcyNDQzNDY5NCwxMjY5MTUxMjM1LDIyOTk2ODc1MDksMzMzMzc3MDAzOSwzNzYxMTYwMDkzLDQwMDU0NTgzNzZdLCJxZiI6eyJiIjpbMCwwLDAsMCwwLDAsMCwwLDAsMCwwLDAsMCwwLDAsMCwwLDAsMCwwLDAsMCwwLDAsMCwwLDAsMCwwLDAsMCwwLDAsMCwwLDAsMCwwLDAsMCwwLDAsMCwwLDAsMCwwLDAsMCwwLDAsMCwwLDAsMCwwLDAsMCwwLDAsMCwwLDAsMCwwLDAsMCwwLDAsMCwwLDAsMF0sImwiOjAsInEiOjYsInIiOjd9fQAAAAAAAAAAAAAAAAAAAEABAAAAAAAACAAAADE0Nzg4OS4wLQEAAHsid2FzX2ZpcnN0X2V2ZW50Ijp0cnVlLCJpbWFnZV9pZCI6WzIzNTQ3ODE3MywxNDI2NjM0MzQwLDE3MjQ0MzQ2OTQsMTI2OTE1MTIzNSwyMjk5Njg3NTA5LDMzMzM3NzAwMzksMzc2MTE2MDA5Myw0MDA1NDU4Mzc2XSwicWYiOnsiYiI6WzAsMCwwLDAsMCwwLDAsMCwwLDAsMCwwLDAsMCwwLDAsMCwwLDAsMCwwLDAsMCwwLDAsMCwwLDAsMCwwLDAsMCwwLDAsMCwwLDAsMCwwLDAsMCwwLDAsMCwwLDAsMCwwLDAsMCwwLDAsMCwwLDAsMCwwLDAsMCwwLDAsMCwwLDAsMCwwLDAsMCwwLDAsMCwwLDBdLCJsIjowLCJxIjo2LCJyIjo3fX0AAAAAAAAAAAAAAAAAAAAAAAAAAAAAAAAAAAAAAAAAAAAAAA=='}}
prove_58;1;94;Mul;94;147983;147983.0;841;0.06735579099949973;{'verificationValue': 147983.0, 'proof': {'imageId': [235478173, 1426634340, 1724434694, 1269151235, 2299687509, 3333770039, 3761160093, 4005458376], 'receipt': 'AwAAAAAAAAAAAAAAmL4gACyGqXD9SCTqBr57Fe21xvS89IksDAnB7FD2cs3kOUscAAAAAAAAAAAAAAAAAAAAAAAAAAAAAAAAAAAAAAAAAAAAAAAAAAAAAAAAAAAAAAAAAQAAAAAAAAAAAAAAAAAAAAAAAAAAAAAAAAAAAAAAAAAAAAAAAAAAAAEAAAAAQAEAAAAAAAAIAAAAMTQ3OTgzLjAtAQAAeyJ3YXNfZmlyc3RfZXZlbnQiOnRydWUsImltYWdlX2lkIjpbMjM1NDc4MTczLDE0MjY2MzQzNDAsMTcyNDQzNDY5NCwxMjY5MTUxMjM1LDIyOTk2ODc1MDksMzMzMzc3MDAzOSwzNzYxMTYwMDkzLDQwMDU0NTgzNzZdLCJxZiI6eyJiIjpbMCwwLDAsMCwwLDAsMCwwLDAsMCwwLDAsMCwwLDAsMCwwLDAsMCwwLDAsMCwwLDAsMCwwLDAsMCwwLDAsMCwwLDAsMCwwLDAsMCwwLDAsMCwwLDAsMCwwLDAsMCwwLDAsMCwwLDAsMCwwLDAsMCwwLDAsMCwwLDAsMCwwLDAsMCwwLDAsMCwwLDAsMCwwLDAsMF0sImwiOjAsInEiOjYsInIiOjd9fQAAAAAAAAAAAAAAAAAAAEABAAAAAAAACAAAADE0Nzk4My4wLQEAAHsid2FzX2ZpcnN0X2V2ZW50Ijp0cnVlLCJpbWFnZV9pZCI6WzIzNTQ3ODE3MywxNDI2NjM0MzQwLDE3MjQ0MzQ2OTQsMTI2OTE1MTIzNSwyMjk5Njg3NTA5LDMzMzM3NzAwMzksMzc2MTE2MDA5Myw0MDA1NDU4Mzc2XSwicWYiOnsiYiI6WzAsMCwwLDAsMCwwLDAsMCwwLDAsMCwwLDAsMCwwLDAsMCwwLDAsMCwwLDAsMCwwLDAsMCwwLDAsMCwwLDAsMCwwLDAsMCwwLDAsMCwwLDAsMCwwLDAsMCwwLDAsMCwwLDAsMCwwLDAsMCwwLDAsMCwwLDAsMCwwLDAsMCwwLDAsMCwwLDAsMCwwLDAsMCwwLDBdLCJsIjowLCJxIjo2LCJyIjo3fX0AAAAAAAAAAAAAAAAAAAAAAAAAAAAAAAAAAAAAAAAAAAAAAA=='}}
prove_59;22;23;Mul;506;148489;148489.0;841;0.06624216599993815;{'verificationValue': 148489.0, 'proof': {'imageId': [235478173, 1426634340, 1724434694, 1269151235, 2299687509, 3333770039, 3761160093, 4005458376], 'receipt': 'AwAAAAAAAAAAAAAAmL4gACyGqXD9SCTqBr57Fe21xvS89IksDAnB7FD2cs3kOUscAAAAAAAAAAAAAAAAAAAAAAAAAAAAAAAAAAAAAAAAAAAAAAAAAAAAAAAAAAAAAAAAAQAAAAAAAAAAAAAAAAAAAAAAAAAAAAAAAAAAAAAAAAAAAAAAAAAAAAEAAAAAQAEAAAAAAAAIAAAAMTQ4NDg5LjAtAQAAeyJ3YXNfZmlyc3RfZXZlbnQiOnRydWUsImltYWdlX2lkIjpbMjM1NDc4MTczLDE0MjY2MzQzNDAsMTcyNDQzNDY5NCwxMjY5MTUxMjM1LDIyOTk2ODc1MDksMzMzMzc3MDAzOSwzNzYxMTYwMDkzLDQwMDU0NTgzNzZdLCJxZiI6eyJiIjpbMCwwLDAsMCwwLDAsMCwwLDAsMCwwLDAsMCwwLDAsMCwwLDAsMCwwLDAsMCwwLDAsMCwwLDAsMCwwLDAsMCwwLDAsMCwwLDAsMCwwLDAsMCwwLDAsMCwwLDAsMCwwLDAsMCwwLDAsMCwwLDAsMCwwLDAsMCwwLDAsMCwwLDAsMCwwLDAsMCwwLDAsMCwwLDAsMF0sImwiOjAsInEiOjYsInIiOjd9fQAAAAAAAAAAAAAAAAAAAEABAAAAAAAACAAAADE0ODQ4OS4wLQEAAHsid2FzX2ZpcnN0X2V2ZW50Ijp0cnVlLCJpbWFnZV9pZCI6WzIzNTQ3ODE3MywxNDI2NjM0MzQwLDE3MjQ0MzQ2OTQsMTI2OTE1MTIzNSwyMjk5Njg3NTA5LDMzMzM3NzAwMzksMzc2MTE2MDA5Myw0MDA1NDU4Mzc2XSwicWYiOnsiYiI6WzAsMCwwLDAsMCwwLDAsMCwwLDAsMCwwLDAsMCwwLDAsMCwwLDAsMCwwLDAsMCwwLDAsMCwwLDAsMCwwLDAsMCwwLDAsMCwwLDAsMCwwLDAsMCwwLDAsMCwwLDAsMCwwLDAsMCwwLDAsMCwwLDAsMCwwLDAsMCwwLDAsMCwwLDAsMCwwLDAsMCwwLDAsMCwwLDBdLCJsIjowLCJxIjo2LCJyIjo3fX0AAAAAAAAAAAAAAAAAAAAAAAAAAAAAAAAAAAAAAAAAAAAAAA=='}}
prove_60;7;42;Mul;294;148783;148783.0;841;0.06768854199981433;{'verificationValue': 148783.0, 'proof': {'imageId': [235478173, 1426634340, 1724434694, 1269151235, 2299687509, 3333770039, 3761160093, 4005458376], 'receipt': 'AwAAAAAAAAAAAAAAmL4gACyGqXD9SCTqBr57Fe21xvS89IksDAnB7FD2cs3kOUscAAAAAAAAAAAAAAAAAAAAAAAAAAAAAAAAAAAAAAAAAAAAAAAAAAAAAAAAAAAAAAAAAQAAAAAAAAAAAAAAAAAAAAAAAAAAAAAAAAAAAAAAAAAAAAAAAAAAAAEAAAAAQAEAAAAAAAAIAAAAMTQ4NzgzLjAtAQAAeyJ3YXNfZmlyc3RfZXZlbnQiOnRydWUsImltYWdlX2lkIjpbMjM1NDc4MTczLDE0MjY2MzQzNDAsMTcyNDQzNDY5NCwxMjY5MTUxMjM1LDIyOTk2ODc1MDksMzMzMzc3MDAzOSwzNzYxMTYwMDkzLDQwMDU0NTgzNzZdLCJxZiI6eyJiIjpbMCwwLDAsMCwwLDAsMCwwLDAsMCwwLDAsMCwwLDAsMCwwLDAsMCwwLDAsMCwwLDAsMCwwLDAsMCwwLDAsMCwwLDAsMCwwLDAsMCwwLDAsMCwwLDAsMCwwLDAsMCwwLDAsMCwwLDAsMCwwLDAsMCwwLDAsMCwwLDAsMCwwLDAsMCwwLDAsMCwwLDAsMCwwLDAsMF0sImwiOjAsInEiOjYsInIiOjd9fQAAAAAAAAAAAAAAAAAAAEABAAAAAAAACAAAADE0ODc4My4wLQEAAHsid2FzX2ZpcnN0X2V2ZW50Ijp0cnVlLCJpbWFnZV9pZCI6WzIzNTQ3ODE3MywxNDI2NjM0MzQwLDE3MjQ0MzQ2OTQsMTI2OTE1MTIzNSwyMjk5Njg3NTA5LDMzMzM3NzAwMzksMzc2MTE2MDA5Myw0MDA1NDU4Mzc2XSwicWYiOnsiYiI6WzAsMCwwLDAsMCwwLDAsMCwwLDAsMCwwLDAsMCwwLDAsMCwwLDAsMCwwLDAsMCwwLDAsMCwwLDAsMCwwLDAsMCwwLDAsMCwwLDAsMCwwLDAsMCwwLDAsMCwwLDAsMCwwLDAsMCwwLDAsMCwwLDAsMCwwLDAsMCwwLDAsMCwwLDAsMCwwLDAsMCwwLDAsMCwwLDBdLCJsIjowLCJxIjo2LCJyIjo3fX0AAAAAAAAAAAAAAAAAAAAAAAAAAAAAAAAAAAAAAAAAAAAAAA=='}}
prove_61;29;18;Mul;522;149305;149305.0;841;0.0658279159997619;{'verificationValue': 149305.0, 'proof': {'imageId': [235478173, 1426634340, 1724434694, 1269151235, 2299687509, 3333770039, 3761160093, 4005458376], 'receipt': 'AwAAAAAAAAAAAAAAmL4gACyGqXD9SCTqBr57Fe21xvS89IksDAnB7FD2cs3kOUscAAAAAAAAAAAAAAAAAAAAAAAAAAAAAAAAAAAAAAAAAAAAAAAAAAAAAAAAAAAAAAAAAQAAAAAAAAAAAAAAAAAAAAAAAAAAAAAAAAAAAAAAAAAAAAAAAAAAAAEAAAAAQAEAAAAAAAAIAAAAMTQ5MzA1LjAtAQAAeyJ3YXNfZmlyc3RfZXZlbnQiOnRydWUsImltYWdlX2lkIjpbMjM1NDc4MTczLDE0MjY2MzQzNDAsMTcyNDQzNDY5NCwxMjY5MTUxMjM1LDIyOTk2ODc1MDksMzMzMzc3MDAzOSwzNzYxMTYwMDkzLDQwMDU0NTgzNzZdLCJxZiI6eyJiIjpbMCwwLDAsMCwwLDAsMCwwLDAsMCwwLDAsMCwwLDAsMCwwLDAsMCwwLDAsMCwwLDAsMCwwLDAsMCwwLDAsMCwwLDAsMCwwLDAsMCwwLDAsMCwwLDAsMCwwLDAsMCwwLDAsMCwwLDAsMCwwLDAsMCwwLDAsMCwwLDAsMCwwLDAsMCwwLDAsMCwwLDAsMCwwLDAsMF0sImwiOjAsInEiOjYsInIiOjd9fQAAAAAAAAAAAAAAAAAAAEABAAAAAAAACAAAADE0OTMwNS4wLQEAAHsid2FzX2ZpcnN0X2V2ZW50Ijp0cnVlLCJpbWFnZV9pZCI6WzIzNTQ3ODE3MywxNDI2NjM0MzQwLDE3MjQ0MzQ2OTQsMTI2OTE1MTIzNSwyMjk5Njg3NTA5LDMzMzM3NzAwMzksMzc2MTE2MDA5Myw0MDA1NDU4Mzc2XSwicWYiOnsiYiI6WzAsMCwwLDAsMCwwLDAsMCwwLDAsMCwwLDAsMCwwLDAsMCwwLDAsMCwwLDAsMCwwLDAsMCwwLDAsMCwwLDAsMCwwLDAsMCwwLDAsMCwwLDAsMCwwLDAsMCwwLDAsMCwwLDAsMCwwLDAsMCwwLDAsMCwwLDAsMCwwLDAsMCwwLDAsMCwwLDAsMCwwLDAsMCwwLDBdLCJsIjowLCJxIjo2LCJyIjo3fX0AAAAAAAAAAAAAAAAAAAAAAAAAAAAAAAAAAAAAAAAAAAAAAA=='}}
prove_62;97;21;Mul;2037;151342;151342.0;841;0.06695025000044552;{'verificationValue': 151342.0, 'proof': {'imageId': [235478173, 1426634340, 1724434694, 1269151235, 2299687509, 3333770039, 3761160093, 4005458376], 'receipt': 'AwAAAAAAAAAAAAAAmL4gACyGqXD9SCTqBr57Fe21xvS89IksDAnB7FD2cs3kOUscAAAAAAAAAAAAAAAAAAAAAAAAAAAAAAAAAAAAAAAAAAAAAAAAAAAAAAAAAAAAAAAAAQAAAAAAAAAAAAAAAAAAAAAAAAAAAAAAAAAAAAAAAAAAAAAAAAAAAAEAAAAAQAEAAAAAAAAIAAAAMTUxMzQyLjAtAQAAeyJ3YXNfZmlyc3RfZXZlbnQiOnRydWUsImltYWdlX2lkIjpbMjM1NDc4MTczLDE0MjY2MzQzNDAsMTcyNDQzNDY5NCwxMjY5MTUxMjM1LDIyOTk2ODc1MDksMzMzMzc3MDAzOSwzNzYxMTYwMDkzLDQwMDU0NTgzNzZdLCJxZiI6eyJiIjpbMCwwLDAsMCwwLDAsMCwwLDAsMCwwLDAsMCwwLDAsMCwwLDAsMCwwLDAsMCwwLDAsMCwwLDAsMCwwLDAsMCwwLDAsMCwwLDAsMCwwLDAsMCwwLDAsMCwwLDAsMCwwLDAsMCwwLDAsMCwwLDAsMCwwLDAsMCwwLDAsMCwwLDAsMCwwLDAsMCwwLDAsMCwwLDAsMF0sImwiOjAsInEiOjYsInIiOjd9fQAAAAAAAAAAAAAAAAAAAEABAAAAAAAACAAAADE1MTM0Mi4wLQEAAHsid2FzX2ZpcnN0X2V2ZW50Ijp0cnVlLCJpbWFnZV9pZCI6WzIzNTQ3ODE3MywxNDI2NjM0MzQwLDE3MjQ0MzQ2OTQsMTI2OTE1MTIzNSwyMjk5Njg3NTA5LDMzMzM3NzAwMzksMzc2MTE2MDA5Myw0MDA1NDU4Mzc2XSwicWYiOnsiYiI6WzAsMCwwLDAsMCwwLDAsMCwwLDAsMCwwLDAsMCwwLDAsMCwwLDAsMCwwLDAsMCwwLDAsMCwwLDAsMCwwLDAsMCwwLDAsMCwwLDAsMCwwLDAsMCwwLDAsMCwwLDAsMCwwLDAsMCwwLDAsMCwwLDAsMCwwLDAsMCwwLDAsMCwwLDAsMCwwLDAsMCwwLDAsMCwwLDBdLCJsIjowLCJxIjo2LCJyIjo3fX0AAAAAAAAAAAAAAAAAAAAAAAAAAAAAAAAAAAAAAAAAAAAAAA=='}}
prove_63;50;76;Mul;3800;155142;155142.0;841;0.06913554099992325;{'verificationValue': 155142.0, 'proof': {'imageId': [235478173, 1426634340, 1724434694, 1269151235, 2299687509, 3333770039, 3761160093, 4005458376], 'receipt': 'AwAAAAAAAAAAAAAAmL4gACyGqXD9SCTqBr57Fe21xvS89IksDAnB7FD2cs3kOUscAAAAAAAAAAAAAAAAAAAAAAAAAAAAAAAAAAAAAAAAAAAAAAAAAAAAAAAAAAAAAAAAAQAAAAAAAAAAAAAAAAAAAAAAAAAAAAAAAAAAAAAAAAAAAAAAAAAAAAEAAAAAQAEAAAAAAAAIAAAAMTU1MTQyLjAtAQAAeyJ3YXNfZmlyc3RfZXZlbnQiOnRydWUsImltYWdlX2lkIjpbMjM1NDc4MTczLDE0MjY2MzQzNDAsMTcyNDQzNDY5NCwxMjY5MTUxMjM1LDIyOTk2ODc1MDksMzMzMzc3MDAzOSwzNzYxMTYwMDkzLDQwMDU0NTgzNzZdLCJxZiI6eyJiIjpbMCwwLDAsMCwwLDAsMCwwLDAsMCwwLDAsMCwwLDAsMCwwLDAsMCwwLDAsMCwwLDAsMCwwLDAsMCwwLDAsMCwwLDAsMCwwLDAsMCwwLDAsMCwwLDAsMCwwLDAsMCwwLDAsMCwwLDAsMCwwLDAsMCwwLDAsMCwwLDAsMCwwLDAsMCwwLDAsMCwwLDAsMCwwLDAsMF0sImwiOjAsInEiOjYsInIiOjd9fQAAAAAAAAAAAAAAAAAAAEABAAAAAAAACAAAADE1NTE0Mi4wLQEAAHsid2FzX2ZpcnN0X2V2ZW50Ijp0cnVlLCJpbWFnZV9pZCI6WzIzNTQ3ODE3MywxNDI2NjM0MzQwLDE3MjQ0MzQ2OTQsMTI2OTE1MTIzNSwyMjk5Njg3NTA5LDMzMzM3NzAwMzksMzc2MTE2MDA5Myw0MDA1NDU4Mzc2XSwicWYiOnsiYiI6WzAsMCwwLDAsMCwwLDAsMCwwLDAsMCwwLDAsMCwwLDAsMCwwLDAsMCwwLDAsMCwwLDAsMCwwLDAsMCwwLDAsMCwwLDAsMCwwLDAsMCwwLDAsMCwwLDAsMCwwLDAsMCwwLDAsMCwwLDAsMCwwLDAsMCwwLDAsMCwwLDAsMCwwLDAsMCwwLDAsMCwwLDAsMCwwLDBdLCJsIjowLCJxIjo2LCJyIjo3fX0AAAAAAAAAAAAAAAAAAAAAAAAAAAAAAAAAAAAAAAAAAAAAAA=='}}
prove_64;6;22;Mul;132;155274;155274.0;841;0.06726458299999649;{'verificationValue': 155274.0, 'proof': {'imageId': [235478173, 1426634340, 1724434694, 1269151235, 2299687509, 3333770039, 3761160093, 4005458376], 'receipt': 'AwAAAAAAAAAAAAAAmL4gACyGqXD9SCTqBr57Fe21xvS89IksDAnB7FD2cs3kOUscAAAAAAAAAAAAAAAAAAAAAAAAAAAAAAAAAAAAAAAAAAAAAAAAAAAAAAAAAAAAAAAAAQAAAAAAAAAAAAAAAAAAAAAAAAAAAAAAAAAAAAAAAAAAAAAAAAAAAAEAAAAAQAEAAAAAAAAIAAAAMTU1Mjc0LjAtAQAAeyJ3YXNfZmlyc3RfZXZlbnQiOnRydWUsImltYWdlX2lkIjpbMjM1NDc4MTczLDE0MjY2MzQzNDAsMTcyNDQzNDY5NCwxMjY5MTUxMjM1LDIyOTk2ODc1MDksMzMzMzc3MDAzOSwzNzYxMTYwMDkzLDQwMDU0NTgzNzZdLCJxZiI6eyJiIjpbMCwwLDAsMCwwLDAsMCwwLDAsMCwwLDAsMCwwLDAsMCwwLDAsMCwwLDAsMCwwLDAsMCwwLDAsMCwwLDAsMCwwLDAsMCwwLDAsMCwwLDAsMCwwLDAsMCwwLDAsMCwwLDAsMCwwLDAsMCwwLDAsMCwwLDAsMCwwLDAsMCwwLDAsMCwwLDAsMCwwLDAsMCwwLDAsMF0sImwiOjAsInEiOjYsInIiOjd9fQAAAAAAAAAAAAAAAAAAAEABAAAAAAAACAAAADE1NTI3NC4wLQEAAHsid2FzX2ZpcnN0X2V2ZW50Ijp0cnVlLCJpbWFnZV9pZCI6WzIzNTQ3ODE3MywxNDI2NjM0MzQwLDE3MjQ0MzQ2OTQsMTI2OTE1MTIzNSwyMjk5Njg3NTA5LDMzMzM3NzAwMzksMzc2MTE2MDA5Myw0MDA1NDU4Mzc2XSwicWYiOnsiYiI6WzAsMCwwLDAsMCwwLDAsMCwwLDAsMCwwLDAsMCwwLDAsMCwwLDAsMCwwLDAsMCwwLDAsMCwwLDAsMCwwLDAsMCwwLDAsMCwwLDAsMCwwLDAsMCwwLDAsMCwwLDAsMCwwLDAsMCwwLDAsMCwwLDAsMCwwLDAsMCwwLDAsMCwwLDAsMCwwLDAsMCwwLDAsMCwwLDBdLCJsIjowLCJxIjo2LCJyIjo3fX0AAAAAAAAAAAAAAAAAAAAAAAAAAAAAAAAAAAAAAAAAAAAAAA=='}}
prove_65;32;93;Mul;2976;158250;158250.0;841;0.06700870799977565;{'verificationValue': 158250.0, 'proof': {'imageId': [235478173, 1426634340, 1724434694, 1269151235, 2299687509, 3333770039, 3761160093, 4005458376], 'receipt': 'AwAAAAAAAAAAAAAAmL4gACyGqXD9SCTqBr57Fe21xvS89IksDAnB7FD2cs3kOUscAAAAAAAAAAAAAAAAAAAAAAAAAAAAAAAAAAAAAAAAAAAAAAAAAAAAAAAAAAAAAAAAAQAAAAAAAAAAAAAAAAAAAAAAAAAAAAAAAAAAAAAAAAAAAAAAAAAAAAEAAAAAQAEAAAAAAAAIAAAAMTU4MjUwLjAtAQAAeyJ3YXNfZmlyc3RfZXZlbnQiOnRydWUsImltYWdlX2lkIjpbMjM1NDc4MTczLDE0MjY2MzQzNDAsMTcyNDQzNDY5NCwxMjY5MTUxMjM1LDIyOTk2ODc1MDksMzMzMzc3MDAzOSwzNzYxMTYwMDkzLDQwMDU0NTgzNzZdLCJxZiI6eyJiIjpbMCwwLDAsMCwwLDAsMCwwLDAsMCwwLDAsMCwwLDAsMCwwLDAsMCwwLDAsMCwwLDAsMCwwLDAsMCwwLDAsMCwwLDAsMCwwLDAsMCwwLDAsMCwwLDAsMCwwLDAsMCwwLDAsMCwwLDAsMCwwLDAsMCwwLDAsMCwwLDAsMCwwLDAsMCwwLDAsMCwwLDAsMCwwLDAsMF0sImwiOjAsInEiOjYsInIiOjd9fQAAAAAAAAAAAAAAAAAAAEABAAAAAAAACAAAADE1ODI1MC4wLQEAAHsid2FzX2ZpcnN0X2V2ZW50Ijp0cnVlLCJpbWFnZV9pZCI6WzIzNTQ3ODE3MywxNDI2NjM0MzQwLDE3MjQ0MzQ2OTQsMTI2OTE1MTIzNSwyMjk5Njg3NTA5LDMzMzM3NzAwMzksMzc2MTE2MDA5Myw0MDA1NDU4Mzc2XSwicWYiOnsiYiI6WzAsMCwwLDAsMCwwLDAsMCwwLDAsMCwwLDAsMCwwLDAsMCwwLDAsMCwwLDAsMCwwLDAsMCwwLDAsMCwwLDAsMCwwLDAsMCwwLDAsMCwwLDAsMCwwLDAsMCwwLDAsMCwwLDAsMCwwLDAsMCwwLDAsMCwwLDAsMCwwLDAsMCwwLDAsMCwwLDAsMCwwLDAsMCwwLDBdLCJsIjowLCJxIjo2LCJyIjo3fX0AAAAAAAAAAAAAAAAAAAAAAAAAAAAAAAAAAAAAAAAAAAAAAA=='}}
prove_66;43;99;Mul;4257;162507;162507.0;841;0.06741833299929567;{'verificationValue': 162507.0, 'proof': {'imageId': [235478173, 1426634340, 1724434694, 1269151235, 2299687509, 3333770039, 3761160093, 4005458376], 'receipt': 'AwAAAAAAAAAAAAAAmL4gACyGqXD9SCTqBr57Fe21xvS89IksDAnB7FD2cs3kOUscAAAAAAAAAAAAAAAAAAAAAAAAAAAAAAAAAAAAAAAAAAAAAAAAAAAAAAAAAAAAAAAAAQAAAAAAAAAAAAAAAAAAAAAAAAAAAAAAAAAAAAAAAAAAAAAAAAAAAAEAAAAAQAEAAAAAAAAIAAAAMTYyNTA3LjAtAQAAeyJ3YXNfZmlyc3RfZXZlbnQiOnRydWUsImltYWdlX2lkIjpbMjM1NDc4MTczLDE0MjY2MzQzNDAsMTcyNDQzNDY5NCwxMjY5MTUxMjM1LDIyOTk2ODc1MDksMzMzMzc3MDAzOSwzNzYxMTYwMDkzLDQwMDU0NTgzNzZdLCJxZiI6eyJiIjpbMCwwLDAsMCwwLDAsMCwwLDAsMCwwLDAsMCwwLDAsMCwwLDAsMCwwLDAsMCwwLDAsMCwwLDAsMCwwLDAsMCwwLDAsMCwwLDAsMCwwLDAsMCwwLDAsMCwwLDAsMCwwLDAsMCwwLDAsMCwwLDAsMCwwLDAsMCwwLDAsMCwwLDAsMCwwLDAsMCwwLDAsMCwwLDAsMF0sImwiOjAsInEiOjYsInIiOjd9fQAAAAAAAAAAAAAAAAAAAEABAAAAAAAACAAAADE2MjUwNy4wLQEAAHsid2FzX2ZpcnN0X2V2ZW50Ijp0cnVlLCJpbWFnZV9pZCI6WzIzNTQ3ODE3MywxNDI2NjM0MzQwLDE3MjQ0MzQ2OTQsMTI2OTE1MTIzNSwyMjk5Njg3NTA5LDMzMzM3NzAwMzksMzc2MTE2MDA5Myw0MDA1NDU4Mzc2XSwicWYiOnsiYiI6WzAsMCwwLDAsMCwwLDAsMCwwLDAsMCwwLDAsMCwwLDAsMCwwLDAsMCwwLDAsMCwwLDAsMCwwLDAsMCwwLDAsMCwwLDAsMCwwLDAsMCwwLDAsMCwwLDAsMCwwLDAsMCwwLDAsMCwwLDAsMCwwLDAsMCwwLDAsMCwwLDAsMCwwLDAsMCwwLDAsMCwwLDAsMCwwLDBdLCJsIjowLCJxIjo2LCJyIjo3fX0AAAAAAAAAAAAAAAAAAAAAAAAAAAAAAAAAAAAAAAAAAAAAAA=='}}
prove_67;34;79;Mul;2686;165193;165193.0;841;0.0672869999998511;{'verificationValue': 165193.0, 'proof': {'imageId': [235478173, 1426634340, 1724434694, 1269151235, 2299687509, 3333770039, 3761160093, 4005458376], 'receipt': 'AwAAAAAAAAAAAAAAmL4gACyGqXD9SCTqBr57Fe21xvS89IksDAnB7FD2cs3kOUscAAAAAAAAAAAAAAAAAAAAAAAAAAAAAAAAAAAAAAAAAAAAAAAAAAAAAAAAAAAAAAAAAQAAAAAAAAAAAAAAAAAAAAAAAAAAAAAAAAAAAAAAAAAAAAAAAAAAAAEAAAAAQAEAAAAAAAAIAAAAMTY1MTkzLjAtAQAAeyJ3YXNfZmlyc3RfZXZlbnQiOnRydWUsImltYWdlX2lkIjpbMjM1NDc4MTczLDE0MjY2MzQzNDAsMTcyNDQzNDY5NCwxMjY5MTUxMjM1LDIyOTk2ODc1MDksMzMzMzc3MDAzOSwzNzYxMTYwMDkzLDQwMDU0NTgzNzZdLCJxZiI6eyJiIjpbMCwwLDAsMCwwLDAsMCwwLDAsMCwwLDAsMCwwLDAsMCwwLDAsMCwwLDAsMCwwLDAsMCwwLDAsMCwwLDAsMCwwLDAsMCwwLDAsMCwwLDAsMCwwLDAsMCwwLDAsMCwwLDAsMCwwLDAsMCwwLDAsMCwwLDAsMCwwLDAsMCwwLDAsMCwwLDAsMCwwLDAsMCwwLDAsMF0sImwiOjAsInEiOjYsInIiOjd9fQAAAAAAAAAAAAAAAAAAAEABAAAAAAAACAAAADE2NTE5My4wLQEAAHsid2FzX2ZpcnN0X2V2ZW50Ijp0cnVlLCJpbWFnZV9pZCI6WzIzNTQ3ODE3MywxNDI2NjM0MzQwLDE3MjQ0MzQ2OTQsMTI2OTE1MTIzNSwyMjk5Njg3NTA5LDMzMzM3NzAwMzksMzc2MTE2MDA5Myw0MDA1NDU4Mzc2XSwicWYiOnsiYiI6WzAsMCwwLDAsMCwwLDAsMCwwLDAsMCwwLDAsMCwwLDAsMCwwLDAsMCwwLDAsMCwwLDAsMCwwLDAsMCwwLDAsMCwwLDAsMCwwLDAsMCwwLDAsMCwwLDAsMCwwLDAsMCwwLDAsMCwwLDAsMCwwLDAsMCwwLDAsMCwwLDAsMCwwLDAsMCwwLDAsMCwwLDAsMCwwLDBdLCJsIjowLCJxIjo2LCJyIjo3fX0AAAAAAAAAAAAAAAAAAAAAAAAAAAAAAAAAAAAAAAAAAAAAAA=='}}
prove_68;71;32;Mul;2272;167465;167465.0;841;0.06694045800031745;{'verificationValue': 167465.0, 'proof': {'imageId': [235478173, 1426634340, 1724434694, 1269151235, 2299687509, 3333770039, 3761160093, 4005458376], 'receipt': 'AwAAAAAAAAAAAAAAmL4gACyGqXD9SCTqBr57Fe21xvS89IksDAnB7FD2cs3kOUscAAAAAAAAAAAAAAAAAAAAAAAAAAAAAAAAAAAAAAAAAAAAAAAAAAAAAAAAAAAAAAAAAQAAAAAAAAAAAAAAAAAAAAAAAAAAAAAAAAAAAAAAAAAAAAAAAAAAAAEAAAAAQAEAAAAAAAAIAAAAMTY3NDY1LjAtAQAAeyJ3YXNfZmlyc3RfZXZlbnQiOnRydWUsImltYWdlX2lkIjpbMjM1NDc4MTczLDE0MjY2MzQzNDAsMTcyNDQzNDY5NCwxMjY5MTUxMjM1LDIyOTk2ODc1MDksMzMzMzc3MDAzOSwzNzYxMTYwMDkzLDQwMDU0NTgzNzZdLCJxZiI6eyJiIjpbMCwwLDAsMCwwLDAsMCwwLDAsMCwwLDAsMCwwLDAsMCwwLDAsMCwwLDAsMCwwLDAsMCwwLDAsMCwwLDAsMCwwLDAsMCwwLDAsMCwwLDAsMCwwLDAsMCwwLDAsMCwwLDAsMCwwLDAsMCwwLDAsMCwwLDAsMCwwLDAsMCwwLDAsMCwwLDAsMCwwLDAsMCwwLDAsMF0sImwiOjAsInEiOjYsInIiOjd9fQAAAAAAAAAAAAAAAAAAAEABAAAAAAAACAAAADE2NzQ2NS4wLQEAAHsid2FzX2ZpcnN0X2V2ZW50Ijp0cnVlLCJpbWFnZV9pZCI6WzIzNTQ3ODE3MywxNDI2NjM0MzQwLDE3MjQ0MzQ2OTQsMTI2OTE1MTIzNSwyMjk5Njg3NTA5LDMzMzM3NzAwMzksMzc2MTE2MDA5Myw0MDA1NDU4Mzc2XSwicWYiOnsiYiI6WzAsMCwwLDAsMCwwLDAsMCwwLDAsMCwwLDAsMCwwLDAsMCwwLDAsMCwwLDAsMCwwLDAsMCwwLDAsMCwwLDAsMCwwLDAsMCwwLDAsMCwwLDAsMCwwLDAsMCwwLDAsMCwwLDAsMCwwLDAsMCwwLDAsMCwwLDAsMCwwLDAsMCwwLDAsMCwwLDAsMCwwLDAsMCwwLDBdLCJsIjowLCJxIjo2LCJyIjo3fX0AAAAAAAAAAAAAAAAAAAAAAAAAAAAAAAAAAAAAAAAAAAAAAA=='}}
prove_69;94;15;Mul;1410;168875;168875.0;841;0.0661862500001007;{'verificationValue': 168875.0, 'proof': {'imageId': [235478173, 1426634340, 1724434694, 1269151235, 2299687509, 3333770039, 3761160093, 4005458376], 'receipt': 'AwAAAAAAAAAAAAAAmL4gACyGqXD9SCTqBr57Fe21xvS89IksDAnB7FD2cs3kOUscAAAAAAAAAAAAAAAAAAAAAAAAAAAAAAAAAAAAAAAAAAAAAAAAAAAAAAAAAAAAAAAAAQAAAAAAAAAAAAAAAAAAAAAAAAAAAAAAAAAAAAAAAAAAAAAAAAAAAAEAAAAAQAEAAAAAAAAIAAAAMTY4ODc1LjAtAQAAeyJ3YXNfZmlyc3RfZXZlbnQiOnRydWUsImltYWdlX2lkIjpbMjM1NDc4MTczLDE0MjY2MzQzNDAsMTcyNDQzNDY5NCwxMjY5MTUxMjM1LDIyOTk2ODc1MDksMzMzMzc3MDAzOSwzNzYxMTYwMDkzLDQwMDU0NTgzNzZdLCJxZiI6eyJiIjpbMCwwLDAsMCwwLDAsMCwwLDAsMCwwLDAsMCwwLDAsMCwwLDAsMCwwLDAsMCwwLDAsMCwwLDAsMCwwLDAsMCwwLDAsMCwwLDAsMCwwLDAsMCwwLDAsMCwwLDAsMCwwLDAsMCwwLDAsMCwwLDAsMCwwLDAsMCwwLDAsMCwwLDAsMCwwLDAsMCwwLDAsMCwwLDAsMF0sImwiOjAsInEiOjYsInIiOjd9fQAAAAAAAAAAAAAAAAAAAEABAAAAAAAACAAAADE2ODg3NS4wLQEAAHsid2FzX2ZpcnN0X2V2ZW50Ijp0cnVlLCJpbWFnZV9pZCI6WzIzNTQ3ODE3MywxNDI2NjM0MzQwLDE3MjQ0MzQ2OTQsMTI2OTE1MTIzNSwyMjk5Njg3NTA5LDMzMzM3NzAwMzksMzc2MTE2MDA5Myw0MDA1NDU4Mzc2XSwicWYiOnsiYiI6WzAsMCwwLDAsMCwwLDAsMCwwLDAsMCwwLDAsMCwwLDAsMCwwLDAsMCwwLDAsMCwwLDAsMCwwLDAsMCwwLDAsMCwwLDAsMCwwLDAsMCwwLDAsMCwwLDAsMCwwLDAsMCwwLDAsMCwwLDAsMCwwLDAsMCwwLDAsMCwwLDAsMCwwLDAsMCwwLDAsMCwwLDAsMCwwLDBdLCJsIjowLCJxIjo2LCJyIjo3fX0AAAAAAAAAAAAAAAAAAAAAAAAAAAAAAAAAAAAAAAAAAAAAAA=='}}
prove_70;21;59;Mul;1239;170114;170114.0;841;0.06779999999889696;{'verificationValue': 170114.0, 'proof': {'imageId': [235478173, 1426634340, 1724434694, 1269151235, 2299687509, 3333770039, 3761160093, 4005458376], 'receipt': 'AwAAAAAAAAAAAAAAmL4gACyGqXD9SCTqBr57Fe21xvS89IksDAnB7FD2cs3kOUscAAAAAAAAAAAAAAAAAAAAAAAAAAAAAAAAAAAAAAAAAAAAAAAAAAAAAAAAAAAAAAAAAQAAAAAAAAAAAAAAAAAAAAAAAAAAAAAAAAAAAAAAAAAAAAAAAAAAAAEAAAAAQAEAAAAAAAAIAAAAMTcwMTE0LjAtAQAAeyJ3YXNfZmlyc3RfZXZlbnQiOnRydWUsImltYWdlX2lkIjpbMjM1NDc4MTczLDE0MjY2MzQzNDAsMTcyNDQzNDY5NCwxMjY5MTUxMjM1LDIyOTk2ODc1MDksMzMzMzc3MDAzOSwzNzYxMTYwMDkzLDQwMDU0NTgzNzZdLCJxZiI6eyJiIjpbMCwwLDAsMCwwLDAsMCwwLDAsMCwwLDAsMCwwLDAsMCwwLDAsMCwwLDAsMCwwLDAsMCwwLDAsMCwwLDAsMCwwLDAsMCwwLDAsMCwwLDAsMCwwLDAsMCwwLDAsMCwwLDAsMCwwLDAsMCwwLDAsMCwwLDAsMCwwLDAsMCwwLDAsMCwwLDAsMCwwLDAsMCwwLDAsMF0sImwiOjAsInEiOjYsInIiOjd9fQAAAAAAAAAAAAAAAAAAAEABAAAAAAAACAAAADE3MDExNC4wLQEAAHsid2FzX2ZpcnN0X2V2ZW50Ijp0cnVlLCJpbWFnZV9pZCI6WzIzNTQ3ODE3MywxNDI2NjM0MzQwLDE3MjQ0MzQ2OTQsMTI2OTE1MTIzNSwyMjk5Njg3NTA5LDMzMzM3NzAwMzksMzc2MTE2MDA5Myw0MDA1NDU4Mzc2XSwicWYiOnsiYiI6WzAsMCwwLDAsMCwwLDAsMCwwLDAsMCwwLDAsMCwwLDAsMCwwLDAsMCwwLDAsMCwwLDAsMCwwLDAsMCwwLDAsMCwwLDAsMCwwLDAsMCwwLDAsMCwwLDAsMCwwLDAsMCwwLDAsMCwwLDAsMCwwLDAsMCwwLDAsMCwwLDAsMCwwLDAsMCwwLDAsMCwwLDAsMCwwLDBdLCJsIjowLCJxIjo2LCJyIjo3fX0AAAAAAAAAAAAAAAAAAAAAAAAAAAAAAAAAAAAAAAAAAAAAAA=='}}
prove_71;99;52;Mul;5148;175262;175262.0;841;0.06707450000067183;{'verificationValue': 175262.0, 'proof': {'imageId': [235478173, 1426634340, 1724434694, 1269151235, 2299687509, 3333770039, 3761160093, 4005458376], 'receipt': 'AwAAAAAAAAAAAAAAmL4gACyGqXD9SCTqBr57Fe21xvS89IksDAnB7FD2cs3kOUscAAAAAAAAAAAAAAAAAAAAAAAAAAAAAAAAAAAAAAAAAAAAAAAAAAAAAAAAAAAAAAAAAQAAAAAAAAAAAAAAAAAAAAAAAAAAAAAAAAAAAAAAAAAAAAAAAAAAAAEAAAAAQAEAAAAAAAAIAAAAMTc1MjYyLjAtAQAAeyJ3YXNfZmlyc3RfZXZlbnQiOnRydWUsImltYWdlX2lkIjpbMjM1NDc4MTczLDE0MjY2MzQzNDAsMTcyNDQzNDY5NCwxMjY5MTUxMjM1LDIyOTk2ODc1MDksMzMzMzc3MDAzOSwzNzYxMTYwMDkzLDQwMDU0NTgzNzZdLCJxZiI6eyJiIjpbMCwwLDAsMCwwLDAsMCwwLDAsMCwwLDAsMCwwLDAsMCwwLDAsMCwwLDAsMCwwLDAsMCwwLDAsMCwwLDAsMCwwLDAsMCwwLDAsMCwwLDAsMCwwLDAsMCwwLDAsMCwwLDAsMCwwLDAsMCwwLDAsMCwwLDAsMCwwLDAsMCwwLDAsMCwwLDAsMCwwLDAsMCwwLDAsMF0sImwiOjAsInEiOjYsInIiOjd9fQAAAAAAAAAAAAAAAAAAAEABAAAAAAAACAAAADE3NTI2Mi4wLQEAAHsid2FzX2ZpcnN0X2V2ZW50Ijp0cnVlLCJpbWFnZV9pZCI6WzIzNTQ3ODE3MywxNDI2NjM0MzQwLDE3MjQ0MzQ2OTQsMTI2OTE1MTIzNSwyMjk5Njg3NTA5LDMzMzM3NzAwMzksMzc2MTE2MDA5Myw0MDA1NDU4Mzc2XSwicWYiOnsiYiI6WzAsMCwwLDAsMCwwLDAsMCwwLDAsMCwwLDAsMCwwLDAsMCwwLDAsMCwwLDAsMCwwLDAsMCwwLDAsMCwwLDAsMCwwLDAsMCwwLDAsMCwwLDAsMCwwLDAsMCwwLDAsMCwwLDAsMCwwLDAsMCwwLDAsMCwwLDAsMCwwLDAsMCwwLDAsMCwwLDAsMCwwLDAsMCwwLDBdLCJsIjowLCJxIjo2LCJyIjo3fX0AAAAAAAAAAAAAAAAAAAAAAAAAAAAAAAAAAAAAAAAAAAAAAA=='}}
prove_72;73;74;Mul;5402;180664;180664.0;841;0.06801958300093247;{'verificationValue': 180664.0, 'proof': {'imageId': [235478173, 1426634340, 1724434694, 1269151235, 2299687509, 3333770039, 3761160093, 4005458376], 'receipt': 'AwAAAAAAAAAAAAAAmL4gACyGqXD9SCTqBr57Fe21xvS89IksDAnB7FD2cs3kOUscAAAAAAAAAAAAAAAAAAAAAAAAAAAAAAAAAAAAAAAAAAAAAAAAAAAAAAAAAAAAAAAAAQAAAAAAAAAAAAAAAAAAAAAAAAAAAAAAAAAAAAAAAAAAAAAAAAAAAAEAAAAAQAEAAAAAAAAIAAAAMTgwNjY0LjAtAQAAeyJ3YXNfZmlyc3RfZXZlbnQiOnRydWUsImltYWdlX2lkIjpbMjM1NDc4MTczLDE0MjY2MzQzNDAsMTcyNDQzNDY5NCwxMjY5MTUxMjM1LDIyOTk2ODc1MDksMzMzMzc3MDAzOSwzNzYxMTYwMDkzLDQwMDU0NTgzNzZdLCJxZiI6eyJiIjpbMCwwLDAsMCwwLDAsMCwwLDAsMCwwLDAsMCwwLDAsMCwwLDAsMCwwLDAsMCwwLDAsMCwwLDAsMCwwLDAsMCwwLDAsMCwwLDAsMCwwLDAsMCwwLDAsMCwwLDAsMCwwLDAsMCwwLDAsMCwwLDAsMCwwLDAsMCwwLDAsMCwwLDAsMCwwLDAsMCwwLDAsMCwwLDAsMF0sImwiOjAsInEiOjYsInIiOjd9fQAAAAAAAAAAAAAAAAAAAEABAAAAAAAACAAAADE4MDY2NC4wLQEAAHsid2FzX2ZpcnN0X2V2ZW50Ijp0cnVlLCJpbWFnZV9pZCI6WzIzNTQ3ODE3MywxNDI2NjM0MzQwLDE3MjQ0MzQ2OTQsMTI2OTE1MTIzNSwyMjk5Njg3NTA5LDMzMzM3NzAwMzksMzc2MTE2MDA5Myw0MDA1NDU4Mzc2XSwicWYiOnsiYiI6WzAsMCwwLDAsMCwwLDAsMCwwLDAsMCwwLDAsMCwwLDAsMCwwLDAsMCwwLDAsMCwwLDAsMCwwLDAsMCwwLDAsMCwwLDAsMCwwLDAsMCwwLDAsMCwwLDAsMCwwLDAsMCwwLDAsMCwwLDAsMCwwLDAsMCwwLDAsMCwwLDAsMCwwLDAsMCwwLDAsMCwwLDAsMCwwLDBdLCJsIjowLCJxIjo2LCJyIjo3fX0AAAAAAAAAAAAAAAAAAAAAAAAAAAAAAAAAAAAAAAAAAAAAAA=='}}
prove_73;48;3;Mul;144;180808;180808.0;841;0.06708341699959419;{'verificationValue': 180808.0, 'proof': {'imageId': [235478173, 1426634340, 1724434694, 1269151235, 2299687509, 3333770039, 3761160093, 4005458376], 'receipt': 'AwAAAAAAAAAAAAAAmL4gACyGqXD9SCTqBr57Fe21xvS89IksDAnB7FD2cs3kOUscAAAAAAAAAAAAAAAAAAAAAAAAAAAAAAAAAAAAAAAAAAAAAAAAAAAAAAAAAAAAAAAAAQAAAAAAAAAAAAAAAAAAAAAAAAAAAAAAAAAAAAAAAAAAAAAAAAAAAAEAAAAAQAEAAAAAAAAIAAAAMTgwODA4LjAtAQAAeyJ3YXNfZmlyc3RfZXZlbnQiOnRydWUsImltYWdlX2lkIjpbMjM1NDc4MTczLDE0MjY2MzQzNDAsMTcyNDQzNDY5NCwxMjY5MTUxMjM1LDIyOTk2ODc1MDksMzMzMzc3MDAzOSwzNzYxMTYwMDkzLDQwMDU0NTgzNzZdLCJxZiI6eyJiIjpbMCwwLDAsMCwwLDAsMCwwLDAsMCwwLDAsMCwwLDAsMCwwLDAsMCwwLDAsMCwwLDAsMCwwLDAsMCwwLDAsMCwwLDAsMCwwLDAsMCwwLDAsMCwwLDAsMCwwLDAsMCwwLDAsMCwwLDAsMCwwLDAsMCwwLDAsMCwwLDAsMCwwLDAsMCwwLDAsMCwwLDAsMCwwLDAsMF0sImwiOjAsInEiOjYsInIiOjd9fQAAAAAAAAAAAAAAAAAAAEABAAAAAAAACAAAADE4MDgwOC4wLQEAAHsid2FzX2ZpcnN0X2V2ZW50Ijp0cnVlLCJpbWFnZV9pZCI6WzIzNTQ3ODE3MywxNDI2NjM0MzQwLDE3MjQ0MzQ2OTQsMTI2OTE1MTIzNSwyMjk5Njg3NTA5LDMzMzM3NzAwMzksMzc2MTE2MDA5Myw0MDA1NDU4Mzc2XSwicWYiOnsiYiI6WzAsMCwwLDAsMCwwLDAsMCwwLDAsMCwwLDAsMCwwLDAsMCwwLDAsMCwwLDAsMCwwLDAsMCwwLDAsMCwwLDAsMCwwLDAsMCwwLDAsMCwwLDAsMCwwLDAsMCwwLDAsMCwwLDAsMCwwLDAsMCwwLDAsMCwwLDAsMCwwLDAsMCwwLDAsMCwwLDAsMCwwLDAsMCwwLDBdLCJsIjowLCJxIjo2LCJyIjo3fX0AAAAAAAAAAAAAAAAAAAAAAAAAAAAAAAAAAAAAAAAAAAAAAA=='}}
prove_74;8;29;Mul;232;181040;181040.0;841;0.06765891699978965;{'verificationValue': 181040.0, 'proof': {'imageId': [235478173, 1426634340, 1724434694, 1269151235, 2299687509, 3333770039, 3761160093, 4005458376], 'receipt': 'AwAAAAAAAAAAAAAAmL4gACyGqXD9SCTqBr57Fe21xvS89IksDAnB7FD2cs3kOUscAAAAAAAAAAAAAAAAAAAAAAAAAAAAAAAAAAAAAAAAAAAAAAAAAAAAAAAAAAAAAAAAAQAAAAAAAAAAAAAAAAAAAAAAAAAAAAAAAAAAAAAAAAAAAAAAAAAAAAEAAAAAQAEAAAAAAAAIAAAAMTgxMDQwLjAtAQAAeyJ3YXNfZmlyc3RfZXZlbnQiOnRydWUsImltYWdlX2lkIjpbMjM1NDc4MTczLDE0MjY2MzQzNDAsMTcyNDQzNDY5NCwxMjY5MTUxMjM1LDIyOTk2ODc1MDksMzMzMzc3MDAzOSwzNzYxMTYwMDkzLDQwMDU0NTgzNzZdLCJxZiI6eyJiIjpbMCwwLDAsMCwwLDAsMCwwLDAsMCwwLDAsMCwwLDAsMCwwLDAsMCwwLDAsMCwwLDAsMCwwLDAsMCwwLDAsMCwwLDAsMCwwLDAsMCwwLDAsMCwwLDAsMCwwLDAsMCwwLDAsMCwwLDAsMCwwLDAsMCwwLDAsMCwwLDAsMCwwLDAsMCwwLDAsMCwwLDAsMCwwLDAsMF0sImwiOjAsInEiOjYsInIiOjd9fQAAAAAAAAAAAAAAAAAAAEABAAAAAAAACAAAADE4MTA0MC4wLQEAAHsid2FzX2ZpcnN0X2V2ZW50Ijp0cnVlLCJpbWFnZV9pZCI6WzIzNTQ3ODE3MywxNDI2NjM0MzQwLDE3MjQ0MzQ2OTQsMTI2OTE1MTIzNSwyMjk5Njg3NTA5LDMzMzM3NzAwMzksMzc2MTE2MDA5Myw0MDA1NDU4Mzc2XSwicWYiOnsiYiI6WzAsMCwwLDAsMCwwLDAsMCwwLDAsMCwwLDAsMCwwLDAsMCwwLDAsMCwwLDAsMCwwLDAsMCwwLDAsMCwwLDAsMCwwLDAsMCwwLDAsMCwwLDAsMCwwLDAsMCwwLDAsMCwwLDAsMCwwLDAsMCwwLDAsMCwwLDAsMCwwLDAsMCwwLDAsMCwwLDAsMCwwLDAsMCwwLDBdLCJsIjowLCJxIjo2LCJyIjo3fX0AAAAAAAAAAAAAAAAAAAAAAAAAAAAAAAAAAAAAAAAAAAAAAA=='}}
prove_75;15;77;Mul;1155;182195;182195.0;841;0.06806879099895013;{'verificationValue': 182195.0, 'proof': {'imageId': [235478173, 1426634340, 1724434694, 1269151235, 2299687509, 3333770039, 3761160093, 4005458376], 'receipt': 'AwAAAAAAAAAAAAAAmL4gACyGqXD9SCTqBr57Fe21xvS89IksDAnB7FD2cs3kOUscAAAAAAAAAAAAAAAAAAAAAAAAAAAAAAAAAAAAAAAAAAAAAAAAAAAAAAAAAAAAAAAAAQAAAAAAAAAAAAAAAAAAAAAAAAAAAAAAAAAAAAAAAAAAAAAAAAAAAAEAAAAAQAEAAAAAAAAIAAAAMTgyMTk1LjAtAQAAeyJ3YXNfZmlyc3RfZXZlbnQiOnRydWUsImltYWdlX2lkIjpbMjM1NDc4MTczLDE0MjY2MzQzNDAsMTcyNDQzNDY5NCwxMjY5MTUxMjM1LDIyOTk2ODc1MDksMzMzMzc3MDAzOSwzNzYxMTYwMDkzLDQwMDU0NTgzNzZdLCJxZiI6eyJiIjpbMCwwLDAsMCwwLDAsMCwwLDAsMCwwLDAsMCwwLDAsMCwwLDAsMCwwLDAsMCwwLDAsMCwwLDAsMCwwLDAsMCwwLDAsMCwwLDAsMCwwLDAsMCwwLDAsMCwwLDAsMCwwLDAsMCwwLDAsMCwwLDAsMCwwLDAsMCwwLDAsMCwwLDAsMCwwLDAsMCwwLDAsMCwwLDAsMF0sImwiOjAsInEiOjYsInIiOjd9fQAAAAAAAAAAAAAAAAAAAEABAAAAAAAACAAAADE4MjE5NS4wLQEAAHsid2FzX2ZpcnN0X2V2ZW50Ijp0cnVlLCJpbWFnZV9pZCI6WzIzNTQ3ODE3MywxNDI2NjM0MzQwLDE3MjQ0MzQ2OTQsMTI2OTE1MTIzNSwyMjk5Njg3NTA5LDMzMzM3NzAwMzksMzc2MTE2MDA5Myw0MDA1NDU4Mzc2XSwicWYiOnsiYiI6WzAsMCwwLDAsMCwwLDAsMCwwLDAsMCwwLDAsMCwwLDAsMCwwLDAsMCwwLDAsMCwwLDAsMCwwLDAsMCwwLDAsMCwwLDAsMCwwLDAsMCwwLDAsMCwwLDAsMCwwLDAsMCwwLDAsMCwwLDAsMCwwLDAsMCwwLDAsMCwwLDAsMCwwLDAsMCwwLDAsMCwwLDAsMCwwLDBdLCJsIjowLCJxIjo2LCJyIjo3fX0AAAAAAAAAAAAAAAAAAAAAAAAAAAAAAAAAAAAAAAAAAAAAAA=='}}
prove_76;62;68;Mul;4216;186411;186411.0;841;0.0675291660008952;{'verificationValue': 186411.0, 'proof': {'imageId': [235478173, 1426634340, 1724434694, 1269151235, 2299687509, 3333770039, 3761160093, 4005458376], 'receipt': 'AwAAAAAAAAAAAAAAmL4gACyGqXD9SCTqBr57Fe21xvS89IksDAnB7FD2cs3kOUscAAAAAAAAAAAAAAAAAAAAAAAAAAAAAAAAAAAAAAAAAAAAAAAAAAAAAAAAAAAAAAAAAQAAAAAAAAAAAAAAAAAAAAAAAAAAAAAAAAAAAAAAAAAAAAAAAAAAAAEAAAAAQAEAAAAAAAAIAAAAMTg2NDExLjAtAQAAeyJ3YXNfZmlyc3RfZXZlbnQiOnRydWUsImltYWdlX2lkIjpbMjM1NDc4MTczLDE0MjY2MzQzNDAsMTcyNDQzNDY5NCwxMjY5MTUxMjM1LDIyOTk2ODc1MDksMzMzMzc3MDAzOSwzNzYxMTYwMDkzLDQwMDU0NTgzNzZdLCJxZiI6eyJiIjpbMCwwLDAsMCwwLDAsMCwwLDAsMCwwLDAsMCwwLDAsMCwwLDAsMCwwLDAsMCwwLDAsMCwwLDAsMCwwLDAsMCwwLDAsMCwwLDAsMCwwLDAsMCwwLDAsMCwwLDAsMCwwLDAsMCwwLDAsMCwwLDAsMCwwLDAsMCwwLDAsMCwwLDAsMCwwLDAsMCwwLDAsMCwwLDAsMF0sImwiOjAsInEiOjYsInIiOjd9fQAAAAAAAAAAAAAAAAAAAEABAAAAAAAACAAAADE4NjQxMS4wLQEAAHsid2FzX2ZpcnN0X2V2ZW50Ijp0cnVlLCJpbWFnZV9pZCI6WzIzNTQ3ODE3MywxNDI2NjM0MzQwLDE3MjQ0MzQ2OTQsMTI2OTE1MTIzNSwyMjk5Njg3NTA5LDMzMzM3NzAwMzksMzc2MTE2MDA5Myw0MDA1NDU4Mzc2XSwicWYiOnsiYiI6WzAsMCwwLDAsMCwwLDAsMCwwLDAsMCwwLDAsMCwwLDAsMCwwLDAsMCwwLDAsMCwwLDAsMCwwLDAsMCwwLDAsMCwwLDAsMCwwLDAsMCwwLDAsMCwwLDAsMCwwLDAsMCwwLDAsMCwwLDAsMCwwLDAsMCwwLDAsMCwwLDAsMCwwLDAsMCwwLDAsMCwwLDAsMCwwLDBdLCJsIjowLCJxIjo2LCJyIjo3fX0AAAAAAAAAAAAAAAAAAAAAAAAAAAAAAAAAAAAAAAAAAAAAAA=='}}
prove_77;50;68;Mul;3400;189811;189811.0;841;0.06781908300035866;{'verificationValue': 189811.0, 'proof': {'imageId': [235478173, 1426634340, 1724434694, 1269151235, 2299687509, 3333770039, 3761160093, 4005458376], 'receipt': 'AwAAAAAAAAAAAAAAmL4gACyGqXD9SCTqBr57Fe21xvS89IksDAnB7FD2cs3kOUscAAAAAAAAAAAAAAAAAAAAAAAAAAAAAAAAAAAAAAAAAAAAAAAAAAAAAAAAAAAAAAAAAQAAAAAAAAAAAAAAAAAAAAAAAAAAAAAAAAAAAAAAAAAAAAAAAAAAAAEAAAAAQAEAAAAAAAAIAAAAMTg5ODExLjAtAQAAeyJ3YXNfZmlyc3RfZXZlbnQiOnRydWUsImltYWdlX2lkIjpbMjM1NDc4MTczLDE0MjY2MzQzNDAsMTcyNDQzNDY5NCwxMjY5MTUxMjM1LDIyOTk2ODc1MDksMzMzMzc3MDAzOSwzNzYxMTYwMDkzLDQwMDU0NTgzNzZdLCJxZiI6eyJiIjpbMCwwLDAsMCwwLDAsMCwwLDAsMCwwLDAsMCwwLDAsMCwwLDAsMCwwLDAsMCwwLDAsMCwwLDAsMCwwLDAsMCwwLDAsMCwwLDAsMCwwLDAsMCwwLDAsMCwwLDAsMCwwLDAsMCwwLDAsMCwwLDAsMCwwLDAsMCwwLDAsMCwwLDAsMCwwLDAsMCwwLDAsMCwwLDAsMF0sImwiOjAsInEiOjYsInIiOjd9fQAAAAAAAAAAAAAAAAAAAEABAAAAAAAACAAAADE4OTgxMS4wLQEAAHsid2FzX2ZpcnN0X2V2ZW50Ijp0cnVlLCJpbWFnZV9pZCI6WzIzNTQ3ODE3MywxNDI2NjM0MzQwLDE3MjQ0MzQ2OTQsMTI2OTE1MTIzNSwyMjk5Njg3NTA5LDMzMzM3NzAwMzksMzc2MTE2MDA5Myw0MDA1NDU4Mzc2XSwicWYiOnsiYiI6WzAsMCwwLDAsMCwwLDAsMCwwLDAsMCwwLDAsMCwwLDAsMCwwLDAsMCwwLDAsMCwwLDAsMCwwLDAsMCwwLDAsMCwwLDAsMCwwLDAsMCwwLDAsMCwwLDAsMCwwLDAsMCwwLDAsMCwwLDAsMCwwLDAsMCwwLDAsMCwwLDAsMCwwLDAsMCwwLDAsMCwwLDAsMCwwLDBdLCJsIjowLCJxIjo2LCJyIjo3fX0AAAAAAAAAAAAAAAAAAAAAAAAAAAAAAAAAAAAAAAAAAAAAAA=='}}
prove_78;65;77;Mul;5005;194816;194816.0;841;0.06849016600062896;{'verificationValue': 194816.0, 'proof': {'imageId': [235478173, 1426634340, 1724434694, 1269151235, 2299687509, 3333770039, 3761160093, 4005458376], 'receipt': 'AwAAAAAAAAAAAAAAmL4gACyGqXD9SCTqBr57Fe21xvS89IksDAnB7FD2cs3kOUscAAAAAAAAAAAAAAAAAAAAAAAAAAAAAAAAAAAAAAAAAAAAAAAAAAAAAAAAAAAAAAAAAQAAAAAAAAAAAAAAAAAAAAAAAAAAAAAAAAAAAAAAAAAAAAAAAAAAAAEAAAAAQAEAAAAAAAAIAAAAMTk0ODE2LjAtAQAAeyJ3YXNfZmlyc3RfZXZlbnQiOnRydWUsImltYWdlX2lkIjpbMjM1NDc4MTczLDE0MjY2MzQzNDAsMTcyNDQzNDY5NCwxMjY5MTUxMjM1LDIyOTk2ODc1MDksMzMzMzc3MDAzOSwzNzYxMTYwMDkzLDQwMDU0NTgzNzZdLCJxZiI6eyJiIjpbMCwwLDAsMCwwLDAsMCwwLDAsMCwwLDAsMCwwLDAsMCwwLDAsMCwwLDAsMCwwLDAsMCwwLDAsMCwwLDAsMCwwLDAsMCwwLDAsMCwwLDAsMCwwLDAsMCwwLDAsMCwwLDAsMCwwLDAsMCwwLDAsMCwwLDAsMCwwLDAsMCwwLDAsMCwwLDAsMCwwLDAsMCwwLDAsMF0sImwiOjAsInEiOjYsInIiOjd9fQAAAAAAAAAAAAAAAAAAAEABAAAAAAAACAAAADE5NDgxNi4wLQEAAHsid2FzX2ZpcnN0X2V2ZW50Ijp0cnVlLCJpbWFnZV9pZCI6WzIzNTQ3ODE3MywxNDI2NjM0MzQwLDE3MjQ0MzQ2OTQsMTI2OTE1MTIzNSwyMjk5Njg3NTA5LDMzMzM3NzAwMzksMzc2MTE2MDA5Myw0MDA1NDU4Mzc2XSwicWYiOnsiYiI6WzAsMCwwLDAsMCwwLDAsMCwwLDAsMCwwLDAsMCwwLDAsMCwwLDAsMCwwLDAsMCwwLDAsMCwwLDAsMCwwLDAsMCwwLDAsMCwwLDAsMCwwLDAsMCwwLDAsMCwwLDAsMCwwLDAsMCwwLDAsMCwwLDAsMCwwLDAsMCwwLDAsMCwwLDAsMCwwLDAsMCwwLDAsMCwwLDBdLCJsIjowLCJxIjo2LCJyIjo3fX0AAAAAAAAAAAAAAAAAAAAAAAAAAAAAAAAAAAAAAAAAAAAAAA=='}}
prove_79;14;35;Mul;490;195306;195306.0;841;0.06813066699942283;{'verificationValue': 195306.0, 'proof': {'imageId': [235478173, 1426634340, 1724434694, 1269151235, 2299687509, 3333770039, 3761160093, 4005458376], 'receipt': 'AwAAAAAAAAAAAAAAmL4gACyGqXD9SCTqBr57Fe21xvS89IksDAnB7FD2cs3kOUscAAAAAAAAAAAAAAAAAAAAAAAAAAAAAAAAAAAAAAAAAAAAAAAAAAAAAAAAAAAAAAAAAQAAAAAAAAAAAAAAAAAAAAAAAAAAAAAAAAAAAAAAAAAAAAAAAAAAAAEAAAAAQAEAAAAAAAAIAAAAMTk1MzA2LjAtAQAAeyJ3YXNfZmlyc3RfZXZlbnQiOnRydWUsImltYWdlX2lkIjpbMjM1NDc4MTczLDE0MjY2MzQzNDAsMTcyNDQzNDY5NCwxMjY5MTUxMjM1LDIyOTk2ODc1MDksMzMzMzc3MDAzOSwzNzYxMTYwMDkzLDQwMDU0NTgzNzZdLCJxZiI6eyJiIjpbMCwwLDAsMCwwLDAsMCwwLDAsMCwwLDAsMCwwLDAsMCwwLDAsMCwwLDAsMCwwLDAsMCwwLDAsMCwwLDAsMCwwLDAsMCwwLDAsMCwwLDAsMCwwLDAsMCwwLDAsMCwwLDAsMCwwLDAsMCwwLDAsMCwwLDAsMCwwLDAsMCwwLDAsMCwwLDAsMCwwLDAsMCwwLDAsMF0sImwiOjAsInEiOjYsInIiOjd9fQAAAAAAAAAAAAAAAAAAAEABAAAAAAAACAAAADE5NTMwNi4wLQEAAHsid2FzX2ZpcnN0X2V2ZW50Ijp0cnVlLCJpbWFnZV9pZCI6WzIzNTQ3ODE3MywxNDI2NjM0MzQwLDE3MjQ0MzQ2OTQsMTI2OTE1MTIzNSwyMjk5Njg3NTA5LDMzMzM3NzAwMzksMzc2MTE2MDA5Myw0MDA1NDU4Mzc2XSwicWYiOnsiYiI6WzAsMCwwLDAsMCwwLDAsMCwwLDAsMCwwLDAsMCwwLDAsMCwwLDAsMCwwLDAsMCwwLDAsMCwwLDAsMCwwLDAsMCwwLDAsMCwwLDAsMCwwLDAsMCwwLDAsMCwwLDAsMCwwLDAsMCwwLDAsMCwwLDAsMCwwLDAsMCwwLDAsMCwwLDAsMCwwLDAsMCwwLDAsMCwwLDBdLCJsIjowLCJxIjo2LCJyIjo3fX0AAAAAAAAAAAAAAAAAAAAAAAAAAAAAAAAAAAAAAAAAAAAAAA=='}}
prove_80;42;89;Mul;3738;199044;199044.0;841;0.06911958300042897;{'verificationValue': 199044.0, 'proof': {'imageId': [235478173, 1426634340, 1724434694, 1269151235, 2299687509, 3333770039, 3761160093, 4005458376], 'receipt': 'AwAAAAAAAAAAAAAAmL4gACyGqXD9SCTqBr57Fe21xvS89IksDAnB7FD2cs3kOUscAAAAAAAAAAAAAAAAAAAAAAAAAAAAAAAAAAAAAAAAAAAAAAAAAAAAAAAAAAAAAAAAAQAAAAAAAAAAAAAAAAAAAAAAAAAAAAAAAAAAAAAAAAAAAAAAAAAAAAEAAAAAQAEAAAAAAAAIAAAAMTk5MDQ0LjAtAQAAeyJ3YXNfZmlyc3RfZXZlbnQiOnRydWUsImltYWdlX2lkIjpbMjM1NDc4MTczLDE0MjY2MzQzNDAsMTcyNDQzNDY5NCwxMjY5MTUxMjM1LDIyOTk2ODc1MDksMzMzMzc3MDAzOSwzNzYxMTYwMDkzLDQwMDU0NTgzNzZdLCJxZiI6eyJiIjpbMCwwLDAsMCwwLDAsMCwwLDAsMCwwLDAsMCwwLDAsMCwwLDAsMCwwLDAsMCwwLDAsMCwwLDAsMCwwLDAsMCwwLDAsMCwwLDAsMCwwLDAsMCwwLDAsMCwwLDAsMCwwLDAsMCwwLDAsMCwwLDAsMCwwLDAsMCwwLDAsMCwwLDAsMCwwLDAsMCwwLDAsMCwwLDAsMF0sImwiOjAsInEiOjYsInIiOjd9fQAAAAAAAAAAAAAAAAAAAEABAAAAAAAACAAAADE5OTA0NC4wLQEAAHsid2FzX2ZpcnN0X2V2ZW50Ijp0cnVlLCJpbWFnZV9pZCI6WzIzNTQ3ODE3MywxNDI2NjM0MzQwLDE3MjQ0MzQ2OTQsMTI2OTE1MTIzNSwyMjk5Njg3NTA5LDMzMzM3NzAwMzksMzc2MTE2MDA5Myw0MDA1NDU4Mzc2XSwicWYiOnsiYiI6WzAsMCwwLDAsMCwwLDAsMCwwLDAsMCwwLDAsMCwwLDAsMCwwLDAsMCwwLDAsMCwwLDAsMCwwLDAsMCwwLDAsMCwwLDAsMCwwLDAsMCwwLDAsMCwwLDAsMCwwLDAsMCwwLDAsMCwwLDAsMCwwLDAsMCwwLDAsMCwwLDAsMCwwLDAsMCwwLDAsMCwwLDAsMCwwLDBdLCJsIjowLCJxIjo2LCJyIjo3fX0AAAAAAAAAAAAAAAAAAAAAAAAAAAAAAAAAAAAAAAAAAAAAAA=='}}
prove_81;65;25;Mul;1625;200669;200669.0;841;0.06855720800012932;{'verificationValue': 200669.0, 'proof': {'imageId': [235478173, 1426634340, 1724434694, 1269151235, 2299687509, 3333770039, 3761160093, 4005458376], 'receipt': 'AwAAAAAAAAAAAAAAmL4gACyGqXD9SCTqBr57Fe21xvS89IksDAnB7FD2cs3kOUscAAAAAAAAAAAAAAAAAAAAAAAAAAAAAAAAAAAAAAAAAAAAAAAAAAAAAAAAAAAAAAAAAQAAAAAAAAAAAAAAAAAAAAAAAAAAAAAAAAAAAAAAAAAAAAAAAAAAAAEAAAAAQAEAAAAAAAAIAAAAMjAwNjY5LjAtAQAAeyJ3YXNfZmlyc3RfZXZlbnQiOnRydWUsImltYWdlX2lkIjpbMjM1NDc4MTczLDE0MjY2MzQzNDAsMTcyNDQzNDY5NCwxMjY5MTUxMjM1LDIyOTk2ODc1MDksMzMzMzc3MDAzOSwzNzYxMTYwMDkzLDQwMDU0NTgzNzZdLCJxZiI6eyJiIjpbMCwwLDAsMCwwLDAsMCwwLDAsMCwwLDAsMCwwLDAsMCwwLDAsMCwwLDAsMCwwLDAsMCwwLDAsMCwwLDAsMCwwLDAsMCwwLDAsMCwwLDAsMCwwLDAsMCwwLDAsMCwwLDAsMCwwLDAsMCwwLDAsMCwwLDAsMCwwLDAsMCwwLDAsMCwwLDAsMCwwLDAsMCwwLDAsMF0sImwiOjAsInEiOjYsInIiOjd9fQAAAAAAAAAAAAAAAAAAAEABAAAAAAAACAAAADIwMDY2OS4wLQEAAHsid2FzX2ZpcnN0X2V2ZW50Ijp0cnVlLCJpbWFnZV9pZCI6WzIzNTQ3ODE3MywxNDI2NjM0MzQwLDE3MjQ0MzQ2OTQsMTI2OTE1MTIzNSwyMjk5Njg3NTA5LDMzMzM3NzAwMzksMzc2MTE2MDA5Myw0MDA1NDU4Mzc2XSwicWYiOnsiYiI6WzAsMCwwLDAsMCwwLDAsMCwwLDAsMCwwLDAsMCwwLDAsMCwwLDAsMCwwLDAsMCwwLDAsMCwwLDAsMCwwLDAsMCwwLDAsMCwwLDAsMCwwLDAsMCwwLDAsMCwwLDAsMCwwLDAsMCwwLDAsMCwwLDAsMCwwLDAsMCwwLDAsMCwwLDAsMCwwLDAsMCwwLDAsMCwwLDBdLCJsIjowLCJxIjo2LCJyIjo3fX0AAAAAAAAAAAAAAAAAAAAAAAAAAAAAAAAAAAAAAAAAAAAAAA=='}}
prove_82;73;55;Mul;4015;204684;204684.0;841;0.07306091700047546;{'verificationValue': 204684.0, 'proof': {'imageId': [235478173, 1426634340, 1724434694, 1269151235, 2299687509, 3333770039, 3761160093, 4005458376], 'receipt': 'AwAAAAAAAAAAAAAAmL4gACyGqXD9SCTqBr57Fe21xvS89IksDAnB7FD2cs3kOUscAAAAAAAAAAAAAAAAAAAAAAAAAAAAAAAAAAAAAAAAAAAAAAAAAAAAAAAAAAAAAAAAAQAAAAAAAAAAAAAAAAAAAAAAAAAAAAAAAAAAAAAAAAAAAAAAAAAAAAEAAAAAQAEAAAAAAAAIAAAAMjA0Njg0LjAtAQAAeyJ3YXNfZmlyc3RfZXZlbnQiOnRydWUsImltYWdlX2lkIjpbMjM1NDc4MTczLDE0MjY2MzQzNDAsMTcyNDQzNDY5NCwxMjY5MTUxMjM1LDIyOTk2ODc1MDksMzMzMzc3MDAzOSwzNzYxMTYwMDkzLDQwMDU0NTgzNzZdLCJxZiI6eyJiIjpbMCwwLDAsMCwwLDAsMCwwLDAsMCwwLDAsMCwwLDAsMCwwLDAsMCwwLDAsMCwwLDAsMCwwLDAsMCwwLDAsMCwwLDAsMCwwLDAsMCwwLDAsMCwwLDAsMCwwLDAsMCwwLDAsMCwwLDAsMCwwLDAsMCwwLDAsMCwwLDAsMCwwLDAsMCwwLDAsMCwwLDAsMCwwLDAsMF0sImwiOjAsInEiOjYsInIiOjd9fQAAAAAAAAAAAAAAAAAAAEABAAAAAAAACAAAADIwNDY4NC4wLQEAAHsid2FzX2ZpcnN0X2V2ZW50Ijp0cnVlLCJpbWFnZV9pZCI6WzIzNTQ3ODE3MywxNDI2NjM0MzQwLDE3MjQ0MzQ2OTQsMTI2OTE1MTIzNSwyMjk5Njg3NTA5LDMzMzM3NzAwMzksMzc2MTE2MDA5Myw0MDA1NDU4Mzc2XSwicWYiOnsiYiI6WzAsMCwwLDAsMCwwLDAsMCwwLDAsMCwwLDAsMCwwLDAsMCwwLDAsMCwwLDAsMCwwLDAsMCwwLDAsMCwwLDAsMCwwLDAsMCwwLDAsMCwwLDAsMCwwLDAsMCwwLDAsMCwwLDAsMCwwLDAsMCwwLDAsMCwwLDAsMCwwLDAsMCwwLDAsMCwwLDAsMCwwLDAsMCwwLDBdLCJsIjowLCJxIjo2LCJyIjo3fX0AAAAAAAAAAAAAAAAAAAAAAAAAAAAAAAAAAAAAAAAAAAAAAA=='}}
prove_83;21;5;Mul;105;204789;204789.0;841;0.10961054200015496;{'verificationValue': 204789.0, 'proof': {'imageId': [235478173, 1426634340, 1724434694, 1269151235, 2299687509, 3333770039, 3761160093, 4005458376], 'receipt': 'AwAAAAAAAAAAAAAAmL4gACyGqXD9SCTqBr57Fe21xvS89IksDAnB7FD2cs3kOUscAAAAAAAAAAAAAAAAAAAAAAAAAAAAAAAAAAAAAAAAAAAAAAAAAAAAAAAAAAAAAAAAAQAAAAAAAAAAAAAAAAAAAAAAAAAAAAAAAAAAAAAAAAAAAAAAAAAAAAEAAAAAQAEAAAAAAAAIAAAAMjA0Nzg5LjAtAQAAeyJ3YXNfZmlyc3RfZXZlbnQiOnRydWUsImltYWdlX2lkIjpbMjM1NDc4MTczLDE0MjY2MzQzNDAsMTcyNDQzNDY5NCwxMjY5MTUxMjM1LDIyOTk2ODc1MDksMzMzMzc3MDAzOSwzNzYxMTYwMDkzLDQwMDU0NTgzNzZdLCJxZiI6eyJiIjpbMCwwLDAsMCwwLDAsMCwwLDAsMCwwLDAsMCwwLDAsMCwwLDAsMCwwLDAsMCwwLDAsMCwwLDAsMCwwLDAsMCwwLDAsMCwwLDAsMCwwLDAsMCwwLDAsMCwwLDAsMCwwLDAsMCwwLDAsMCwwLDAsMCwwLDAsMCwwLDAsMCwwLDAsMCwwLDAsMCwwLDAsMCwwLDAsMF0sImwiOjAsInEiOjYsInIiOjd9fQAAAAAAAAAAAAAAAAAAAEABAAAAAAAACAAAADIwNDc4OS4wLQEAAHsid2FzX2ZpcnN0X2V2ZW50Ijp0cnVlLCJpbWFnZV9pZCI6WzIzNTQ3ODE3MywxNDI2NjM0MzQwLDE3MjQ0MzQ2OTQsMTI2OTE1MTIzNSwyMjk5Njg3NTA5LDMzMzM3NzAwMzksMzc2MTE2MDA5Myw0MDA1NDU4Mzc2XSwicWYiOnsiYiI6WzAsMCwwLDAsMCwwLDAsMCwwLDAsMCwwLDAsMCwwLDAsMCwwLDAsMCwwLDAsMCwwLDAsMCwwLDAsMCwwLDAsMCwwLDAsMCwwLDAsMCwwLDAsMCwwLDAsMCwwLDAsMCwwLDAsMCwwLDAsMCwwLDAsMCwwLDAsMCwwLDAsMCwwLDAsMCwwLDAsMCwwLDAsMCwwLDBdLCJsIjowLCJxIjo2LCJyIjo3fX0AAAAAAAAAAAAAAAAAAAAAAAAAAAAAAAAAAAAAAAAAAAAAAA=='}}
prove_84;90;74;Mul;6660;211449;211449.0;841;0.06993750000037835;{'verificationValue': 211449.0, 'proof': {'imageId': [235478173, 1426634340, 1724434694, 1269151235, 2299687509, 3333770039, 3761160093, 4005458376], 'receipt': 'AwAAAAAAAAAAAAAAmL4gACyGqXD9SCTqBr57Fe21xvS89IksDAnB7FD2cs3kOUscAAAAAAAAAAAAAAAAAAAAAAAAAAAAAAAAAAAAAAAAAAAAAAAAAAAAAAAAAAAAAAAAAQAAAAAAAAAAAAAAAAAAAAAAAAAAAAAAAAAAAAAAAAAAAAAAAAAAAAEAAAAAQAEAAAAAAAAIAAAAMjExNDQ5LjAtAQAAeyJ3YXNfZmlyc3RfZXZlbnQiOnRydWUsImltYWdlX2lkIjpbMjM1NDc4MTczLDE0MjY2MzQzNDAsMTcyNDQzNDY5NCwxMjY5MTUxMjM1LDIyOTk2ODc1MDksMzMzMzc3MDAzOSwzNzYxMTYwMDkzLDQwMDU0NTgzNzZdLCJxZiI6eyJiIjpbMCwwLDAsMCwwLDAsMCwwLDAsMCwwLDAsMCwwLDAsMCwwLDAsMCwwLDAsMCwwLDAsMCwwLDAsMCwwLDAsMCwwLDAsMCwwLDAsMCwwLDAsMCwwLDAsMCwwLDAsMCwwLDAsMCwwLDAsMCwwLDAsMCwwLDAsMCwwLDAsMCwwLDAsMCwwLDAsMCwwLDAsMCwwLDAsMF0sImwiOjAsInEiOjYsInIiOjd9fQAAAAAAAAAAAAAAAAAAAEABAAAAAAAACAAAADIxMTQ0OS4wLQEAAHsid2FzX2ZpcnN0X2V2ZW50Ijp0cnVlLCJpbWFnZV9pZCI6WzIzNTQ3ODE3MywxNDI2NjM0MzQwLDE3MjQ0MzQ2OTQsMTI2OTE1MTIzNSwyMjk5Njg3NTA5LDMzMzM3NzAwMzksMzc2MTE2MDA5Myw0MDA1NDU4Mzc2XSwicWYiOnsiYiI6WzAsMCwwLDAsMCwwLDAsMCwwLDAsMCwwLDAsMCwwLDAsMCwwLDAsMCwwLDAsMCwwLDAsMCwwLDAsMCwwLDAsMCwwLDAsMCwwLDAsMCwwLDAsMCwwLDAsMCwwLDAsMCwwLDAsMCwwLDAsMCwwLDAsMCwwLDAsMCwwLDAsMCwwLDAsMCwwLDAsMCwwLDAsMCwwLDBdLCJsIjowLCJxIjo2LCJyIjo3fX0AAAAAAAAAAAAAAAAAAAAAAAAAAAAAAAAAAAAAAAAAAAAAAA=='}}
prove_85;29;27;Mul;783;212232;212232.0;841;0.06895158299994364;{'verificationValue': 212232.0, 'proof': {'imageId': [235478173, 1426634340, 1724434694, 1269151235, 2299687509, 3333770039, 3761160093, 4005458376], 'receipt': 'AwAAAAAAAAAAAAAAmL4gACyGqXD9SCTqBr57Fe21xvS89IksDAnB7FD2cs3kOUscAAAAAAAAAAAAAAAAAAAAAAAAAAAAAAAAAAAAAAAAAAAAAAAAAAAAAAAAAAAAAAAAAQAAAAAAAAAAAAAAAAAAAAAAAAAAAAAAAAAAAAAAAAAAAAAAAAAAAAEAAAAAQAEAAAAAAAAIAAAAMjEyMjMyLjAtAQAAeyJ3YXNfZmlyc3RfZXZlbnQiOnRydWUsImltYWdlX2lkIjpbMjM1NDc4MTczLDE0MjY2MzQzNDAsMTcyNDQzNDY5NCwxMjY5MTUxMjM1LDIyOTk2ODc1MDksMzMzMzc3MDAzOSwzNzYxMTYwMDkzLDQwMDU0NTgzNzZdLCJxZiI6eyJiIjpbMCwwLDAsMCwwLDAsMCwwLDAsMCwwLDAsMCwwLDAsMCwwLDAsMCwwLDAsMCwwLDAsMCwwLDAsMCwwLDAsMCwwLDAsMCwwLDAsMCwwLDAsMCwwLDAsMCwwLDAsMCwwLDAsMCwwLDAsMCwwLDAsMCwwLDAsMCwwLDAsMCwwLDAsMCwwLDAsMCwwLDAsMCwwLDAsMF0sImwiOjAsInEiOjYsInIiOjd9fQAAAAAAAAAAAAAAAAAAAEABAAAAAAAACAAAADIxMjIzMi4wLQEAAHsid2FzX2ZpcnN0X2V2ZW50Ijp0cnVlLCJpbWFnZV9pZCI6WzIzNTQ3ODE3MywxNDI2NjM0MzQwLDE3MjQ0MzQ2OTQsMTI2OTE1MTIzNSwyMjk5Njg3NTA5LDMzMzM3NzAwMzksMzc2MTE2MDA5Myw0MDA1NDU4Mzc2XSwicWYiOnsiYiI6WzAsMCwwLDAsMCwwLDAsMCwwLDAsMCwwLDAsMCwwLDAsMCwwLDAsMCwwLDAsMCwwLDAsMCwwLDAsMCwwLDAsMCwwLDAsMCwwLDAsMCwwLDAsMCwwLDAsMCwwLDAsMCwwLDAsMCwwLDAsMCwwLDAsMCwwLDAsMCwwLDAsMCwwLDAsMCwwLDAsMCwwLDAsMCwwLDBdLCJsIjowLCJxIjo2LCJyIjo3fX0AAAAAAAAAAAAAAAAAAAAAAAAAAAAAAAAAAAAAAAAAAAAAAA=='}}
prove_86;25;49;Mul;1225;213457;213457.0;841;0.0689470839988644;{'verificationValue': 213457.0, 'proof': {'imageId': [235478173, 1426634340, 1724434694, 1269151235, 2299687509, 3333770039, 3761160093, 4005458376], 'receipt': 'AwAAAAAAAAAAAAAAmL4gACyGqXD9SCTqBr57Fe21xvS89IksDAnB7FD2cs3kOUscAAAAAAAAAAAAAAAAAAAAAAAAAAAAAAAAAAAAAAAAAAAAAAAAAAAAAAAAAAAAAAAAAQAAAAAAAAAAAAAAAAAAAAAAAAAAAAAAAAAAAAAAAAAAAAAAAAAAAAEAAAAAQAEAAAAAAAAIAAAAMjEzNDU3LjAtAQAAeyJ3YXNfZmlyc3RfZXZlbnQiOnRydWUsImltYWdlX2lkIjpbMjM1NDc4MTczLDE0MjY2MzQzNDAsMTcyNDQzNDY5NCwxMjY5MTUxMjM1LDIyOTk2ODc1MDksMzMzMzc3MDAzOSwzNzYxMTYwMDkzLDQwMDU0NTgzNzZdLCJxZiI6eyJiIjpbMCwwLDAsMCwwLDAsMCwwLDAsMCwwLDAsMCwwLDAsMCwwLDAsMCwwLDAsMCwwLDAsMCwwLDAsMCwwLDAsMCwwLDAsMCwwLDAsMCwwLDAsMCwwLDAsMCwwLDAsMCwwLDAsMCwwLDAsMCwwLDAsMCwwLDAsMCwwLDAsMCwwLDAsMCwwLDAsMCwwLDAsMCwwLDAsMF0sImwiOjAsInEiOjYsInIiOjd9fQAAAAAAAAAAAAAAAAAAAEABAAAAAAAACAAAADIxMzQ1Ny4wLQEAAHsid2FzX2ZpcnN0X2V2ZW50Ijp0cnVlLCJpbWFnZV9pZCI6WzIzNTQ3ODE3MywxNDI2NjM0MzQwLDE3MjQ0MzQ2OTQsMTI2OTE1MTIzNSwyMjk5Njg3NTA5LDMzMzM3NzAwMzksMzc2MTE2MDA5Myw0MDA1NDU4Mzc2XSwicWYiOnsiYiI6WzAsMCwwLDAsMCwwLDAsMCwwLDAsMCwwLDAsMCwwLDAsMCwwLDAsMCwwLDAsMCwwLDAsMCwwLDAsMCwwLDAsMCwwLDAsMCwwLDAsMCwwLDAsMCwwLDAsMCwwLDAsMCwwLDAsMCwwLDAsMCwwLDAsMCwwLDAsMCwwLDAsMCwwLDAsMCwwLDAsMCwwLDAsMCwwLDBdLCJsIjowLCJxIjo2LCJyIjo3fX0AAAAAAAAAAAAAAAAAAAAAAAAAAAAAAAAAAAAAAAAAAAAAAA=='}}
prove_87;67;67;Mul;4489;217946;217946.0;841;0.06917208400045638;{'verificationValue': 217946.0, 'proof': {'imageId': [235478173, 1426634340, 1724434694, 1269151235, 2299687509, 3333770039, 3761160093, 4005458376], 'receipt': 'AwAAAAAAAAAAAAAAmL4gACyGqXD9SCTqBr57Fe21xvS89IksDAnB7FD2cs3kOUscAAAAAAAAAAAAAAAAAAAAAAAAAAAAAAAAAAAAAAAAAAAAAAAAAAAAAAAAAAAAAAAAAQAAAAAAAAAAAAAAAAAAAAAAAAAAAAAAAAAAAAAAAAAAAAAAAAAAAAEAAAAAQAEAAAAAAAAIAAAAMjE3OTQ2LjAtAQAAeyJ3YXNfZmlyc3RfZXZlbnQiOnRydWUsImltYWdlX2lkIjpbMjM1NDc4MTczLDE0MjY2MzQzNDAsMTcyNDQzNDY5NCwxMjY5MTUxMjM1LDIyOTk2ODc1MDksMzMzMzc3MDAzOSwzNzYxMTYwMDkzLDQwMDU0NTgzNzZdLCJxZiI6eyJiIjpbMCwwLDAsMCwwLDAsMCwwLDAsMCwwLDAsMCwwLDAsMCwwLDAsMCwwLDAsMCwwLDAsMCwwLDAsMCwwLDAsMCwwLDAsMCwwLDAsMCwwLDAsMCwwLDAsMCwwLDAsMCwwLDAsMCwwLDAsMCwwLDAsMCwwLDAsMCwwLDAsMCwwLDAsMCwwLDAsMCwwLDAsMCwwLDAsMF0sImwiOjAsInEiOjYsInIiOjd9fQAAAAAAAAAAAAAAAAAAAEABAAAAAAAACAAAADIxNzk0Ni4wLQEAAHsid2FzX2ZpcnN0X2V2ZW50Ijp0cnVlLCJpbWFnZV9pZCI6WzIzNTQ3ODE3MywxNDI2NjM0MzQwLDE3MjQ0MzQ2OTQsMTI2OTE1MTIzNSwyMjk5Njg3NTA5LDMzMzM3NzAwMzksMzc2MTE2MDA5Myw0MDA1NDU4Mzc2XSwicWYiOnsiYiI6WzAsMCwwLDAsMCwwLDAsMCwwLDAsMCwwLDAsMCwwLDAsMCwwLDAsMCwwLDAsMCwwLDAsMCwwLDAsMCwwLDAsMCwwLDAsMCwwLDAsMCwwLDAsMCwwLDAsMCwwLDAsMCwwLDAsMCwwLDAsMCwwLDAsMCwwLDAsMCwwLDAsMCwwLDAsMCwwLDAsMCwwLDAsMCwwLDBdLCJsIjowLCJxIjo2LCJyIjo3fX0AAAAAAAAAAAAAAAAAAAAAAAAAAAAAAAAAAAAAAAAAAAAAAA=='}}
prove_88;38;38;Mul;1444;219390;219390.0;841;0.06944074999955774;{'verificationValue': 219390.0, 'proof': {'imageId': [235478173, 1426634340, 1724434694, 1269151235, 2299687509, 3333770039, 3761160093, 4005458376], 'receipt': 'AwAAAAAAAAAAAAAAmL4gACyGqXD9SCTqBr57Fe21xvS89IksDAnB7FD2cs3kOUscAAAAAAAAAAAAAAAAAAAAAAAAAAAAAAAAAAAAAAAAAAAAAAAAAAAAAAAAAAAAAAAAAQAAAAAAAAAAAAAAAAAAAAAAAAAAAAAAAAAAAAAAAAAAAAAAAAAAAAEAAAAAQAEAAAAAAAAIAAAAMjE5MzkwLjAtAQAAeyJ3YXNfZmlyc3RfZXZlbnQiOnRydWUsImltYWdlX2lkIjpbMjM1NDc4MTczLDE0MjY2MzQzNDAsMTcyNDQzNDY5NCwxMjY5MTUxMjM1LDIyOTk2ODc1MDksMzMzMzc3MDAzOSwzNzYxMTYwMDkzLDQwMDU0NTgzNzZdLCJxZiI6eyJiIjpbMCwwLDAsMCwwLDAsMCwwLDAsMCwwLDAsMCwwLDAsMCwwLDAsMCwwLDAsMCwwLDAsMCwwLDAsMCwwLDAsMCwwLDAsMCwwLDAsMCwwLDAsMCwwLDAsMCwwLDAsMCwwLDAsMCwwLDAsMCwwLDAsMCwwLDAsMCwwLDAsMCwwLDAsMCwwLDAsMCwwLDAsMCwwLDAsMF0sImwiOjAsInEiOjYsInIiOjd9fQAAAAAAAAAAAAAAAAAAAEABAAAAAAAACAAAADIxOTM5MC4wLQEAAHsid2FzX2ZpcnN0X2V2ZW50Ijp0cnVlLCJpbWFnZV9pZCI6WzIzNTQ3ODE3MywxNDI2NjM0MzQwLDE3MjQ0MzQ2OTQsMTI2OTE1MTIzNSwyMjk5Njg3NTA5LDMzMzM3NzAwMzksMzc2MTE2MDA5Myw0MDA1NDU4Mzc2XSwicWYiOnsiYiI6WzAsMCwwLDAsMCwwLDAsMCwwLDAsMCwwLDAsMCwwLDAsMCwwLDAsMCwwLDAsMCwwLDAsMCwwLDAsMCwwLDAsMCwwLDAsMCwwLDAsMCwwLDAsMCwwLDAsMCwwLDAsMCwwLDAsMCwwLDAsMCwwLDAsMCwwLDAsMCwwLDAsMCwwLDAsMCwwLDAsMCwwLDAsMCwwLDBdLCJsIjowLCJxIjo2LCJyIjo3fX0AAAAAAAAAAAAAAAAAAAAAAAAAAAAAAAAAAAAAAAAAAAAAAA=='}}
prove_89;62;20;Mul;1240;220630;220630.0;841;0.07296208399930038;{'verificationValue': 220630.0, 'proof': {'imageId': [235478173, 1426634340, 1724434694, 1269151235, 2299687509, 3333770039, 3761160093, 4005458376], 'receipt': 'AwAAAAAAAAAAAAAAmL4gACyGqXD9SCTqBr57Fe21xvS89IksDAnB7FD2cs3kOUscAAAAAAAAAAAAAAAAAAAAAAAAAAAAAAAAAAAAAAAAAAAAAAAAAAAAAAAAAAAAAAAAAQAAAAAAAAAAAAAAAAAAAAAAAAAAAAAAAAAAAAAAAAAAAAAAAAAAAAEAAAAAQAEAAAAAAAAIAAAAMjIwNjMwLjAtAQAAeyJ3YXNfZmlyc3RfZXZlbnQiOnRydWUsImltYWdlX2lkIjpbMjM1NDc4MTczLDE0MjY2MzQzNDAsMTcyNDQzNDY5NCwxMjY5MTUxMjM1LDIyOTk2ODc1MDksMzMzMzc3MDAzOSwzNzYxMTYwMDkzLDQwMDU0NTgzNzZdLCJxZiI6eyJiIjpbMCwwLDAsMCwwLDAsMCwwLDAsMCwwLDAsMCwwLDAsMCwwLDAsMCwwLDAsMCwwLDAsMCwwLDAsMCwwLDAsMCwwLDAsMCwwLDAsMCwwLDAsMCwwLDAsMCwwLDAsMCwwLDAsMCwwLDAsMCwwLDAsMCwwLDAsMCwwLDAsMCwwLDAsMCwwLDAsMCwwLDAsMCwwLDAsMF0sImwiOjAsInEiOjYsInIiOjd9fQAAAAAAAAAAAAAAAAAAAEABAAAAAAAACAAAADIyMDYzMC4wLQEAAHsid2FzX2ZpcnN0X2V2ZW50Ijp0cnVlLCJpbWFnZV9pZCI6WzIzNTQ3ODE3MywxNDI2NjM0MzQwLDE3MjQ0MzQ2OTQsMTI2OTE1MTIzNSwyMjk5Njg3NTA5LDMzMzM3NzAwMzksMzc2MTE2MDA5Myw0MDA1NDU4Mzc2XSwicWYiOnsiYiI6WzAsMCwwLDAsMCwwLDAsMCwwLDAsMCwwLDAsMCwwLDAsMCwwLDAsMCwwLDAsMCwwLDAsMCwwLDAsMCwwLDAsMCwwLDAsMCwwLDAsMCwwLDAsMCwwLDAsMCwwLDAsMCwwLDAsMCwwLDAsMCwwLDAsMCwwLDAsMCwwLDAsMCwwLDAsMCwwLDAsMCwwLDAsMCwwLDBdLCJsIjowLCJxIjo2LCJyIjo3fX0AAAAAAAAAAAAAAAAAAAAAAAAAAAAAAAAAAAAAAAAAAAAAAA=='}}
prove_90;44;77;Mul;3388;224018;224018.0;841;0.06933787500020117;{'verificationValue': 224018.0, 'proof': {'imageId': [235478173, 1426634340, 1724434694, 1269151235, 2299687509, 3333770039, 3761160093, 4005458376], 'receipt': 'AwAAAAAAAAAAAAAAmL4gACyGqXD9SCTqBr57Fe21xvS89IksDAnB7FD2cs3kOUscAAAAAAAAAAAAAAAAAAAAAAAAAAAAAAAAAAAAAAAAAAAAAAAAAAAAAAAAAAAAAAAAAQAAAAAAAAAAAAAAAAAAAAAAAAAAAAAAAAAAAAAAAAAAAAAAAAAAAAEAAAAAQAEAAAAAAAAIAAAAMjI0MDE4LjAtAQAAeyJ3YXNfZmlyc3RfZXZlbnQiOnRydWUsImltYWdlX2lkIjpbMjM1NDc4MTczLDE0MjY2MzQzNDAsMTcyNDQzNDY5NCwxMjY5MTUxMjM1LDIyOTk2ODc1MDksMzMzMzc3MDAzOSwzNzYxMTYwMDkzLDQwMDU0NTgzNzZdLCJxZiI6eyJiIjpbMCwwLDAsMCwwLDAsMCwwLDAsMCwwLDAsMCwwLDAsMCwwLDAsMCwwLDAsMCwwLDAsMCwwLDAsMCwwLDAsMCwwLDAsMCwwLDAsMCwwLDAsMCwwLDAsMCwwLDAsMCwwLDAsMCwwLDAsMCwwLDAsMCwwLDAsMCwwLDAsMCwwLDAsMCwwLDAsMCwwLDAsMCwwLDAsMF0sImwiOjAsInEiOjYsInIiOjd9fQAAAAAAAAAAAAAAAAAAAEABAAAAAAAACAAAADIyNDAxOC4wLQEAAHsid2FzX2ZpcnN0X2V2ZW50Ijp0cnVlLCJpbWFnZV9pZCI6WzIzNTQ3ODE3MywxNDI2NjM0MzQwLDE3MjQ0MzQ2OTQsMTI2OTE1MTIzNSwyMjk5Njg3NTA5LDMzMzM3NzAwMzksMzc2MTE2MDA5Myw0MDA1NDU4Mzc2XSwicWYiOnsiYiI6WzAsMCwwLDAsMCwwLDAsMCwwLDAsMCwwLDAsMCwwLDAsMCwwLDAsMCwwLDAsMCwwLDAsMCwwLDAsMCwwLDAsMCwwLDAsMCwwLDAsMCwwLDAsMCwwLDAsMCwwLDAsMCwwLDAsMCwwLDAsMCwwLDAsMCwwLDAsMCwwLDAsMCwwLDAsMCwwLDAsMCwwLDAsMCwwLDBdLCJsIjowLCJxIjo2LCJyIjo3fX0AAAAAAAAAAAAAAAAAAAAAAAAAAAAAAAAAAAAAAAAAAAAAAA=='}}
prove_91;88;89;Mul;7832;231850;231850.0;841;0.06821441700049036;{'verificationValue': 231850.0, 'proof': {'imageId': [235478173, 1426634340, 1724434694, 1269151235, 2299687509, 3333770039, 3761160093, 4005458376], 'receipt': 'AwAAAAAAAAAAAAAAmL4gACyGqXD9SCTqBr57Fe21xvS89IksDAnB7FD2cs3kOUscAAAAAAAAAAAAAAAAAAAAAAAAAAAAAAAAAAAAAAAAAAAAAAAAAAAAAAAAAAAAAAAAAQAAAAAAAAAAAAAAAAAAAAAAAAAAAAAAAAAAAAAAAAAAAAAAAAAAAAEAAAAAQAEAAAAAAAAIAAAAMjMxODUwLjAtAQAAeyJ3YXNfZmlyc3RfZXZlbnQiOnRydWUsImltYWdlX2lkIjpbMjM1NDc4MTczLDE0MjY2MzQzNDAsMTcyNDQzNDY5NCwxMjY5MTUxMjM1LDIyOTk2ODc1MDksMzMzMzc3MDAzOSwzNzYxMTYwMDkzLDQwMDU0NTgzNzZdLCJxZiI6eyJiIjpbMCwwLDAsMCwwLDAsMCwwLDAsMCwwLDAsMCwwLDAsMCwwLDAsMCwwLDAsMCwwLDAsMCwwLDAsMCwwLDAsMCwwLDAsMCwwLDAsMCwwLDAsMCwwLDAsMCwwLDAsMCwwLDAsMCwwLDAsMCwwLDAsMCwwLDAsMCwwLDAsMCwwLDAsMCwwLDAsMCwwLDAsMCwwLDAsMF0sImwiOjAsInEiOjYsInIiOjd9fQAAAAAAAAAAAAAAAAAAAEABAAAAAAAACAAAADIzMTg1MC4wLQEAAHsid2FzX2ZpcnN0X2V2ZW50Ijp0cnVlLCJpbWFnZV9pZCI6WzIzNTQ3ODE3MywxNDI2NjM0MzQwLDE3MjQ0MzQ2OTQsMTI2OTE1MTIzNSwyMjk5Njg3NTA5LDMzMzM3NzAwMzksMzc2MTE2MDA5Myw0MDA1NDU4Mzc2XSwicWYiOnsiYiI6WzAsMCwwLDAsMCwwLDAsMCwwLDAsMCwwLDAsMCwwLDAsMCwwLDAsMCwwLDAsMCwwLDAsMCwwLDAsMCwwLDAsMCwwLDAsMCwwLDAsMCwwLDAsMCwwLDAsMCwwLDAsMCwwLDAsMCwwLDAsMCwwLDAsMCwwLDAsMCwwLDAsMCwwLDAsMCwwLDAsMCwwLDAsMCwwLDBdLCJsIjowLCJxIjo2LCJyIjo3fX0AAAAAAAAAAAAAAAAAAAAAAAAAAAAAAAAAAAAAAAAAAAAAAA=='}}
prove_92;68;74;Mul;5032;236882;236882.0;841;0.07031725000160804;{'verificationValue': 236882.0, 'proof': {'imageId': [235478173, 1426634340, 1724434694, 1269151235, 2299687509, 3333770039, 3761160093, 4005458376], 'receipt': 'AwAAAAAAAAAAAAAAmL4gACyGqXD9SCTqBr57Fe21xvS89IksDAnB7FD2cs3kOUscAAAAAAAAAAAAAAAAAAAAAAAAAAAAAAAAAAAAAAAAAAAAAAAAAAAAAAAAAAAAAAAAAQAAAAAAAAAAAAAAAAAAAAAAAAAAAAAAAAAAAAAAAAAAAAAAAAAAAAEAAAAAQAEAAAAAAAAIAAAAMjM2ODgyLjAtAQAAeyJ3YXNfZmlyc3RfZXZlbnQiOnRydWUsImltYWdlX2lkIjpbMjM1NDc4MTczLDE0MjY2MzQzNDAsMTcyNDQzNDY5NCwxMjY5MTUxMjM1LDIyOTk2ODc1MDksMzMzMzc3MDAzOSwzNzYxMTYwMDkzLDQwMDU0NTgzNzZdLCJxZiI6eyJiIjpbMCwwLDAsMCwwLDAsMCwwLDAsMCwwLDAsMCwwLDAsMCwwLDAsMCwwLDAsMCwwLDAsMCwwLDAsMCwwLDAsMCwwLDAsMCwwLDAsMCwwLDAsMCwwLDAsMCwwLDAsMCwwLDAsMCwwLDAsMCwwLDAsMCwwLDAsMCwwLDAsMCwwLDAsMCwwLDAsMCwwLDAsMCwwLDAsMF0sImwiOjAsInEiOjYsInIiOjd9fQAAAAAAAAAAAAAAAAAAAEABAAAAAAAACAAAADIzNjg4Mi4wLQEAAHsid2FzX2ZpcnN0X2V2ZW50Ijp0cnVlLCJpbWFnZV9pZCI6WzIzNTQ3ODE3MywxNDI2NjM0MzQwLDE3MjQ0MzQ2OTQsMTI2OTE1MTIzNSwyMjk5Njg3NTA5LDMzMzM3NzAwMzksMzc2MTE2MDA5Myw0MDA1NDU4Mzc2XSwicWYiOnsiYiI6WzAsMCwwLDAsMCwwLDAsMCwwLDAsMCwwLDAsMCwwLDAsMCwwLDAsMCwwLDAsMCwwLDAsMCwwLDAsMCwwLDAsMCwwLDAsMCwwLDAsMCwwLDAsMCwwLDAsMCwwLDAsMCwwLDAsMCwwLDAsMCwwLDAsMCwwLDAsMCwwLDAsMCwwLDAsMCwwLDAsMCwwLDAsMCwwLDBdLCJsIjowLCJxIjo2LCJyIjo3fX0AAAAAAAAAAAAAAAAAAAAAAAAAAAAAAAAAAAAAAAAAAAAAAA=='}}
prove_93;96;33;Mul;3168;240050;240050.0;841;0.0689627499996277;{'verificationValue': 240050.0, 'proof': {'imageId': [235478173, 1426634340, 1724434694, 1269151235, 2299687509, 3333770039, 3761160093, 4005458376], 'receipt': 'AwAAAAAAAAAAAAAAmL4gACyGqXD9SCTqBr57Fe21xvS89IksDAnB7FD2cs3kOUscAAAAAAAAAAAAAAAAAAAAAAAAAAAAAAAAAAAAAAAAAAAAAAAAAAAAAAAAAAAAAAAAAQAAAAAAAAAAAAAAAAAAAAAAAAAAAAAAAAAAAAAAAAAAAAAAAAAAAAEAAAAAQAEAAAAAAAAIAAAAMjQwMDUwLjAtAQAAeyJ3YXNfZmlyc3RfZXZlbnQiOnRydWUsImltYWdlX2lkIjpbMjM1NDc4MTczLDE0MjY2MzQzNDAsMTcyNDQzNDY5NCwxMjY5MTUxMjM1LDIyOTk2ODc1MDksMzMzMzc3MDAzOSwzNzYxMTYwMDkzLDQwMDU0NTgzNzZdLCJxZiI6eyJiIjpbMCwwLDAsMCwwLDAsMCwwLDAsMCwwLDAsMCwwLDAsMCwwLDAsMCwwLDAsMCwwLDAsMCwwLDAsMCwwLDAsMCwwLDAsMCwwLDAsMCwwLDAsMCwwLDAsMCwwLDAsMCwwLDAsMCwwLDAsMCwwLDAsMCwwLDAsMCwwLDAsMCwwLDAsMCwwLDAsMCwwLDAsMCwwLDAsMF0sImwiOjAsInEiOjYsInIiOjd9fQAAAAAAAAAAAAAAAAAAAEABAAAAAAAACAAAADI0MDA1MC4wLQEAAHsid2FzX2ZpcnN0X2V2ZW50Ijp0cnVlLCJpbWFnZV9pZCI6WzIzNTQ3ODE3MywxNDI2NjM0MzQwLDE3MjQ0MzQ2OTQsMTI2OTE1MTIzNSwyMjk5Njg3NTA5LDMzMzM3NzAwMzksMzc2MTE2MDA5Myw0MDA1NDU4Mzc2XSwicWYiOnsiYiI6WzAsMCwwLDAsMCwwLDAsMCwwLDAsMCwwLDAsMCwwLDAsMCwwLDAsMCwwLDAsMCwwLDAsMCwwLDAsMCwwLDAsMCwwLDAsMCwwLDAsMCwwLDAsMCwwLDAsMCwwLDAsMCwwLDAsMCwwLDAsMCwwLDAsMCwwLDAsMCwwLDAsMCwwLDAsMCwwLDAsMCwwLDAsMCwwLDBdLCJsIjowLCJxIjo2LCJyIjo3fX0AAAAAAAAAAAAAAAAAAAAAAAAAAAAAAAAAAAAAAAAAAAAAAA=='}}
prove_94;72;12;Mul;864;240914;240914.0;841;0.06936054200014041;{'verificationValue': 240914.0, 'proof': {'imageId': [235478173, 1426634340, 1724434694, 1269151235, 2299687509, 3333770039, 3761160093, 4005458376], 'receipt': 'AwAAAAAAAAAAAAAAmL4gACyGqXD9SCTqBr57Fe21xvS89IksDAnB7FD2cs3kOUscAAAAAAAAAAAAAAAAAAAAAAAAAAAAAAAAAAAAAAAAAAAAAAAAAAAAAAAAAAAAAAAAAQAAAAAAAAAAAAAAAAAAAAAAAAAAAAAAAAAAAAAAAAAAAAAAAAAAAAEAAAAAQAEAAAAAAAAIAAAAMjQwOTE0LjAtAQAAeyJ3YXNfZmlyc3RfZXZlbnQiOnRydWUsImltYWdlX2lkIjpbMjM1NDc4MTczLDE0MjY2MzQzNDAsMTcyNDQzNDY5NCwxMjY5MTUxMjM1LDIyOTk2ODc1MDksMzMzMzc3MDAzOSwzNzYxMTYwMDkzLDQwMDU0NTgzNzZdLCJxZiI6eyJiIjpbMCwwLDAsMCwwLDAsMCwwLDAsMCwwLDAsMCwwLDAsMCwwLDAsMCwwLDAsMCwwLDAsMCwwLDAsMCwwLDAsMCwwLDAsMCwwLDAsMCwwLDAsMCwwLDAsMCwwLDAsMCwwLDAsMCwwLDAsMCwwLDAsMCwwLDAsMCwwLDAsMCwwLDAsMCwwLDAsMCwwLDAsMCwwLDAsMF0sImwiOjAsInEiOjYsInIiOjd9fQAAAAAAAAAAAAAAAAAAAEABAAAAAAAACAAAADI0MDkxNC4wLQEAAHsid2FzX2ZpcnN0X2V2ZW50Ijp0cnVlLCJpbWFnZV9pZCI6WzIzNTQ3ODE3MywxNDI2NjM0MzQwLDE3MjQ0MzQ2OTQsMTI2OTE1MTIzNSwyMjk5Njg3NTA5LDMzMzM3NzAwMzksMzc2MTE2MDA5Myw0MDA1NDU4Mzc2XSwicWYiOnsiYiI6WzAsMCwwLDAsMCwwLDAsMCwwLDAsMCwwLDAsMCwwLDAsMCwwLDAsMCwwLDAsMCwwLDAsMCwwLDAsMCwwLDAsMCwwLDAsMCwwLDAsMCwwLDAsMCwwLDAsMCwwLDAsMCwwLDAsMCwwLDAsMCwwLDAsMCwwLDAsMCwwLDAsMCwwLDAsMCwwLDAsMCwwLDAsMCwwLDBdLCJsIjowLCJxIjo2LCJyIjo3fX0AAAAAAAAAAAAAAAAAAAAAAAAAAAAAAAAAAAAAAAAAAAAAAA=='}}
prove_95;56;83;Mul;4648;245562;245562.0;841;0.06974870799967903;{'verificationValue': 245562.0, 'proof': {'imageId': [235478173, 1426634340, 1724434694, 1269151235, 2299687509, 3333770039, 3761160093, 4005458376], 'receipt': 'AwAAAAAAAAAAAAAAmL4gACyGqXD9SCTqBr57Fe21xvS89IksDAnB7FD2cs3kOUscAAAAAAAAAAAAAAAAAAAAAAAAAAAAAAAAAAAAAAAAAAAAAAAAAAAAAAAAAAAAAAAAAQAAAAAAAAAAAAAAAAAAAAAAAAAAAAAAAAAAAAAAAAAAAAAAAAAAAAEAAAAAQAEAAAAAAAAIAAAAMjQ1NTYyLjAtAQAAeyJ3YXNfZmlyc3RfZXZlbnQiOnRydWUsImltYWdlX2lkIjpbMjM1NDc4MTczLDE0MjY2MzQzNDAsMTcyNDQzNDY5NCwxMjY5MTUxMjM1LDIyOTk2ODc1MDksMzMzMzc3MDAzOSwzNzYxMTYwMDkzLDQwMDU0NTgzNzZdLCJxZiI6eyJiIjpbMCwwLDAsMCwwLDAsMCwwLDAsMCwwLDAsMCwwLDAsMCwwLDAsMCwwLDAsMCwwLDAsMCwwLDAsMCwwLDAsMCwwLDAsMCwwLDAsMCwwLDAsMCwwLDAsMCwwLDAsMCwwLDAsMCwwLDAsMCwwLDAsMCwwLDAsMCwwLDAsMCwwLDAsMCwwLDAsMCwwLDAsMCwwLDAsMF0sImwiOjAsInEiOjYsInIiOjd9fQAAAAAAAAAAAAAAAAAAAEABAAAAAAAACAAAADI0NTU2Mi4wLQEAAHsid2FzX2ZpcnN0X2V2ZW50Ijp0cnVlLCJpbWFnZV9pZCI6WzIzNTQ3ODE3MywxNDI2NjM0MzQwLDE3MjQ0MzQ2OTQsMTI2OTE1MTIzNSwyMjk5Njg3NTA5LDMzMzM3NzAwMzksMzc2MTE2MDA5Myw0MDA1NDU4Mzc2XSwicWYiOnsiYiI6WzAsMCwwLDAsMCwwLDAsMCwwLDAsMCwwLDAsMCwwLDAsMCwwLDAsMCwwLDAsMCwwLDAsMCwwLDAsMCwwLDAsMCwwLDAsMCwwLDAsMCwwLDAsMCwwLDAsMCwwLDAsMCwwLDAsMCwwLDAsMCwwLDAsMCwwLDAsMCwwLDAsMCwwLDAsMCwwLDAsMCwwLDAsMCwwLDBdLCJsIjowLCJxIjo2LCJyIjo3fX0AAAAAAAAAAAAAAAAAAAAAAAAAAAAAAAAAAAAAAAAAAAAAAA=='}}
prove_96;60;76;Mul;4560;250122;250122.0;841;0.07015437500012922;{'verificationValue': 250122.0, 'proof': {'imageId': [235478173, 1426634340, 1724434694, 1269151235, 2299687509, 3333770039, 3761160093, 4005458376], 'receipt': 'AwAAAAAAAAAAAAAAmL4gACyGqXD9SCTqBr57Fe21xvS89IksDAnB7FD2cs3kOUscAAAAAAAAAAAAAAAAAAAAAAAAAAAAAAAAAAAAAAAAAAAAAAAAAAAAAAAAAAAAAAAAAQAAAAAAAAAAAAAAAAAAAAAAAAAAAAAAAAAAAAAAAAAAAAAAAAAAAAEAAAAAQAEAAAAAAAAIAAAAMjUwMTIyLjAtAQAAeyJ3YXNfZmlyc3RfZXZlbnQiOnRydWUsImltYWdlX2lkIjpbMjM1NDc4MTczLDE0MjY2MzQzNDAsMTcyNDQzNDY5NCwxMjY5MTUxMjM1LDIyOTk2ODc1MDksMzMzMzc3MDAzOSwzNzYxMTYwMDkzLDQwMDU0NTgzNzZdLCJxZiI6eyJiIjpbMCwwLDAsMCwwLDAsMCwwLDAsMCwwLDAsMCwwLDAsMCwwLDAsMCwwLDAsMCwwLDAsMCwwLDAsMCwwLDAsMCwwLDAsMCwwLDAsMCwwLDAsMCwwLDAsMCwwLDAsMCwwLDAsMCwwLDAsMCwwLDAsMCwwLDAsMCwwLDAsMCwwLDAsMCwwLDAsMCwwLDAsMCwwLDAsMF0sImwiOjAsInEiOjYsInIiOjd9fQAAAAAAAAAAAAAAAAAAAEABAAAAAAAACAAAADI1MDEyMi4wLQEAAHsid2FzX2ZpcnN0X2V2ZW50Ijp0cnVlLCJpbWFnZV9pZCI6WzIzNTQ3ODE3MywxNDI2NjM0MzQwLDE3MjQ0MzQ2OTQsMTI2OTE1MTIzNSwyMjk5Njg3NTA5LDMzMzM3NzAwMzksMzc2MTE2MDA5Myw0MDA1NDU4Mzc2XSwicWYiOnsiYiI6WzAsMCwwLDAsMCwwLDAsMCwwLDAsMCwwLDAsMCwwLDAsMCwwLDAsMCwwLDAsMCwwLDAsMCwwLDAsMCwwLDAsMCwwLDAsMCwwLDAsMCwwLDAsMCwwLDAsMCwwLDAsMCwwLDAsMCwwLDAsMCwwLDAsMCwwLDAsMCwwLDAsMCwwLDAsMCwwLDAsMCwwLDAsMCwwLDBdLCJsIjowLCJxIjo2LCJyIjo3fX0AAAAAAAAAAAAAAAAAAAAAAAAAAAAAAAAAAAAAAAAAAAAAAA=='}}
prove_97;61;26;Mul;1586;251708;251708.0;841;0.06887208300031489;{'verificationValue': 251708.0, 'proof': {'imageId': [235478173, 1426634340, 1724434694, 1269151235, 2299687509, 3333770039, 3761160093, 4005458376], 'receipt': 'AwAAAAAAAAAAAAAAmL4gACyGqXD9SCTqBr57Fe21xvS89IksDAnB7FD2cs3kOUscAAAAAAAAAAAAAAAAAAAAAAAAAAAAAAAAAAAAAAAAAAAAAAAAAAAAAAAAAAAAAAAAAQAAAAAAAAAAAAAAAAAAAAAAAAAAAAAAAAAAAAAAAAAAAAAAAAAAAAEAAAAAQAEAAAAAAAAIAAAAMjUxNzA4LjAtAQAAeyJ3YXNfZmlyc3RfZXZlbnQiOnRydWUsImltYWdlX2lkIjpbMjM1NDc4MTczLDE0MjY2MzQzNDAsMTcyNDQzNDY5NCwxMjY5MTUxMjM1LDIyOTk2ODc1MDksMzMzMzc3MDAzOSwzNzYxMTYwMDkzLDQwMDU0NTgzNzZdLCJxZiI6eyJiIjpbMCwwLDAsMCwwLDAsMCwwLDAsMCwwLDAsMCwwLDAsMCwwLDAsMCwwLDAsMCwwLDAsMCwwLDAsMCwwLDAsMCwwLDAsMCwwLDAsMCwwLDAsMCwwLDAsMCwwLDAsMCwwLDAsMCwwLDAsMCwwLDAsMCwwLDAsMCwwLDAsMCwwLDAsMCwwLDAsMCwwLDAsMCwwLDAsMF0sImwiOjAsInEiOjYsInIiOjd9fQAAAAAAAAAAAAAAAAAAAEABAAAAAAAACAAAADI1MTcwOC4wLQEAAHsid2FzX2ZpcnN0X2V2ZW50Ijp0cnVlLCJpbWFnZV9pZCI6WzIzNTQ3ODE3MywxNDI2NjM0MzQwLDE3MjQ0MzQ2OTQsMTI2OTE1MTIzNSwyMjk5Njg3NTA5LDMzMzM3NzAwMzksMzc2MTE2MDA5Myw0MDA1NDU4Mzc2XSwicWYiOnsiYiI6WzAsMCwwLDAsMCwwLDAsMCwwLDAsMCwwLDAsMCwwLDAsMCwwLDAsMCwwLDAsMCwwLDAsMCwwLDAsMCwwLDAsMCwwLDAsMCwwLDAsMCwwLDAsMCwwLDAsMCwwLDAsMCwwLDAsMCwwLDAsMCwwLDAsMCwwLDAsMCwwLDAsMCwwLDAsMCwwLDAsMCwwLDAsMCwwLDBdLCJsIjowLCJxIjo2LCJyIjo3fX0AAAAAAAAAAAAAAAAAAAAAAAAAAAAAAAAAAAAAAAAAAAAAAA=='}}
prove_98;50;72;Mul;3600;255308;255308.0;841;0.06976112499978626;{'verificationValue': 255308.0, 'proof': {'imageId': [235478173, 1426634340, 1724434694, 1269151235, 2299687509, 3333770039, 3761160093, 4005458376], 'receipt': 'AwAAAAAAAAAAAAAAmL4gACyGqXD9SCTqBr57Fe21xvS89IksDAnB7FD2cs3kOUscAAAAAAAAAAAAAAAAAAAAAAAAAAAAAAAAAAAAAAAAAAAAAAAAAAAAAAAAAAAAAAAAAQAAAAAAAAAAAAAAAAAAAAAAAAAAAAAAAAAAAAAAAAAAAAAAAAAAAAEAAAAAQAEAAAAAAAAIAAAAMjU1MzA4LjAtAQAAeyJ3YXNfZmlyc3RfZXZlbnQiOnRydWUsImltYWdlX2lkIjpbMjM1NDc4MTczLDE0MjY2MzQzNDAsMTcyNDQzNDY5NCwxMjY5MTUxMjM1LDIyOTk2ODc1MDksMzMzMzc3MDAzOSwzNzYxMTYwMDkzLDQwMDU0NTgzNzZdLCJxZiI6eyJiIjpbMCwwLDAsMCwwLDAsMCwwLDAsMCwwLDAsMCwwLDAsMCwwLDAsMCwwLDAsMCwwLDAsMCwwLDAsMCwwLDAsMCwwLDAsMCwwLDAsMCwwLDAsMCwwLDAsMCwwLDAsMCwwLDAsMCwwLDAsMCwwLDAsMCwwLDAsMCwwLDAsMCwwLDAsMCwwLDAsMCwwLDAsMCwwLDAsMF0sImwiOjAsInEiOjYsInIiOjd9fQAAAAAAAAAAAAAAAAAAAEABAAAAAAAACAAAADI1NTMwOC4wLQEAAHsid2FzX2ZpcnN0X2V2ZW50Ijp0cnVlLCJpbWFnZV9pZCI6WzIzNTQ3ODE3MywxNDI2NjM0MzQwLDE3MjQ0MzQ2OTQsMTI2OTE1MTIzNSwyMjk5Njg3NTA5LDMzMzM3NzAwMzksMzc2MTE2MDA5Myw0MDA1NDU4Mzc2XSwicWYiOnsiYiI6WzAsMCwwLDAsMCwwLDAsMCwwLDAsMCwwLDAsMCwwLDAsMCwwLDAsMCwwLDAsMCwwLDAsMCwwLDAsMCwwLDAsMCwwLDAsMCwwLDAsMCwwLDAsMCwwLDAsMCwwLDAsMCwwLDAsMCwwLDAsMCwwLDAsMCwwLDAsMCwwLDAsMCwwLDAsMCwwLDAsMCwwLDAsMCwwLDBdLCJsIjowLCJxIjo2LCJyIjo3fX0AAAAAAAAAAAAAAAAAAAAAAAAAAAAAAAAAAAAAAAAAAAAAAA=='}}
prove_99;54;34;Mul;1836;257144;257144.0;841;0.0695032089988672;{'verificationValue': 257144.0, 'proof': {'imageId': [235478173, 1426634340, 1724434694, 1269151235, 2299687509, 3333770039, 3761160093, 4005458376], 'receipt': 'AwAAAAAAAAAAAAAAmL4gACyGqXD9SCTqBr57Fe21xvS89IksDAnB7FD2cs3kOUscAAAAAAAAAAAAAAAAAAAAAAAAAAAAAAAAAAAAAAAAAAAAAAAAAAAAAAAAAAAAAAAAAQAAAAAAAAAAAAAAAAAAAAAAAAAAAAAAAAAAAAAAAAAAAAAAAAAAAAEAAAAAQAEAAAAAAAAIAAAAMjU3MTQ0LjAtAQAAeyJ3YXNfZmlyc3RfZXZlbnQiOnRydWUsImltYWdlX2lkIjpbMjM1NDc4MTczLDE0MjY2MzQzNDAsMTcyNDQzNDY5NCwxMjY5MTUxMjM1LDIyOTk2ODc1MDksMzMzMzc3MDAzOSwzNzYxMTYwMDkzLDQwMDU0NTgzNzZdLCJxZiI6eyJiIjpbMCwwLDAsMCwwLDAsMCwwLDAsMCwwLDAsMCwwLDAsMCwwLDAsMCwwLDAsMCwwLDAsMCwwLDAsMCwwLDAsMCwwLDAsMCwwLDAsMCwwLDAsMCwwLDAsMCwwLDAsMCwwLDAsMCwwLDAsMCwwLDAsMCwwLDAsMCwwLDAsMCwwLDAsMCwwLDAsMCwwLDAsMCwwLDAsMF0sImwiOjAsInEiOjYsInIiOjd9fQAAAAAAAAAAAAAAAAAAAEABAAAAAAAACAAAADI1NzE0NC4wLQEAAHsid2FzX2ZpcnN0X2V2ZW50Ijp0cnVlLCJpbWFnZV9pZCI6WzIzNTQ3ODE3MywxNDI2NjM0MzQwLDE3MjQ0MzQ2OTQsMTI2OTE1MTIzNSwyMjk5Njg3NTA5LDMzMzM3NzAwMzksMzc2MTE2MDA5Myw0MDA1NDU4Mzc2XSwicWYiOnsiYiI6WzAsMCwwLDAsMCwwLDAsMCwwLDAsMCwwLDAsMCwwLDAsMCwwLDAsMCwwLDAsMCwwLDAsMCwwLDAsMCwwLDAsMCwwLDAsMCwwLDAsMCwwLDAsMCwwLDAsMCwwLDAsMCwwLDAsMCwwLDAsMCwwLDAsMCwwLDAsMCwwLDAsMCwwLDAsMCwwLDAsMCwwLDAsMCwwLDBdLCJsIjowLCJxIjo2LCJyIjo3fX0AAAAAAAAAAAAAAAAAAAAAAAAAAAAAAAAAAAAAAAAAAAAAAA=='}}
